PROVINSI,KABUPATEN,KECAMATAN,KELURAHAN,JUMLAH_KELUARGA,JUMLAH_SASARAN,JUMLAH_KRS,PENERIMA_BAAS,PENERIMA_BANTUAN_PANGAN,JUMLAH_BALITA_STUNTING,TERLALU_TUA,TERLALU_MUDA,TERLALU_BANYAK,TERLALU_DEKAT,SANITASI,SUMBER_AIR_MINUM,CATIN_SASARAN,CATIN_TERDAMPINGI,CATIN_TIDAK_TERDAMPINGI,CATIN_BERESIKO,BUMIL_SASARAN,BUMIL_TERDAMPINGI,BUMIL_TIDAK_TERDAMPINGI,BUMIL_BERESIKO,PASCASALIN_SASARAN,PASCASALIN_TERDAMPINGI,PASCASALIN_TIDAK_TERDAMPINGI,PASCASALIN_BERESIKO,BADUTA_SASARAN,BADUTA_TERDAMPINGI,BADUTA_TIDAK_TERDAMPINGI,BADUTA_BERESIKO,BULAN
SULAWESI BARAT,MAMUJU TENGAH,TOBADAK,MAHAHE,54,18,5,4,0,0,0,2,3,0,4,1,8,7,1,4,10,6,4,4,9,7,2,6,16,4,12,14,JANUARI
SULAWESI BARAT,MAMUJU TENGAH,TOBADAK,SALOBAJA,78,55,9,8,4,2,2,5,1,0,1,4,15,9,6,4,38,28,10,14,34,33,1,21,0,0,0,0,JANUARI
SULAWESI BARAT,MAMUJU TENGAH,TOBADAK,TOBADAK,100,17,2,2,1,0,0,1,0,1,1,1,10,9,1,9,14,6,8,5,11,10,1,6,14,2,12,3,JANUARI
SULAWESI BARAT,MAMUJU TENGAH,TOBADAK,PALONGAAN,82,14,9,6,1,0,0,2,4,1,8,1,4,3,1,0,13,10,3,8,7,3,4,3,14,13,1,4,JANUARI
SULAWESI BARAT,MAMUJU TENGAH,TOBADAK,BATU PARIGI,68,44,3,0,0,0,0,2,1,0,2,0,11,1,10,0,16,16,0,10,10,4,6,1,4,2,2,3,JANUARI
SULAWESI BARAT,MAMUJU TENGAH,TOBADAK,BAMBADARU,68,49,33,15,15,2,2,12,15,1,13,3,0,0,0,0,42,18,24,14,22,7,15,0,33,7,26,1,JANUARI
SULAWESI BARAT,MAMUJU TENGAH,TOBADAK,SEJATI,86,70,62,15,2,0,0,45,0,2,28,22,12,4,8,4,53,33,20,28,31,27,4,27,65,8,57,24,JANUARI
SULAWESI BARAT,MAMUJU TENGAH,TOBADAK,SALOADAK,77,12,4,3,2,2,2,0,1,0,2,0,11,5,6,3,11,5,6,2,10,8,2,3,15,12,3,8,JANUARI
SULAWESI BARAT,MAMUJU TENGAH,PANGALE,POLO PANGALE,61,32,17,14,3,0,0,17,0,0,1,12,3,0,3,0,30,12,18,10,21,6,15,1,25,2,23,24,JANUARI
SULAWESI BARAT,MAMUJU TENGAH,PANGALE,PANGALE,97,38,17,14,9,1,1,4,9,0,7,6,12,2,10,2,23,23,0,1,1,1,0,0,24,0,24,10,JANUARI
SULAWESI BARAT,MAMUJU TENGAH,PANGALE,SARTANAMAJU,98,55,50,32,5,0,0,4,5,13,41,3,9,2,7,1,54,53,1,15,36,15,21,3,24,11,13,3,JANUARI
SULAWESI BARAT,MAMUJU TENGAH,PANGALE,POLO LERENG,80,58,33,32,18,1,1,21,5,1,25,7,4,4,0,3,35,11,24,5,8,1,7,1,43,1,42,8,JANUARI
SULAWESI BARAT,MAMUJU TENGAH,PANGALE,KUO,61,73,58,5,0,0,0,10,18,5,56,1,10,8,2,3,30,13,17,4,26,18,8,14,71,32,39,62,JANUARI
SULAWESI BARAT,MAMUJU TENGAH,PANGALE,POLO CAMBA,89,77,62,19,12,11,3,1,32,26,57,3,9,2,7,2,43,23,20,19,29,12,17,0,9,3,6,7,JANUARI
SULAWESI BARAT,MAMUJU TENGAH,PANGALE,LAMBA-LAMBA,78,46,45,10,7,4,3,31,1,3,32,1,13,7,6,3,32,15,17,12,30,22,8,13,39,5,34,21,JANUARI
SULAWESI BARAT,MAMUJU TENGAH,PANGALE,KOMBILING,89,59,3,1,1,1,0,2,0,1,0,1,15,15,0,2,21,21,0,1,6,3,3,3,38,8,30,12,JANUARI
SULAWESI BARAT,MAMUJU TENGAH,PANGALE,LEMO-LEMO,76,58,29,7,3,2,0,28,0,1,29,0,5,4,1,1,17,12,5,0,9,2,7,0,48,43,5,35,JANUARI
SULAWESI BARAT,MAMUJU TENGAH,BUDONG-BUDONG,BABANA,81,29,24,24,13,0,0,6,18,0,14,1,5,2,3,2,16,9,7,7,14,13,1,1,30,20,10,10,JANUARI
SULAWESI BARAT,MAMUJU TENGAH,BUDONG-BUDONG,LUMU,98,72,32,16,6,1,1,20,6,5,16,3,8,4,4,1,53,27,26,27,36,7,29,6,54,15,39,49,JANUARI
SULAWESI BARAT,MAMUJU TENGAH,BUDONG-BUDONG,PONTANAKAYANG,35,74,22,0,0,0,0,4,14,0,12,5,5,4,1,4,59,57,2,51,37,13,24,1,37,4,33,14,JANUARI
SULAWESI BARAT,MAMUJU TENGAH,BUDONG-BUDONG,SALOGATTA,82,22,10,3,3,2,2,7,1,0,2,1,5,0,5,0,12,8,4,2,12,9,3,1,16,0,16,10,JANUARI
SULAWESI BARAT,MAMUJU TENGAH,BUDONG-BUDONG,KIRE,37,59,54,8,4,0,0,10,39,4,39,10,0,0,0,0,10,5,5,2,5,4,1,4,35,20,15,12,JANUARI
SULAWESI BARAT,MAMUJU TENGAH,BUDONG-BUDONG,TINALI,91,35,26,14,12,12,5,15,1,2,17,4,16,6,10,2,31,27,4,1,3,3,0,0,11,2,9,5,JANUARI
SULAWESI BARAT,MAMUJU TENGAH,BUDONG-BUDONG,SALUMANURUNG,36,12,6,6,6,1,0,0,2,2,4,0,3,2,1,2,12,7,5,6,11,8,3,5,3,2,1,1,JANUARI
SULAWESI BARAT,MAMUJU TENGAH,BUDONG-BUDONG,PASAPA,35,65,45,13,7,0,0,11,20,14,30,12,7,0,7,0,23,12,11,7,22,0,22,0,23,19,4,9,JANUARI
SULAWESI BARAT,MAMUJU TENGAH,BUDONG-BUDONG,BOJO,40,66,49,2,2,2,1,34,4,10,44,1,4,1,3,0,22,8,14,0,11,10,1,9,30,29,1,21,JANUARI
SULAWESI BARAT,MAMUJU TENGAH,BUDONG-BUDONG,BARAKKANG,77,75,67,44,17,1,0,11,5,25,6,23,8,5,3,3,23,6,17,0,3,1,2,1,37,4,33,25,JANUARI
SULAWESI BARAT,MAMUJU TENGAH,BUDONG-BUDONG,LEMBAH HADA,41,70,22,9,2,0,0,8,14,0,2,9,2,2,0,1,12,9,3,0,3,0,3,0,33,16,17,2,JANUARI
SULAWESI BARAT,MAMUJU TENGAH,TOPOYO,BUDONG-BUDONG,49,57,8,5,2,1,0,4,1,2,3,3,4,4,0,0,18,17,1,6,17,12,5,2,13,13,0,13,JANUARI
SULAWESI BARAT,MAMUJU TENGAH,TOPOYO,TOPOYO,35,47,15,12,9,2,1,3,2,0,14,1,2,0,2,0,25,9,16,7,22,8,14,1,27,26,1,15,JANUARI
SULAWESI BARAT,MAMUJU TENGAH,TOPOYO,TUMBU,36,25,18,0,0,0,0,12,4,1,10,2,0,0,0,0,19,6,13,6,1,0,1,0,6,2,4,2,JANUARI
SULAWESI BARAT,MAMUJU TENGAH,TOPOYO,KABUBU,96,79,45,10,5,1,0,22,8,3,23,2,14,11,3,7,66,22,44,1,40,8,32,1,72,61,11,28,JANUARI
SULAWESI BARAT,MAMUJU TENGAH,TOPOYO,WAEPUTEH,61,79,48,48,27,21,5,32,3,8,48,0,3,3,0,2,27,8,19,1,2,2,0,1,31,4,27,3,JANUARI
SULAWESI BARAT,MAMUJU TENGAH,TOPOYO,TANGKOU,74,47,19,3,3,1,1,5,0,9,8,5,11,3,8,2,19,17,2,6,15,8,7,3,30,16,14,0,JANUARI
SULAWESI BARAT,MAMUJU TENGAH,TOPOYO,TABOLANG,97,53,13,8,3,2,0,7,3,2,1,12,11,1,10,1,40,32,8,7,38,18,20,3,20,13,7,13,JANUARI
SULAWESI BARAT,MAMUJU TENGAH,TOPOYO,PARAILI,53,28,8,4,4,3,0,6,1,0,2,5,3,2,1,2,28,21,7,16,3,2,1,1,0,0,0,0,JANUARI
SULAWESI BARAT,MAMUJU TENGAH,TOPOYO,SALUPANGKANG,76,11,7,0,0,0,0,1,5,1,4,2,10,1,9,0,11,6,5,2,3,3,0,1,4,0,4,4,JANUARI
SULAWESI BARAT,MAMUJU TENGAH,TOPOYO,SALUPANGKANG IV,38,20,15,6,4,1,1,2,10,2,2,10,5,4,1,4,15,15,0,0,13,8,5,6,14,10,4,14,JANUARI
SULAWESI BARAT,MAMUJU TENGAH,TOPOYO,TAPPILINA,44,24,1,0,0,0,0,1,0,0,0,1,5,2,3,2,21,6,15,6,11,3,8,1,8,6,2,6,JANUARI
SULAWESI BARAT,MAMUJU TENGAH,TOPOYO,BAMBAMANURUNG,98,77,13,2,1,1,0,4,1,3,2,5,11,0,11,0,50,26,24,9,15,2,13,1,61,0,61,35,JANUARI
SULAWESI BARAT,MAMUJU TENGAH,TOPOYO,SALULEKBO,43,38,7,6,3,2,0,0,5,2,4,0,4,1,3,1,26,20,6,17,22,15,7,14,11,3,8,5,JANUARI
SULAWESI BARAT,MAMUJU TENGAH,TOPOYO,PANGALLOANG,83,57,39,20,11,11,8,6,17,0,24,12,4,0,4,0,38,17,21,5,8,3,5,1,22,11,11,0,JANUARI
SULAWESI BARAT,MAMUJU TENGAH,TOPOYO,SINABATTA,75,59,10,6,0,0,0,3,1,2,5,1,10,2,8,2,20,8,12,1,6,4,2,3,43,26,17,2,JANUARI
SULAWESI BARAT,MAMUJU TENGAH,KAROSSA,KAROSSA,41,69,27,27,14,13,0,4,10,13,7,2,1,1,0,0,57,23,34,17,12,6,6,3,36,22,14,23,JANUARI
SULAWESI BARAT,MAMUJU TENGAH,KAROSSA,TASOKKO,46,76,74,41,3,1,1,62,9,0,37,37,7,6,1,6,55,31,24,3,19,8,11,1,38,35,3,19,JANUARI
SULAWESI BARAT,MAMUJU TENGAH,KAROSSA,LARA,69,10,5,1,1,0,0,0,4,0,1,1,13,7,6,0,10,10,0,2,0,0,0,0,5,2,3,3,JANUARI
SULAWESI BARAT,MAMUJU TENGAH,KAROSSA,KADAILA,42,12,7,6,0,0,0,3,2,0,4,0,1,1,0,1,10,8,2,7,2,2,0,1,6,3,3,4,JANUARI
SULAWESI BARAT,MAMUJU TENGAH,KAROSSA,KAYU CALLA,60,78,4,0,0,0,0,0,3,0,4,0,1,1,0,1,26,17,9,0,12,12,0,0,37,4,33,28,JANUARI
SULAWESI BARAT,MAMUJU TENGAH,KAROSSA,LEMBAH HOPO,84,60,52,15,9,9,6,26,1,3,21,15,7,3,4,0,14,10,4,2,3,2,1,1,1,1,0,0,JANUARI
SULAWESI BARAT,MAMUJU TENGAH,KAROSSA,BENGGAULU,39,36,14,0,0,0,0,0,6,0,9,5,5,0,5,0,24,15,9,15,12,9,3,5,35,27,8,5,JANUARI
SULAWESI BARAT,MAMUJU TENGAH,KAROSSA,SUKA MAJU,92,76,9,6,2,1,0,6,0,3,0,0,14,0,14,0,59,46,13,1,7,4,3,2,34,7,27,23,JANUARI
SULAWESI BARAT,MAMUJU TENGAH,KAROSSA,KAMBUNONG,90,16,13,8,0,0,0,6,5,1,9,1,14,0,14,0,15,11,4,9,1,1,0,1,7,0,7,3,JANUARI
SULAWESI BARAT,MAMUJU TENGAH,KAROSSA,SALUBIRO,44,67,5,1,0,0,0,5,0,0,3,1,2,0,2,0,22,10,12,0,11,5,6,5,43,13,30,32,JANUARI
SULAWESI BARAT,MAMUJU TENGAH,KAROSSA,SANJANGO,52,77,11,3,3,1,0,2,0,7,2,0,4,0,4,0,32,23,9,21,25,21,4,0,1,1,0,1,JANUARI
SULAWESI BARAT,PASANGKAYU,BAMBAIRA,TAMPAURE,69,34,15,4,0,0,0,9,2,4,1,3,0,0,0,0,30,5,25,2,24,22,2,13,37,18,19,28,JANUARI
SULAWESI BARAT,PASANGKAYU,BAMBAIRA,BAMBAIRA,63,47,32,17,13,2,0,7,23,2,2,13,5,0,5,0,18,14,4,4,4,2,2,0,9,1,8,8,JANUARI
SULAWESI BARAT,PASANGKAYU,BAMBAIRA,KASOLOANG,35,11,5,0,0,0,0,1,3,0,5,0,2,0,2,0,11,9,2,0,2,0,2,0,0,0,0,0,JANUARI
SULAWESI BARAT,PASANGKAYU,BAMBAIRA,KALUKU NANGKA,37,28,20,5,5,4,2,12,2,1,0,3,7,2,5,1,13,7,6,1,0,0,0,0,1,0,1,1,JANUARI
SULAWESI BARAT,PASANGKAYU,BAMBALAMOTU,RANDOMAYANG,71,17,10,7,3,1,1,7,0,1,4,2,9,1,8,1,11,6,5,5,9,3,6,0,8,2,6,3,JANUARI
SULAWESI BARAT,PASANGKAYU,BAMBALAMOTU,BAMBALAMOTU,39,11,9,6,1,0,0,5,2,2,2,5,1,0,1,0,10,6,4,3,4,0,4,0,5,2,3,0,JANUARI
SULAWESI BARAT,PASANGKAYU,BAMBALAMOTU,POLEWALI,32,70,8,8,5,1,0,0,0,1,1,7,2,0,2,0,52,39,13,24,15,12,3,0,64,56,8,17,JANUARI
SULAWESI BARAT,PASANGKAYU,BAMBALAMOTU,PANGIANG,41,53,27,10,7,6,4,23,0,0,12,2,6,3,3,3,41,34,7,30,7,3,4,0,2,2,0,0,JANUARI
SULAWESI BARAT,PASANGKAYU,BAMBALAMOTU,KALOLA,41,29,23,14,13,2,0,22,0,1,15,0,4,4,0,2,26,6,20,2,7,4,3,1,25,10,15,10,JANUARI
SULAWESI BARAT,PASANGKAYU,BAMBALAMOTU,WULAI,58,22,5,2,2,1,0,0,2,3,4,0,3,0,3,0,13,13,0,5,11,6,5,2,16,16,0,6,JANUARI
SULAWESI BARAT,PASANGKAYU,BARAS,BARAS,60,19,17,7,3,0,0,4,7,6,16,0,10,8,2,7,18,12,6,3,17,14,3,12,18,16,2,6,JANUARI
SULAWESI BARAT,PASANGKAYU,BARAS,BULU PARIGI,47,75,8,2,0,0,0,0,2,0,2,5,3,1,2,0,72,21,51,2,0,0,0,0,13,4,9,1,JANUARI
SULAWESI BARAT,PASANGKAYU,BARAS,BALANTI,34,28,0,0,0,0,0,0,0,0,0,0,4,1,3,0,23,6,17,0,9,3,6,3,1,1,0,1,JANUARI
SULAWESI BARAT,PASANGKAYU,BARAS,MOTU,98,14,4,4,3,0,0,2,0,1,4,0,1,0,1,0,11,9,2,0,9,8,1,3,12,11,1,11,JANUARI
SULAWESI BARAT,PASANGKAYU,BARAS,TOWONI,41,17,10,2,0,0,0,4,3,0,0,9,4,4,0,3,14,13,1,9,5,3,2,1,10,6,4,5,JANUARI
SULAWESI BARAT,PASANGKAYU,BARAS,KASANO,58,33,11,8,7,5,1,6,3,0,0,2,1,1,0,0,16,7,9,4,12,5,7,0,7,1,6,1,JANUARI
SULAWESI BARAT,PASANGKAYU,BULU TABA,SUMBER SARI,86,41,35,20,8,3,3,25,5,2,34,0,10,1,9,0,34,14,20,2,25,11,14,4,15,3,12,0,JANUARI
SULAWESI BARAT,PASANGKAYU,BULU TABA,LELEJAE,58,77,21,14,6,4,3,6,4,7,18,1,6,5,1,5,22,21,1,16,9,2,7,1,8,0,8,8,JANUARI
SULAWESI BARAT,PASANGKAYU,BULU TABA,BUKIT HARAPAN,100,27,7,2,1,1,1,4,1,1,7,0,17,3,14,1,21,21,0,9,9,3,6,2,2,0,2,1,JANUARI
SULAWESI BARAT,PASANGKAYU,BULU TABA,LILIMORI,40,27,3,2,0,0,0,1,0,1,1,0,2,2,0,1,12,10,2,3,4,2,2,2,12,8,4,6,JANUARI
SULAWESI BARAT,PASANGKAYU,BULU TABA,KARAVE,64,58,29,10,8,3,1,4,8,14,28,0,0,0,0,0,57,5,52,1,3,1,2,1,40,14,26,26,JANUARI
SULAWESI BARAT,PASANGKAYU,BULU TABA,KASTABUANA,86,43,23,22,8,0,0,14,5,2,14,5,9,5,4,5,37,22,15,16,15,5,10,5,8,6,2,6,JANUARI
SULAWESI BARAT,PASANGKAYU,BULU TABA,OMPI,65,42,39,29,8,2,2,11,10,15,6,5,6,5,1,0,37,30,7,29,17,2,15,0,33,29,4,30,JANUARI
SULAWESI BARAT,PASANGKAYU,DAPURANG,DAPURANG,81,64,35,2,0,0,0,18,6,10,2,7,5,1,4,1,17,7,10,3,17,4,13,1,26,0,26,6,JANUARI
SULAWESI BARAT,PASANGKAYU,DAPURANG,BENGGAULU,62,42,0,0,0,0,0,0,0,0,0,0,5,2,3,0,26,10,16,4,11,5,6,5,5,0,5,2,JANUARI
SULAWESI BARAT,PASANGKAYU,DAPURANG,TIRTABUANA,62,29,23,4,0,0,0,17,4,1,21,2,12,7,5,7,15,8,7,1,14,13,1,7,32,6,26,14,JANUARI
SULAWESI BARAT,PASANGKAYU,DAPURANG,BULU BONGGU,70,66,26,22,5,5,2,1,23,0,20,5,5,3,2,1,44,31,13,14,27,1,26,1,72,6,66,16,JANUARI
SULAWESI BARAT,PASANGKAYU,DAPURANG,SARASA,84,22,15,15,4,2,2,11,1,1,2,4,14,8,6,7,12,12,0,1,11,1,10,0,22,2,20,18,JANUARI
SULAWESI BARAT,PASANGKAYU,DURIPOKU,TAMMARUNANG,33,51,12,6,2,2,1,2,0,7,3,3,5,2,3,0,43,42,1,4,28,16,12,12,59,3,56,10,JANUARI
SULAWESI BARAT,PASANGKAYU,DURIPOKU,SAPTANAJAYA,89,67,36,12,7,3,1,32,2,1,36,0,1,0,1,0,42,23,19,8,35,6,29,5,54,38,16,16,JANUARI
SULAWESI BARAT,PASANGKAYU,DURIPOKU,TARANGGI,44,41,16,3,2,2,0,14,0,1,2,7,2,2,0,0,40,26,14,12,8,8,0,0,5,0,5,4,JANUARI
SULAWESI BARAT,PASANGKAYU,DURIPOKU,SIPAKAINGA,74,50,16,6,4,2,2,2,9,2,4,12,10,7,3,3,34,23,11,20,1,1,0,0,24,22,2,8,JANUARI
SULAWESI BARAT,PASANGKAYU,LARIANG,KULU,44,34,12,11,9,5,3,6,1,2,11,0,0,0,0,0,11,7,4,5,10,8,2,6,2,2,0,0,JANUARI
SULAWESI BARAT,PASANGKAYU,LARIANG,PARABU,68,67,58,6,1,0,0,55,2,0,1,30,6,3,3,2,53,23,30,4,29,28,1,17,65,61,4,55,JANUARI
SULAWESI BARAT,PASANGKAYU,LARIANG,KENANGAN,41,71,19,5,3,1,1,15,3,0,14,5,6,4,2,1,57,7,50,6,30,16,14,8,43,37,6,43,JANUARI
SULAWESI BARAT,PASANGKAYU,LARIANG,BAJAWALI,60,80,7,7,5,3,1,4,0,2,3,2,1,0,1,0,17,11,6,6,6,6,0,5,9,5,4,6,JANUARI
SULAWESI BARAT,PASANGKAYU,LARIANG,SINGGANI,91,21,19,15,13,3,2,5,12,0,19,0,15,11,4,2,14,11,3,6,9,8,1,0,8,4,4,1,JANUARI
SULAWESI BARAT,PASANGKAYU,LARIANG,BATU MATORU,39,26,4,0,0,0,0,1,0,3,0,4,0,0,0,0,15,9,6,5,13,11,2,7,24,10,14,15,JANUARI
SULAWESI BARAT,PASANGKAYU,LARIANG,BAMBAKORO,93,51,48,20,13,4,0,43,5,0,36,0,12,12,0,8,26,15,11,13,4,1,3,0,18,10,8,2,JANUARI
SULAWESI BARAT,PASANGKAYU,PASANGKAYU,KARYA BERSAMA,79,71,55,27,8,6,2,32,4,14,20,20,2,1,1,1,33,14,19,5,5,4,1,0,7,4,3,2,JANUARI
SULAWESI BARAT,PASANGKAYU,PASANGKAYU,AKO,72,56,26,13,0,0,0,17,7,0,25,1,3,3,0,2,17,12,5,1,16,16,0,1,44,34,10,40,JANUARI
SULAWESI BARAT,PASANGKAYU,PASANGKAYU,PASANGKAYU,33,40,20,6,6,4,4,1,3,0,1,14,2,2,0,0,17,8,9,8,3,3,0,1,25,9,16,3,JANUARI
SULAWESI BARAT,PASANGKAYU,PASANGKAYU,MARTAJAYA,64,50,1,0,0,0,0,0,1,0,1,0,3,1,2,1,31,11,20,8,19,11,8,9,52,22,30,36,JANUARI
SULAWESI BARAT,PASANGKAYU,PASANGKAYU,PAKAVA,49,40,27,0,0,0,0,10,13,1,27,0,7,2,5,1,23,20,3,10,19,4,15,4,8,5,3,1,JANUARI
SULAWESI BARAT,PASANGKAYU,PASANGKAYU,GUNUNG SARI,97,72,29,9,2,2,1,2,24,2,21,5,2,0,2,0,29,13,16,1,9,4,5,2,1,0,1,1,JANUARI
SULAWESI BARAT,PASANGKAYU,PEDONGGA,MALEI,100,74,71,62,56,30,3,40,21,1,47,15,8,8,0,3,33,16,17,13,19,17,2,7,26,9,17,9,JANUARI
SULAWESI BARAT,PASANGKAYU,PEDONGGA,PEDANDA,37,42,2,0,0,0,0,1,1,0,1,1,3,3,0,1,32,14,18,1,23,20,3,12,0,0,0,0,JANUARI
SULAWESI BARAT,PASANGKAYU,PEDONGGA,BATU OGE,56,31,29,21,15,13,11,2,16,0,3,0,8,3,5,3,11,10,1,6,4,0,4,0,17,3,14,7,JANUARI
SULAWESI BARAT,PASANGKAYU,PEDONGGA,MARTASARI,77,10,3,3,2,1,0,1,2,0,0,1,5,5,0,5,10,6,4,1,3,3,0,3,0,0,0,0,JANUARI
SULAWESI BARAT,PASANGKAYU,SARJO,SARJO,60,36,36,7,4,0,0,29,7,0,27,9,3,2,1,0,13,10,3,5,0,0,0,0,25,25,0,17,JANUARI
SULAWESI BARAT,PASANGKAYU,SARJO,MAPONU,87,15,0,0,0,0,0,0,0,0,0,0,6,1,5,1,12,8,4,4,0,0,0,0,7,2,5,0,JANUARI
SULAWESI BARAT,PASANGKAYU,SARJO,LETAWA,77,76,51,13,1,0,0,2,10,9,35,10,8,8,0,1,55,32,23,26,28,11,17,6,38,22,16,25,JANUARI
SULAWESI BARAT,PASANGKAYU,SARJO,SARUDE,86,11,10,6,3,0,0,4,6,0,3,5,14,4,10,4,10,5,5,0,9,6,3,6,11,0,11,1,JANUARI
SULAWESI BARAT,PASANGKAYU,SARUDU,DODA,43,48,36,27,18,12,2,23,0,11,0,12,2,0,2,0,31,22,9,9,3,2,1,0,12,4,8,4,JANUARI
SULAWESI BARAT,PASANGKAYU,SARUDU,SARUDU,83,68,18,17,4,1,1,7,8,2,1,5,7,6,1,3,50,11,39,10,11,1,10,1,3,3,0,2,JANUARI
SULAWESI BARAT,PASANGKAYU,SARUDU,BULU MARIO,50,71,71,58,43,9,2,62,7,0,7,47,5,4,1,0,10,6,4,3,5,5,0,0,17,6,11,5,JANUARI
SULAWESI BARAT,PASANGKAYU,SARUDU,KUMASARI,60,41,5,4,1,1,1,3,1,0,0,2,0,0,0,0,33,5,28,4,29,23,6,4,31,26,5,16,JANUARI
SULAWESI BARAT,PASANGKAYU,SARUDU,PATIKA,45,18,16,2,0,0,0,3,5,4,1,5,1,0,1,0,12,7,5,6,4,1,3,1,5,5,0,1,JANUARI
SULAWESI BARAT,PASANGKAYU,TIKKE RAYA,MAKMUR JAYA,57,46,38,16,8,6,0,8,21,5,17,2,6,5,1,5,18,16,2,8,6,0,6,0,27,14,13,0,JANUARI
SULAWESI BARAT,PASANGKAYU,TIKKE RAYA,LARIANG,100,23,2,2,0,0,0,0,0,2,2,0,1,0,1,0,13,6,7,0,13,1,12,0,11,10,1,10,JANUARI
SULAWESI BARAT,PASANGKAYU,TIKKE RAYA,TIKKE,72,53,2,1,0,0,0,0,1,0,1,1,12,1,11,0,10,9,1,0,9,0,9,0,12,6,6,8,JANUARI
SULAWESI BARAT,PASANGKAYU,TIKKE RAYA,PAJALELE,34,11,2,0,0,0,0,1,0,0,1,0,2,1,1,0,10,9,1,7,3,3,0,0,2,0,2,2,JANUARI
SULAWESI BARAT,PASANGKAYU,TIKKE RAYA,JENGENG RAYA,89,39,2,2,2,1,1,1,0,0,0,0,2,2,0,1,29,21,8,19,4,3,1,0,6,4,2,3,JANUARI
SULAWESI BARAT,MAJENE,BANGGAE,BANGGAE,46,75,55,42,31,8,8,17,20,5,3,50,3,2,1,1,58,6,52,3,58,58,0,11,89,20,69,36,JANUARI
SULAWESI BARAT,MAJENE,BANGGAE,BARU,72,78,71,13,3,0,0,71,0,0,19,5,14,3,11,1,47,11,36,6,19,2,17,2,66,55,11,64,JANUARI
SULAWESI BARAT,MAJENE,BANGGAE,PANGALI ALI,95,55,33,16,2,2,0,22,5,5,2,9,15,14,1,12,29,24,5,6,22,4,18,4,36,8,28,1,JANUARI
SULAWESI BARAT,MAJENE,BANGGAE,TOTOLI,64,53,8,6,6,4,1,5,1,1,3,5,1,0,1,0,37,7,30,5,13,2,11,0,11,5,6,0,JANUARI
SULAWESI BARAT,MAJENE,BANGGAE,RANGAS,71,47,18,16,11,8,6,1,4,2,17,1,1,1,0,0,24,18,6,4,16,8,8,4,42,29,13,21,JANUARI
SULAWESI BARAT,MAJENE,BANGGAE,GALUNG,93,56,9,8,6,6,6,1,0,1,6,2,11,4,7,4,41,8,33,8,2,2,0,0,8,6,2,0,JANUARI
SULAWESI BARAT,MAJENE,BANGGAE,PALIPI SOREANG,51,47,40,16,8,3,0,37,3,0,8,29,1,0,1,0,33,21,12,11,16,10,6,7,34,24,10,10,JANUARI
SULAWESI BARAT,MAJENE,BANGGAE,PAMBOBORANG,80,28,3,0,0,0,0,2,0,0,3,0,3,1,2,1,27,20,7,4,22,7,15,2,27,16,11,6,JANUARI
SULAWESI BARAT,MAJENE,BANGGAE TIMUR,BAURUNG,43,79,46,21,13,13,6,12,5,18,32,14,6,6,0,5,77,61,16,42,33,26,7,2,69,48,21,34,JANUARI
SULAWESI BARAT,MAJENE,BANGGAE TIMUR,BARUGA,43,63,60,53,13,9,8,19,16,0,14,19,4,2,2,2,56,18,38,5,4,3,1,0,4,2,2,4,JANUARI
SULAWESI BARAT,MAJENE,BANGGAE TIMUR,BARUGA DHUA,73,14,7,1,0,0,0,0,5,2,5,1,7,6,1,3,14,13,1,12,8,6,2,5,3,3,0,1,JANUARI
SULAWESI BARAT,MAJENE,BANGGAE TIMUR,LABUANG,92,10,9,9,4,4,1,7,1,0,6,0,3,1,2,0,10,5,5,4,3,0,3,0,8,5,3,0,JANUARI
SULAWESI BARAT,MAJENE,BANGGAE TIMUR,TANDE,34,71,15,1,0,0,0,13,1,0,7,3,0,0,0,0,52,35,17,1,34,5,29,4,43,13,30,36,JANUARI
SULAWESI BARAT,MAJENE,BANGGAE TIMUR,LEMBANG,46,77,22,21,0,0,0,15,5,0,11,7,5,2,3,1,38,13,25,8,37,8,29,7,63,20,43,32,JANUARI
SULAWESI BARAT,MAJENE,BANGGAE TIMUR,LABUANG UTARA,44,61,30,9,5,4,3,27,0,0,19,1,7,3,4,1,29,25,4,18,0,0,0,0,25,18,7,20,JANUARI
SULAWESI BARAT,MAJENE,BANGGAE TIMUR,TANDE TIMUR,80,60,46,40,36,17,6,29,9,0,35,4,8,1,7,0,26,9,17,2,11,9,2,2,13,8,5,13,JANUARI
SULAWESI BARAT,MAJENE,BANGGAE TIMUR,BUTTU BARUGA,42,32,18,13,6,6,4,12,0,2,2,6,5,3,2,2,30,11,19,9,6,4,2,4,22,19,3,5,JANUARI
SULAWESI BARAT,MAJENE,MALUNDA,MALUNDA,84,29,11,0,0,0,0,11,0,0,9,2,9,2,7,0,25,5,20,4,4,0,4,0,5,5,0,4,JANUARI
SULAWESI BARAT,MAJENE,MALUNDA,LAMUNGANG BATU,34,64,5,5,2,1,0,3,2,0,5,0,5,3,2,0,26,14,12,3,22,2,20,1,43,24,19,7,JANUARI
SULAWESI BARAT,MAJENE,MALUNDA,BAMBANGAN,43,48,45,11,7,7,5,22,7,5,11,27,4,3,1,3,22,12,10,4,1,1,0,0,16,1,15,1,JANUARI
SULAWESI BARAT,MAJENE,MALUNDA,LOMBANG,41,36,30,22,8,0,0,21,2,1,22,1,1,0,1,0,35,33,2,2,0,0,0,0,21,3,18,2,JANUARI
SULAWESI BARAT,MAJENE,MALUNDA,LOMBONG,44,23,9,6,4,3,2,7,0,0,7,1,6,4,2,1,17,7,10,2,6,1,5,0,8,7,1,1,JANUARI
SULAWESI BARAT,MAJENE,MALUNDA,MEKKATTA,61,65,33,7,0,0,0,1,24,8,13,9,9,8,1,6,15,12,3,4,12,9,3,9,52,7,45,47,JANUARI
SULAWESI BARAT,MAJENE,MALUNDA,MALIAYA,84,40,36,27,10,3,0,20,6,10,6,20,3,1,2,0,37,15,22,14,29,6,23,6,14,13,1,13,JANUARI
SULAWESI BARAT,MAJENE,MALUNDA,LOMBANG TIMUR,80,26,24,9,1,1,0,6,4,14,10,13,4,0,4,0,16,16,0,2,0,0,0,0,7,0,7,3,JANUARI
SULAWESI BARAT,MAJENE,MALUNDA,SALUTAHONGAN,90,30,24,10,2,2,1,5,8,0,23,0,12,0,12,0,22,16,6,14,4,4,0,4,17,12,5,13,JANUARI
SULAWESI BARAT,MAJENE,MALUNDA,LOMBONG TIMUR,93,59,22,8,4,1,1,7,6,5,6,2,9,6,3,6,43,8,35,8,21,3,18,3,61,14,47,57,JANUARI
SULAWESI BARAT,MAJENE,MALUNDA,MEKKATTA SELATAN,64,68,22,0,0,0,0,20,1,0,2,4,12,12,0,6,61,19,42,17,32,3,29,3,14,4,10,4,JANUARI
SULAWESI BARAT,MAJENE,MALUNDA,KAYUANGIN,77,71,44,0,0,0,0,34,7,2,32,8,12,9,3,6,70,11,59,8,16,8,8,5,28,6,22,27,JANUARI
SULAWESI BARAT,MAJENE,PAMBOANG,LALAMPANUA,100,80,9,0,0,0,0,5,1,1,3,1,14,8,6,6,80,24,56,9,62,37,25,4,11,11,0,7,JANUARI
SULAWESI BARAT,MAJENE,PAMBOANG,SIRINDU,91,41,27,18,12,11,3,9,4,3,17,6,5,1,4,0,11,7,4,5,1,1,0,0,23,10,13,1,JANUARI
SULAWESI BARAT,MAJENE,PAMBOANG,ADOLANG,61,79,23,17,4,2,0,16,6,1,2,13,3,2,1,1,24,6,18,4,17,3,14,0,72,0,72,18,JANUARI
SULAWESI BARAT,MAJENE,PAMBOANG,BABABULO,43,64,43,9,2,0,0,11,19,13,24,5,2,0,2,0,10,6,4,2,0,0,0,0,1,1,0,0,JANUARI
SULAWESI BARAT,MAJENE,PAMBOANG,BONDE,80,17,6,4,1,0,0,5,0,0,1,5,5,3,2,3,13,13,0,0,10,0,10,0,2,0,2,1,JANUARI
SULAWESI BARAT,MAJENE,PAMBOANG,BETTENG,89,24,22,11,10,7,5,7,9,1,2,1,9,2,7,1,16,5,11,3,1,0,1,0,12,2,10,11,JANUARI
SULAWESI BARAT,MAJENE,PAMBOANG,SIMBANG,100,20,18,12,10,3,1,6,9,1,10,8,9,0,9,0,19,10,9,6,11,5,6,4,24,22,2,19,JANUARI
SULAWESI BARAT,MAJENE,PAMBOANG,BONDE UTARA,53,71,63,61,27,7,3,9,49,0,59,4,0,0,0,0,47,9,38,9,24,12,12,7,32,1,31,17,JANUARI
SULAWESI BARAT,MAJENE,PAMBOANG,BABABULO UTARA,36,74,71,33,7,6,4,51,12,4,1,64,5,3,2,3,38,22,16,10,30,3,27,3,60,43,17,57,JANUARI
SULAWESI BARAT,MAJENE,PAMBOANG,BUTTU PAMBOANG,89,35,16,9,6,5,1,6,1,2,2,11,8,4,4,0,30,15,15,0,27,6,21,6,38,29,9,13,JANUARI
SULAWESI BARAT,MAJENE,PAMBOANG,BANUA ADOLANG,70,80,39,16,2,2,1,26,2,3,10,24,8,4,4,2,63,29,34,20,15,13,2,11,24,0,24,4,JANUARI
SULAWESI BARAT,MAJENE,PAMBOANG,ADOLANG DHUA,68,22,3,1,1,1,0,3,0,0,0,3,3,3,0,2,16,15,1,2,16,16,0,4,11,9,2,6,JANUARI
SULAWESI BARAT,MAJENE,PAMBOANG,TINAMBUNG,49,11,11,8,7,2,1,4,1,2,10,1,1,0,1,0,11,9,2,5,8,5,3,2,15,8,7,1,JANUARI
SULAWESI BARAT,MAJENE,PAMBOANG,PESULOANG,57,59,43,15,0,0,0,23,20,0,17,13,4,4,0,0,43,15,28,8,19,11,8,8,3,0,3,2,JANUARI
SULAWESI BARAT,MAJENE,PAMBOANG,BALOMBONG,91,37,22,5,2,0,0,21,1,0,10,9,10,10,0,9,24,22,2,14,23,13,10,3,36,7,29,16,JANUARI
SULAWESI BARAT,MAJENE,SENDANA,MOSSO,75,46,6,6,4,3,2,3,1,0,1,4,8,6,2,0,26,21,5,19,5,4,1,3,23,19,4,2,JANUARI
SULAWESI BARAT,MAJENE,SENDANA,MOSSO DHUA,98,70,45,13,5,1,1,21,1,13,0,35,1,1,0,0,16,8,8,3,7,5,2,1,16,5,11,8,JANUARI
SULAWESI BARAT,MAJENE,SENDANA,TOTOLISI SENDANA,31,26,8,6,3,1,1,5,0,0,5,2,1,0,1,0,15,11,4,10,7,1,6,1,19,12,7,2,JANUARI
SULAWESI BARAT,MAJENE,SENDANA,TALLUBANUA,49,72,70,23,21,2,1,32,8,23,37,9,5,3,2,0,58,43,15,41,3,2,1,2,20,9,11,2,JANUARI
SULAWESI BARAT,MAJENE,SENDANA,LALATEDZONG,92,25,14,11,4,1,0,7,4,0,8,3,1,1,0,0,20,7,13,5,4,2,2,2,6,3,3,5,JANUARI
SULAWESI BARAT,MAJENE,SENDANA,BINANGA,49,52,6,0,0,0,0,5,1,0,2,2,8,2,6,2,46,19,27,10,40,7,33,0,71,61,10,14,JANUARI
SULAWESI BARAT,MAJENE,SENDANA,PUTTADA,46,22,13,8,5,4,1,4,3,0,1,9,1,0,1,0,15,14,1,9,15,12,3,4,20,3,17,8,JANUARI
SULAWESI BARAT,MAJENE,SENDANA,PAMINGGALAN,58,36,7,3,1,1,0,6,0,0,4,3,9,8,1,4,12,12,0,5,12,10,2,5,2,1,1,1,JANUARI
SULAWESI BARAT,MAJENE,SENDANA,LEPPANGANG,33,13,13,4,0,0,0,1,11,1,6,5,2,1,1,1,12,10,2,4,12,3,9,0,17,15,2,16,JANUARI
SULAWESI BARAT,MAJENE,SENDANA,PUNDAU,94,37,19,6,5,3,0,2,16,0,0,6,17,17,0,14,32,11,21,6,28,0,28,0,3,1,2,2,JANUARI
SULAWESI BARAT,MAJENE,SENDANA,SENDANA,78,65,24,20,13,13,8,13,0,3,8,12,4,2,2,2,45,5,40,1,34,23,11,10,70,33,37,3,JANUARI
SULAWESI BARAT,MAJENE,SENDANA,BANUA SENDANA,42,48,13,3,0,0,0,8,0,3,13,0,4,4,0,0,40,29,11,18,21,8,13,2,37,25,12,32,JANUARI
SULAWESI BARAT,MAJENE,SENDANA,TALLUBANUA UTARA,97,38,23,23,10,6,0,22,0,0,16,5,15,7,8,6,31,5,26,4,18,9,9,8,44,44,0,24,JANUARI
SULAWESI BARAT,MAJENE,SENDANA,LIMBORO RAMBU-RAMBU,73,18,8,7,2,1,0,1,3,0,8,0,4,4,0,0,11,6,5,3,4,0,4,0,7,0,7,4,JANUARI
SULAWESI BARAT,MAJENE,SENDANA,LIMBUA,47,10,6,2,0,0,0,4,1,0,4,2,2,0,2,0,10,5,5,0,10,7,3,4,0,0,0,0,JANUARI
SULAWESI BARAT,MAJENE,SENDANA,BUKIT SAMANG,34,11,6,5,5,3,2,1,2,0,4,1,4,3,1,0,11,10,1,10,9,3,6,3,12,12,0,11,JANUARI
SULAWESI BARAT,MAJENE,TAMMERODO SENDANA,SEPPONG,88,37,0,0,0,0,0,0,0,0,0,0,17,16,1,16,17,9,8,5,5,5,0,4,24,6,18,0,JANUARI
SULAWESI BARAT,MAJENE,TAMMERODO SENDANA,TAMMERODO,35,59,6,4,4,2,1,3,1,0,4,2,6,4,2,1,26,18,8,5,16,1,15,0,45,23,22,40,JANUARI
SULAWESI BARAT,MAJENE,TAMMERODO SENDANA,ULIDANG,92,43,35,31,1,0,0,34,0,0,1,4,3,2,1,0,12,9,3,2,6,1,5,0,15,0,15,15,JANUARI
SULAWESI BARAT,MAJENE,TAMMERODO SENDANA,TALLAMBALAO,100,53,18,5,2,2,0,1,2,5,4,12,18,11,7,8,24,9,15,5,15,2,13,0,6,2,4,2,JANUARI
SULAWESI BARAT,MAJENE,TAMMERODO SENDANA,TAMMERODO UTARA,83,49,28,11,2,1,1,17,10,0,17,9,5,4,1,4,26,16,10,3,21,14,7,2,9,6,3,2,JANUARI
SULAWESI BARAT,MAJENE,TAMMERODO SENDANA,MANYAMBA,72,51,39,3,3,0,0,32,4,3,6,26,4,1,3,1,46,45,1,9,26,21,5,2,61,22,39,28,JANUARI
SULAWESI BARAT,MAJENE,TAMMERODO SENDANA,AWO,37,77,43,1,0,0,0,3,37,3,8,34,0,0,0,0,11,10,1,1,0,0,0,0,7,5,2,7,JANUARI
SULAWESI BARAT,MAJENE,TUBO SENDANA,ONANG,43,30,14,4,0,0,0,9,2,1,7,7,8,8,0,8,30,8,22,4,24,21,3,4,14,2,12,2,JANUARI
SULAWESI BARAT,MAJENE,TUBO SENDANA,TUBO,79,13,11,2,0,0,0,11,0,0,7,0,12,5,7,5,13,5,8,5,8,1,7,1,13,4,9,1,JANUARI
SULAWESI BARAT,MAJENE,TUBO SENDANA,ONANG UTARA,86,26,22,19,6,4,1,21,0,0,8,0,16,14,2,2,26,26,0,26,1,1,0,0,4,3,1,2,JANUARI
SULAWESI BARAT,MAJENE,TUBO SENDANA,TUBO SELATAN,45,32,10,7,5,2,2,6,2,0,3,2,3,2,1,1,27,18,9,4,20,5,15,3,7,7,0,2,JANUARI
SULAWESI BARAT,MAJENE,TUBO SENDANA,BONDE BONDE,91,24,2,1,0,0,0,1,1,0,0,0,15,8,7,1,10,7,3,5,2,2,0,0,3,3,0,0,JANUARI
SULAWESI BARAT,MAJENE,TUBO SENDANA,TUBO TENGAH,71,29,9,6,6,4,1,6,2,0,0,2,0,0,0,0,12,10,2,10,12,3,9,1,7,6,1,0,JANUARI
SULAWESI BARAT,MAJENE,TUBO SENDANA,TUBO POANG,72,77,74,56,4,2,1,48,1,15,25,0,3,1,2,0,69,36,33,32,29,24,5,21,8,3,5,2,JANUARI
SULAWESI BARAT,MAJENE,ULUMANDA,KABIRAAN,74,78,20,4,3,2,2,3,8,4,20,0,7,0,7,0,51,22,29,18,48,7,41,0,19,9,10,2,JANUARI
SULAWESI BARAT,MAJENE,ULUMANDA,SAMBABO,59,40,5,5,3,3,0,1,4,0,2,3,6,4,2,1,17,5,12,5,7,0,7,0,31,30,1,2,JANUARI
SULAWESI BARAT,MAJENE,ULUMANDA,TANDEALLO,100,45,44,3,1,1,0,25,10,1,36,0,1,1,0,1,12,10,2,10,3,1,2,0,12,8,4,7,JANUARI
SULAWESI BARAT,MAJENE,ULUMANDA,ULUMANDA,57,46,38,16,10,8,6,14,6,4,26,7,3,0,3,0,18,16,2,12,16,6,10,4,14,0,14,9,JANUARI
SULAWESI BARAT,MAJENE,ULUMANDA,SALUTAMBUNG,31,45,36,36,15,2,2,26,2,5,26,5,6,6,0,4,31,10,21,9,19,8,11,2,25,3,22,4,JANUARI
SULAWESI BARAT,MAJENE,ULUMANDA,POPENGA,39,23,22,18,3,0,0,2,14,0,7,8,7,6,1,3,20,8,12,5,4,1,3,0,6,2,4,6,JANUARI
SULAWESI BARAT,MAJENE,ULUMANDA,SULAI,53,39,2,1,0,0,0,0,2,0,0,0,7,4,3,3,25,21,4,4,20,5,15,3,19,13,6,11,JANUARI
SULAWESI BARAT,MAJENE,ULUMANDA,PANGGALO,46,44,12,2,1,1,0,9,1,1,8,4,5,5,0,1,36,18,18,13,19,7,12,3,43,17,26,32,JANUARI
SULAWESI BARAT,MAMASA,ARALLE,ARALLE,60,41,35,35,16,5,1,18,3,1,19,14,8,8,0,3,34,22,12,2,15,11,4,7,25,21,4,16,JANUARI
SULAWESI BARAT,MAMASA,ARALLE,RALLE ANAK,98,33,29,25,13,4,2,18,8,1,29,0,2,1,1,1,30,15,15,5,5,3,2,3,24,4,20,14,JANUARI
SULAWESI BARAT,MAMASA,ARALLE,PANETEAN,100,51,9,1,1,0,0,5,1,1,4,1,20,18,2,2,18,15,3,9,10,6,4,0,10,9,1,4,JANUARI
SULAWESI BARAT,MAMASA,ARALLE,UHAILANU,43,42,28,8,0,0,0,15,7,2,17,4,8,7,1,5,15,5,10,0,0,0,0,0,0,0,0,0,JANUARI
SULAWESI BARAT,MAMASA,ARALLE,ARALLE UTARA,90,36,9,8,1,1,1,1,7,0,5,0,8,8,0,5,33,13,20,12,32,2,30,1,29,7,22,12,JANUARI
SULAWESI BARAT,MAMASA,ARALLE,UHAIDAHO,54,37,1,0,0,0,0,0,1,0,0,1,3,1,2,0,23,14,9,10,18,10,8,5,6,5,1,2,JANUARI
SULAWESI BARAT,MAMASA,ARALLE,BARURU,79,34,8,8,6,6,2,2,0,0,1,6,7,6,1,5,12,9,3,7,4,2,2,2,24,10,14,18,JANUARI
SULAWESI BARAT,MAMASA,ARALLE,RALLEANAK UTARA,36,48,34,16,8,6,3,28,1,2,23,8,1,0,1,0,42,37,5,20,4,0,4,0,32,24,8,15,JANUARI
SULAWESI BARAT,MAMASA,ARALLE,PAMOSEANG PANGGA,73,80,41,14,7,7,2,19,14,3,9,5,7,4,3,4,32,6,26,3,28,12,16,7,24,0,24,12,JANUARI
SULAWESI BARAT,MAMASA,ARALLE,KALABE,68,10,10,0,0,0,0,2,4,4,1,4,10,1,9,1,10,9,1,5,7,7,0,5,6,2,4,5,JANUARI
SULAWESI BARAT,MAMASA,ARALLE,ARALLE SELATAN,67,65,23,8,1,0,0,11,1,11,9,2,12,10,2,0,33,8,25,2,8,7,1,5,23,4,19,18,JANUARI
SULAWESI BARAT,MAMASA,ARALLE,HAHANGAN,61,12,9,2,2,0,0,8,0,1,8,0,5,2,3,1,11,6,5,5,4,4,0,4,8,5,3,3,JANUARI
SULAWESI BARAT,MAMASA,BALLA,BALLA,33,28,2,1,1,1,0,0,2,0,2,0,4,2,2,1,15,8,7,5,13,5,8,2,1,1,0,1,JANUARI
SULAWESI BARAT,MAMASA,BALLA,BALLA BARAT,88,32,17,12,3,2,1,16,0,0,12,1,9,2,7,0,16,11,5,8,7,4,3,3,21,12,9,1,JANUARI
SULAWESI BARAT,MAMASA,BALLA,BALLA SATANETEAN,95,73,26,11,8,0,0,26,0,0,24,2,5,5,0,5,73,15,58,7,10,10,0,10,20,11,9,8,JANUARI
SULAWESI BARAT,MAMASA,BALLA,BALLA TUMUKA,83,10,9,4,4,2,2,6,1,0,1,4,3,0,3,0,10,10,0,7,8,1,7,1,8,7,1,7,JANUARI
SULAWESI BARAT,MAMASA,BALLA,SEPAKUAN,56,53,53,53,23,12,11,13,5,19,53,0,7,0,7,0,53,13,40,4,37,19,18,1,3,2,1,3,JANUARI
SULAWESI BARAT,MAMASA,BALLA,PIDARA,48,33,17,5,5,4,0,14,2,1,2,4,6,2,4,0,33,17,16,15,9,3,6,2,18,12,6,11,JANUARI
SULAWESI BARAT,MAMASA,BALLA,BAMBAPUANG,41,20,9,0,0,0,0,3,3,0,4,5,0,0,0,0,17,11,6,11,13,1,12,1,6,6,0,4,JANUARI
SULAWESI BARAT,MAMASA,BALLA,BALLA TIMUR,61,45,29,9,3,0,0,23,0,3,19,4,7,5,2,1,36,31,5,5,8,2,6,2,26,9,17,8,JANUARI
SULAWESI BARAT,MAMASA,BAMBANG,MOKALLANG,75,18,12,3,1,1,1,4,7,0,1,4,12,12,0,3,14,6,8,0,3,3,0,3,13,7,6,6,JANUARI
SULAWESI BARAT,MAMASA,BAMBANG,MASOSO,97,30,11,7,7,2,1,7,0,2,3,4,0,0,0,0,10,7,3,7,2,0,2,0,4,3,1,4,JANUARI
SULAWESI BARAT,MAMASA,BAMBANG,SALUASSING,30,15,11,9,3,1,1,0,1,5,2,1,5,0,5,0,15,12,3,4,1,0,1,0,6,6,0,2,JANUARI
SULAWESI BARAT,MAMASA,BAMBANG,SALUBULO,58,23,14,3,0,0,0,9,2,2,11,3,7,5,2,0,18,11,7,0,5,4,1,0,3,3,0,2,JANUARI
SULAWESI BARAT,MAMASA,BAMBANG,SALUKADI,32,30,9,7,4,1,1,6,1,1,4,5,1,0,1,0,18,12,6,0,16,11,5,10,32,23,9,7,JANUARI
SULAWESI BARAT,MAMASA,BAMBANG,SALUKEPOPOK,32,50,18,0,0,0,0,2,2,2,16,0,1,0,1,0,14,11,3,0,2,1,1,1,27,21,6,21,JANUARI
SULAWESI BARAT,MAMASA,BAMBANG,ULUMAMBI BARAT,70,48,21,21,17,13,13,2,5,1,19,1,1,0,1,0,24,17,7,6,1,0,1,0,0,0,0,0,JANUARI
SULAWESI BARAT,MAMASA,BAMBANG,LIMBADEBATA,92,26,2,0,0,0,0,0,1,0,2,0,2,0,2,0,17,16,1,2,13,11,2,6,7,7,0,5,JANUARI
SULAWESI BARAT,MAMASA,BAMBANG,TANETE TOMBA,76,59,0,0,0,0,0,0,0,0,0,0,7,5,2,0,21,20,1,2,2,0,2,0,20,14,6,16,JANUARI
SULAWESI BARAT,MAMASA,BAMBANG,BAMBANG,32,17,5,2,1,0,0,0,0,5,4,0,3,2,1,0,12,12,0,8,8,6,2,5,9,3,6,8,JANUARI
SULAWESI BARAT,MAMASA,BAMBANG,RANTELEMO,57,74,10,9,8,6,2,0,8,0,7,2,3,1,2,1,22,16,6,5,7,0,7,0,11,6,5,1,JANUARI
SULAWESI BARAT,MAMASA,BAMBANG,SALUDENGEN,61,19,16,1,0,0,0,8,8,0,6,8,10,0,10,0,19,8,11,0,8,0,8,0,20,0,20,12,JANUARI
SULAWESI BARAT,MAMASA,BAMBANG,ULUMAMBI,74,13,10,5,3,3,3,3,0,3,7,0,13,5,8,0,12,11,1,2,4,1,3,1,13,0,13,12,JANUARI
SULAWESI BARAT,MAMASA,BAMBANG,BAMBANG TIMUR,53,41,41,37,30,14,11,9,14,6,24,15,8,1,7,1,15,6,9,5,8,8,0,7,28,27,1,25,JANUARI
SULAWESI BARAT,MAMASA,BAMBANG,MINANGA,78,28,25,11,11,8,7,1,6,5,3,0,5,1,4,1,12,11,1,1,5,0,5,0,7,0,7,1,JANUARI
SULAWESI BARAT,MAMASA,BAMBANG,SIKAMASE,46,78,23,0,0,0,0,18,3,1,19,1,8,8,0,5,56,53,3,7,4,2,2,0,11,11,0,0,JANUARI
SULAWESI BARAT,MAMASA,BAMBANG,RANTETARIMA,86,24,6,5,5,3,3,3,0,0,6,0,0,0,0,0,20,17,3,4,20,16,4,2,24,19,5,22,JANUARI
SULAWESI BARAT,MAMASA,BAMBANG,SALURURU,63,48,43,13,10,2,2,34,6,0,30,9,8,4,4,4,40,26,14,24,15,14,1,7,44,37,7,31,JANUARI
SULAWESI BARAT,MAMASA,BAMBANG,SALUTABANG,94,30,19,10,5,5,5,1,13,0,1,13,16,8,8,8,26,20,6,18,13,4,9,4,29,7,22,8,JANUARI
SULAWESI BARAT,MAMASA,BAMBANG,BALATANA,96,38,25,1,0,0,0,8,3,7,1,11,10,9,1,3,25,13,12,2,6,0,6,0,9,3,6,3,JANUARI
SULAWESI BARAT,MAMASA,BUNTUMALANGKA,BUNTUMALANGKA,33,17,8,0,0,0,0,4,1,0,6,0,2,2,0,2,10,6,4,1,6,3,3,1,17,9,8,1,JANUARI
SULAWESI BARAT,MAMASA,BUNTUMALANGKA,RANTEBERAN,37,66,5,1,0,0,0,5,0,0,1,2,1,0,1,0,10,8,2,5,4,3,1,3,39,27,12,30,JANUARI
SULAWESI BARAT,MAMASA,BUNTUMALANGKA,KEBANGA,32,25,16,6,0,0,0,12,0,4,8,2,6,3,3,3,21,17,4,15,18,15,3,3,25,14,11,15,JANUARI
SULAWESI BARAT,MAMASA,BUNTUMALANGKA,SALURINDU,34,13,11,8,1,1,1,4,3,1,3,0,3,1,2,0,12,11,1,5,8,3,5,2,5,0,5,2,JANUARI
SULAWESI BARAT,MAMASA,BUNTUMALANGKA,TAORA,34,28,24,0,0,0,0,3,0,0,7,10,4,1,3,1,13,8,5,3,12,2,10,1,12,1,11,2,JANUARI
SULAWESI BARAT,MAMASA,BUNTUMALANGKA,KABAE,63,34,11,9,4,3,3,1,6,0,9,1,12,9,3,7,16,14,2,12,16,11,5,6,35,18,17,14,JANUARI
SULAWESI BARAT,MAMASA,BUNTUMALANGKA,SALUTAMBUN BARAT,51,32,31,22,12,0,0,22,5,1,7,23,3,1,2,1,12,9,3,3,0,0,0,0,4,1,3,3,JANUARI
SULAWESI BARAT,MAMASA,BUNTUMALANGKA,PENATANGAN,69,70,47,31,10,1,0,26,2,19,16,18,2,1,1,1,20,10,10,6,4,4,0,4,42,31,11,13,JANUARI
SULAWESI BARAT,MAMASA,BUNTUMALANGKA,SALUTAMBUN TIMUR,78,51,1,1,0,0,0,1,0,0,1,0,3,1,2,1,25,25,0,11,1,0,1,0,8,7,1,7,JANUARI
SULAWESI BARAT,MAMASA,BUNTUMALANGKA,SALUTAMBUN,59,73,20,11,2,2,0,8,3,4,13,0,10,0,10,0,70,9,61,8,41,5,36,1,37,26,11,14,JANUARI
SULAWESI BARAT,MAMASA,BUNTUMALANGKA,ARALLE TIMUR,42,35,25,8,5,4,0,12,4,7,6,1,6,3,3,2,34,28,6,17,10,2,8,1,10,8,2,6,JANUARI
SULAWESI BARAT,MAMASA,MAMASA,MAMASA,30,71,9,5,0,0,0,7,2,0,0,8,4,2,2,1,21,14,7,8,12,1,11,0,41,35,6,35,JANUARI
SULAWESI BARAT,MAMASA,MAMASA,RAMBUSARATU,75,66,62,6,1,0,0,53,2,3,17,34,8,7,1,7,27,22,5,5,18,12,6,3,1,1,0,0,JANUARI
SULAWESI BARAT,MAMASA,MAMASA,OSANGO,82,54,40,33,3,0,0,38,0,1,16,1,13,4,9,4,31,29,2,23,31,0,31,0,15,5,10,1,JANUARI
SULAWESI BARAT,MAMASA,MAMASA,LAMBANAN,61,66,24,10,2,2,0,7,17,0,14,0,4,3,1,1,40,16,24,15,31,18,13,12,16,13,3,11,JANUARI
SULAWESI BARAT,MAMASA,MAMASA,LEMBANA SALULO,77,12,5,0,0,0,0,5,0,0,1,2,4,3,1,0,10,6,4,0,2,1,1,1,9,9,0,5,JANUARI
SULAWESI BARAT,MAMASA,MAMASA,TAUPE,76,15,14,13,11,2,2,6,2,3,3,6,15,15,0,10,11,8,3,6,0,0,0,0,4,0,4,2,JANUARI
SULAWESI BARAT,MAMASA,MAMASA,BUNTU BUDA,100,17,1,0,0,0,0,0,0,1,0,1,6,3,3,2,10,10,0,10,4,4,0,0,7,2,5,6,JANUARI
SULAWESI BARAT,MAMASA,MAMASA,TONDOK BAKARU,34,76,60,53,53,25,3,20,14,17,27,27,5,0,5,0,37,31,6,23,32,23,9,13,25,1,24,9,JANUARI
SULAWESI BARAT,MAMASA,MAMASA,PEBASSIAN,41,61,36,24,0,0,0,28,8,0,27,9,7,1,6,1,25,25,0,17,15,12,3,6,34,29,5,17,JANUARI
SULAWESI BARAT,MAMASA,MAMASA,MAMBULILING,42,22,0,0,0,0,0,0,0,0,0,0,5,3,2,3,18,6,12,2,13,3,10,3,26,14,12,26,JANUARI
SULAWESI BARAT,MAMASA,MAMASA,BOMBONG LAMBE,77,56,56,20,4,1,1,14,14,11,23,19,10,6,4,3,37,19,18,8,15,1,14,1,54,23,31,31,JANUARI
SULAWESI BARAT,MAMASA,MAMASA,BUBUN BATU,54,61,54,19,9,9,7,37,3,4,1,39,8,2,6,1,28,13,15,7,0,0,0,0,33,7,26,3,JANUARI
SULAWESI BARAT,MAMASA,MAMBI,MAMBI,70,22,1,1,0,0,0,0,1,0,1,0,1,1,0,1,18,8,10,6,0,0,0,0,7,5,2,1,JANUARI
SULAWESI BARAT,MAMASA,MAMBI,TALIPUKKI,55,78,34,10,8,2,2,23,4,1,25,9,9,2,7,2,49,34,15,33,28,18,10,8,49,24,25,31,JANUARI
SULAWESI BARAT,MAMASA,MAMBI,RANTEBULAHAN,88,42,41,41,40,14,12,20,2,4,40,0,9,2,7,0,12,7,5,5,9,2,7,1,27,9,18,9,JANUARI
SULAWESI BARAT,MAMASA,MAMBI,SONDONGLAYU,99,65,10,4,2,1,0,3,1,5,0,9,15,11,4,1,57,21,36,13,37,12,25,0,29,29,0,3,JANUARI
SULAWESI BARAT,MAMASA,MAMBI,SALUBANUA,43,59,51,44,1,1,0,18,31,2,50,0,8,6,2,6,51,35,16,23,18,17,1,3,17,9,8,13,JANUARI
SULAWESI BARAT,MAMASA,MAMBI,TAPALINA,64,52,30,0,0,0,0,26,4,0,29,0,7,3,4,3,17,15,2,13,6,6,0,0,23,6,17,14,JANUARI
SULAWESI BARAT,MAMASA,MAMBI,SENDANA,97,45,27,25,16,11,5,5,3,12,10,14,18,4,14,3,34,30,4,22,25,15,10,3,2,1,1,0,JANUARI
SULAWESI BARAT,MAMASA,MAMBI,PAMOSEAN,66,73,11,8,2,0,0,11,0,0,11,0,3,2,1,2,73,61,12,5,7,6,1,3,13,9,4,11,JANUARI
SULAWESI BARAT,MAMASA,MAMBI,SELUMAKA,94,70,64,33,10,2,2,43,11,1,42,0,15,9,6,8,59,31,28,4,47,25,22,15,89,68,21,77,JANUARI
SULAWESI BARAT,MAMASA,MAMBI,BUJUNG MANURUNG,90,15,15,4,1,1,1,4,6,0,5,5,3,0,3,0,11,11,0,6,6,3,3,1,11,6,5,11,JANUARI
SULAWESI BARAT,MAMASA,MAMBI,SALU ALO,58,30,14,2,2,2,2,6,2,2,12,2,8,1,7,0,17,12,5,0,7,6,1,2,18,16,2,14,JANUARI
SULAWESI BARAT,MAMASA,MAMBI,INDOBANUA,48,53,36,0,0,0,0,4,28,2,36,0,8,3,5,2,13,10,3,8,8,8,0,1,8,4,4,4,JANUARI
SULAWESI BARAT,MAMASA,MAMBI,SALUDURIAN,34,29,28,23,6,5,4,4,17,0,21,4,0,0,0,0,20,6,14,1,5,0,5,0,13,3,10,11,JANUARI
SULAWESI BARAT,MAMASA,MEHALAAN,MEHALAAN,92,65,15,3,1,0,0,10,2,3,15,0,16,7,9,4,23,19,4,5,12,6,6,3,32,0,32,26,JANUARI
SULAWESI BARAT,MAMASA,MEHALAAN,BOTTENG,95,19,16,4,0,0,0,11,0,5,3,4,3,0,3,0,15,11,4,5,0,0,0,0,3,0,3,3,JANUARI
SULAWESI BARAT,MAMASA,MEHALAAN,SALUKONTA,34,23,6,5,2,0,0,0,2,1,2,1,1,1,0,0,17,12,5,9,15,9,6,7,17,14,3,8,JANUARI
SULAWESI BARAT,MAMASA,MEHALAAN,MESAKADA,33,73,68,62,26,8,2,61,1,2,22,42,1,0,1,0,73,5,68,0,9,0,9,0,60,3,57,11,JANUARI
SULAWESI BARAT,MAMASA,MEHALAAN,MEHALAAN BARAT,42,43,8,2,2,0,0,5,2,0,1,1,1,0,1,0,36,22,14,20,6,6,0,3,5,4,1,0,JANUARI
SULAWESI BARAT,MAMASA,MEHALAAN,SALUAHOK,58,80,46,19,0,0,0,32,6,8,19,25,9,0,9,0,16,8,8,6,5,2,3,0,25,22,3,1,JANUARI
SULAWESI BARAT,MAMASA,MEHALAAN,SALUBALO,88,36,34,4,1,1,1,12,12,1,17,10,1,0,1,0,11,7,4,5,3,0,3,0,16,11,5,16,JANUARI
SULAWESI BARAT,MAMASA,MEHALAAN,PASSEMBUK,71,73,43,8,2,2,2,20,16,2,27,14,8,7,1,5,52,18,34,9,17,8,9,5,16,9,7,5,JANUARI
SULAWESI BARAT,MAMASA,MEHALAAN,KONDO,31,26,9,4,1,1,1,5,2,0,3,0,5,2,3,2,15,11,4,4,8,4,4,0,0,0,0,0,JANUARI
SULAWESI BARAT,MAMASA,MEHALAAN,LEKO SUKAMAJU,84,69,13,7,6,6,5,6,1,1,11,1,1,0,1,0,46,37,9,9,45,22,23,10,8,8,0,4,JANUARI
SULAWESI BARAT,MAMASA,MEHALAAN,ULUMEA,92,77,72,41,1,1,1,14,49,7,27,4,0,0,0,0,64,16,48,10,51,25,26,15,62,2,60,29,JANUARI
SULAWESI BARAT,MAMASA,MESSAWA,MESSAWA,85,17,10,1,0,0,0,8,0,0,2,7,9,6,3,6,16,10,6,7,6,4,2,0,12,3,9,3,JANUARI
SULAWESI BARAT,MAMASA,MESSAWA,RIPPUNG,93,19,18,8,4,1,1,3,6,1,17,0,18,7,11,1,13,11,2,7,13,0,13,0,25,17,8,6,JANUARI
SULAWESI BARAT,MAMASA,MESSAWA,MAKUANG,74,48,17,8,2,1,0,1,5,6,0,6,2,2,0,0,23,23,0,16,4,3,1,3,27,9,18,21,JANUARI
SULAWESI BARAT,MAMASA,MESSAWA,SEPANG,62,60,18,13,7,4,1,15,1,1,11,7,5,2,3,0,25,22,3,10,20,11,9,6,31,26,5,11,JANUARI
SULAWESI BARAT,MAMASA,MESSAWA,MALIMBONG,88,50,11,8,1,0,0,0,4,3,9,0,0,0,0,0,47,17,30,6,38,1,37,0,14,5,9,4,JANUARI
SULAWESI BARAT,MAMASA,MESSAWA,MATANDE,100,58,16,3,1,0,0,3,2,8,2,6,17,6,11,0,56,33,23,13,24,6,18,5,56,12,44,5,JANUARI
SULAWESI BARAT,MAMASA,MESSAWA,SIPAI,59,77,10,10,3,2,1,4,2,0,9,1,1,1,0,1,45,27,18,22,6,0,6,0,41,11,30,24,JANUARI
SULAWESI BARAT,MAMASA,MESSAWA,PASMA MAMBU,75,42,41,12,10,4,3,5,6,14,41,0,8,1,7,1,10,6,4,1,6,0,6,0,11,6,5,10,JANUARI
SULAWESI BARAT,MAMASA,MESSAWA,TANETE BATU,67,57,57,16,15,14,7,17,2,16,37,0,7,5,2,0,29,17,12,16,9,3,6,0,33,15,18,32,JANUARI
SULAWESI BARAT,MAMASA,NOSU,NOSU,39,70,62,9,4,3,2,58,2,0,34,9,7,6,1,6,61,47,14,17,48,44,4,3,9,4,5,1,JANUARI
SULAWESI BARAT,MAMASA,NOSU,MINANGA,90,45,14,12,11,3,3,8,3,0,2,10,14,14,0,14,14,10,4,3,7,6,1,0,19,12,7,0,JANUARI
SULAWESI BARAT,MAMASA,NOSU,BATUPAPAN,43,27,1,1,1,0,0,0,0,0,1,0,0,0,0,0,20,18,2,17,1,0,1,0,19,10,9,11,JANUARI
SULAWESI BARAT,MAMASA,NOSU,MASEWWE,56,27,7,4,3,2,1,5,1,0,4,3,3,0,3,0,13,12,1,10,11,10,1,2,13,0,13,12,JANUARI
SULAWESI BARAT,MAMASA,NOSU,SIWI,73,54,40,40,32,6,4,12,1,0,37,0,3,3,0,3,47,38,9,17,11,2,9,0,23,19,4,9,JANUARI
SULAWESI BARAT,MAMASA,NOSU,MINANGA TIMUR,31,50,18,13,2,2,1,17,0,0,5,3,2,0,2,0,50,22,28,3,6,1,5,1,35,26,9,21,JANUARI
SULAWESI BARAT,MAMASA,NOSU,PARINDING,61,65,13,10,7,4,0,9,0,0,3,1,10,1,9,0,23,22,1,15,10,3,7,0,6,5,1,1,JANUARI
SULAWESI BARAT,MAMASA,PANA,PANA,41,58,18,11,1,1,0,8,7,3,3,13,1,1,0,0,24,7,17,1,23,18,5,15,29,13,16,17,JANUARI
SULAWESI BARAT,MAMASA,PANA,MANIPI,40,72,51,34,23,14,2,31,5,2,15,27,8,3,5,2,53,5,48,5,35,23,12,5,74,8,66,24,JANUARI
SULAWESI BARAT,MAMASA,PANA,MAMULLU,77,30,20,14,11,0,0,8,11,1,10,3,14,3,11,3,16,8,8,2,2,0,2,0,11,5,6,4,JANUARI
SULAWESI BARAT,MAMASA,PANA,SAPAN,52,44,20,16,3,3,3,9,0,7,20,0,6,6,0,3,44,16,28,9,6,3,3,0,11,10,1,5,JANUARI
SULAWESI BARAT,MAMASA,PANA,DATUBARINGAN,94,57,3,1,0,0,0,2,0,0,2,0,18,17,1,1,32,15,17,5,16,9,7,5,43,6,37,38,JANUARI
SULAWESI BARAT,MAMASA,PANA,PANURA,74,75,4,0,0,0,0,3,1,0,1,2,2,1,1,1,75,62,13,55,18,3,15,3,45,24,21,31,JANUARI
SULAWESI BARAT,MAMASA,PANA,TALLANG BULAWAN,33,40,11,11,4,3,2,4,5,0,9,0,4,3,1,0,13,7,6,4,8,7,1,2,25,7,18,13,JANUARI
SULAWESI BARAT,MAMASA,PANA,KARAKA,54,15,3,1,1,1,1,1,0,1,1,2,9,4,5,1,15,6,9,3,5,1,4,0,0,0,0,0,JANUARI
SULAWESI BARAT,MAMASA,PANA,ULUSALU,96,67,1,0,0,0,0,1,0,0,0,0,9,3,6,3,54,18,36,1,1,1,0,1,17,6,11,17,JANUARI
SULAWESI BARAT,MAMASA,PANA,WERI,42,72,4,4,4,1,1,2,1,0,1,1,8,7,1,7,43,7,36,4,34,22,12,11,77,70,7,56,JANUARI
SULAWESI BARAT,MAMASA,PANA,SALUTAMBUN,60,34,2,1,1,0,0,1,1,0,2,0,5,5,0,0,16,9,7,0,16,14,2,5,16,4,12,7,JANUARI
SULAWESI BARAT,MAMASA,PANA,SALOAN,87,15,12,6,0,0,0,2,5,2,7,0,17,12,5,11,11,5,6,3,4,3,1,0,8,1,7,5,JANUARI
SULAWESI BARAT,MAMASA,PANA,ULUSALU INDAH,56,59,56,23,0,0,0,46,6,1,8,31,10,1,9,0,15,5,10,4,15,10,5,8,6,0,6,5,JANUARI
SULAWESI BARAT,MAMASA,RANTEBULAHAN TIMUR,SALUMOKANAN,35,67,58,5,4,1,0,45,7,5,34,0,4,3,1,2,18,6,12,5,9,8,1,5,20,7,13,2,JANUARI
SULAWESI BARAT,MAMASA,RANTEBULAHAN TIMUR,SALUMOKANAN BARAT,59,21,7,4,4,2,2,4,1,0,4,2,7,1,6,1,10,8,2,6,3,3,0,0,10,6,4,2,JANUARI
SULAWESI BARAT,MAMASA,RANTEBULAHAN TIMUR,BUANGIN,47,34,0,0,0,0,0,0,0,0,0,0,2,1,1,1,34,7,27,3,9,7,2,6,26,23,3,2,JANUARI
SULAWESI BARAT,MAMASA,RANTEBULAHAN TIMUR,BAMBANG BUDA,48,27,5,2,1,0,0,1,1,1,1,3,5,2,3,1,14,11,3,2,12,5,7,4,27,20,7,6,JANUARI
SULAWESI BARAT,MAMASA,RANTEBULAHAN TIMUR,LEKO,94,21,5,1,0,0,0,2,0,0,2,1,8,2,6,1,18,7,11,3,10,5,5,3,24,19,5,0,JANUARI
SULAWESI BARAT,MAMASA,RANTEBULAHAN TIMUR,KIRAK,36,30,5,1,0,0,0,3,1,0,3,1,1,0,1,0,30,12,18,1,25,18,7,4,6,5,1,4,JANUARI
SULAWESI BARAT,MAMASA,RANTEBULAHAN TIMUR,SALUMOKANAN UTARA,50,16,3,3,2,0,0,0,1,1,3,0,5,1,4,0,12,10,2,6,9,1,8,0,2,1,1,0,JANUARI
SULAWESI BARAT,MAMASA,RANTEBULAHAN TIMUR,SAMPALE,31,57,8,1,1,0,0,7,0,1,8,0,4,1,3,0,43,36,7,28,29,9,20,2,42,28,14,11,JANUARI
SULAWESI BARAT,MAMASA,SESENAPADANG,OROBUA,31,79,7,7,1,1,0,3,1,1,3,0,2,1,1,1,61,26,35,11,2,0,2,0,32,12,20,18,JANUARI
SULAWESI BARAT,MAMASA,SESENAPADANG,PALADAN,66,80,32,8,5,5,4,15,3,2,16,3,7,2,5,1,61,18,43,17,3,3,0,0,39,2,37,26,JANUARI
SULAWESI BARAT,MAMASA,SESENAPADANG,OROBUA TIMUR,83,23,8,5,3,3,1,0,5,2,8,0,15,6,9,6,11,6,5,2,6,1,5,1,11,11,0,0,JANUARI
SULAWESI BARAT,MAMASA,SESENAPADANG,RANTE PUANG,38,36,15,14,6,5,4,7,4,0,1,11,1,1,0,1,28,25,3,4,5,0,5,0,12,5,7,1,JANUARI
SULAWESI BARAT,MAMASA,SESENAPADANG,SATENETEAN,37,46,6,1,1,1,0,2,3,0,3,3,6,1,5,1,17,6,11,1,8,1,7,1,19,11,8,14,JANUARI
SULAWESI BARAT,MAMASA,SESENAPADANG,LISUAN ADA,60,11,7,7,6,1,1,4,1,1,1,6,0,0,0,0,11,5,6,2,1,0,1,0,8,0,8,8,JANUARI
SULAWESI BARAT,MAMASA,SESENAPADANG,OROBUA SELATAN,82,48,8,0,0,0,0,0,7,0,6,0,8,2,6,1,41,5,36,1,12,12,0,0,9,1,8,1,JANUARI
SULAWESI BARAT,MAMASA,SESENAPADANG,MALANGKENA PADANG,93,78,38,36,23,6,5,1,7,7,6,21,5,4,1,0,34,21,13,11,2,2,0,0,6,6,0,1,JANUARI
SULAWESI BARAT,MAMASA,SESENAPADANG,MALIMBONG,58,47,47,31,13,9,2,36,4,4,42,0,7,5,2,2,17,17,0,13,0,0,0,0,7,1,6,7,JANUARI
SULAWESI BARAT,MAMASA,SESENAPADANG,MARAMPAN OROBUA,72,78,38,5,2,0,0,6,11,10,13,22,11,7,4,4,31,25,6,23,5,2,3,1,39,35,4,3,JANUARI
SULAWESI BARAT,MAMASA,SUMARORONG,SUMARORONG,90,15,9,1,1,1,0,6,2,1,2,7,14,1,13,1,10,6,4,0,5,4,1,3,5,1,4,0,JANUARI
SULAWESI BARAT,MAMASA,SUMARORONG,TABONE,74,71,49,17,16,10,7,29,5,5,27,18,5,5,0,1,26,24,2,6,10,4,6,1,9,7,2,0,JANUARI
SULAWESI BARAT,MAMASA,SUMARORONG,BATANG URU,98,10,2,2,0,0,0,1,1,0,0,2,19,17,2,3,10,8,2,2,7,5,2,4,3,0,3,1,JANUARI
SULAWESI BARAT,MAMASA,SUMARORONG,SASAKAN,94,62,23,18,14,12,11,11,0,1,4,19,10,3,7,1,39,16,23,7,37,5,32,5,56,14,42,7,JANUARI
SULAWESI BARAT,MAMASA,SUMARORONG,TADISI,67,80,35,10,7,7,5,25,2,0,5,10,2,0,2,0,46,10,36,2,46,37,9,16,72,23,49,1,JANUARI
SULAWESI BARAT,MAMASA,SUMARORONG,SIBANAWA,78,69,25,18,5,0,0,1,24,0,25,0,8,6,2,3,26,15,11,11,20,18,2,12,47,45,2,17,JANUARI
SULAWESI BARAT,MAMASA,SUMARORONG,BATANGNGURU TIMUR,81,65,13,6,1,1,0,1,4,3,7,6,7,2,5,1,36,36,0,13,26,26,0,10,56,9,47,43,JANUARI
SULAWESI BARAT,MAMASA,SUMARORONG,SALUBALO,43,60,7,7,7,0,0,4,3,0,6,0,7,6,1,5,23,21,2,17,6,5,1,5,32,10,22,24,JANUARI
SULAWESI BARAT,MAMASA,SUMARORONG,BANEA,84,19,0,0,0,0,0,0,0,0,0,0,10,7,3,7,18,13,5,10,17,14,3,11,6,1,5,0,JANUARI
SULAWESI BARAT,MAMASA,SUMARORONG,RANTE KAMASE,89,12,1,1,1,1,0,0,0,1,1,0,14,10,4,4,12,7,5,0,12,1,11,0,9,8,1,7,JANUARI
SULAWESI BARAT,MAMASA,TABANG,TABANG,55,46,44,25,7,2,0,38,3,3,17,4,5,2,3,1,31,6,25,1,1,1,0,0,24,12,12,0,JANUARI
SULAWESI BARAT,MAMASA,TABANG,TADOKALUA,42,80,80,37,5,2,2,51,20,6,60,12,7,5,2,3,65,55,10,55,15,10,5,2,19,10,9,0,JANUARI
SULAWESI BARAT,MAMASA,TABANG,TABANG BARAT,78,39,23,16,16,8,2,8,0,10,12,3,6,3,3,3,12,10,2,1,11,1,10,0,30,1,29,12,JANUARI
SULAWESI BARAT,MAMASA,TABANG,MASUPU,88,52,52,0,0,0,0,48,3,0,52,0,15,8,7,7,50,46,4,23,42,18,24,6,11,0,11,3,JANUARI
SULAWESI BARAT,MAMASA,TABANG,KALAMA,97,41,1,0,0,0,0,0,0,0,1,0,10,6,4,4,19,9,10,2,1,1,0,1,22,3,19,8,JANUARI
SULAWESI BARAT,MAMASA,TABANG,BAKADISURA,58,34,19,9,3,2,2,4,9,4,13,4,8,1,7,0,16,6,10,1,0,0,0,0,20,3,17,14,JANUARI
SULAWESI BARAT,MAMASA,TABANG,SALUKONA,51,42,8,2,1,0,0,8,0,0,8,0,2,2,0,0,23,7,16,5,17,10,7,4,27,15,12,9,JANUARI
SULAWESI BARAT,MAMASA,TABULAHAN,LAKAHANG,91,62,49,29,14,13,1,33,0,8,47,2,0,0,0,0,29,12,17,0,13,8,5,6,18,11,7,13,JANUARI
SULAWESI BARAT,MAMASA,TABULAHAN,PERIANGAN,38,67,23,17,14,1,0,0,23,0,12,6,3,1,2,1,14,12,2,1,4,4,0,3,4,2,2,4,JANUARI
SULAWESI BARAT,MAMASA,TABULAHAN,MALATIRO,39,44,16,16,4,3,0,13,1,1,9,0,7,0,7,0,15,9,6,1,7,7,0,7,21,15,6,2,JANUARI
SULAWESI BARAT,MAMASA,TABULAHAN,TABULAHAN,43,29,17,5,2,1,1,0,0,2,11,4,2,2,0,2,16,12,4,1,11,7,4,2,14,2,12,6,JANUARI
SULAWESI BARAT,MAMASA,TABULAHAN,SALULEANG,59,24,5,0,0,0,0,1,4,0,1,1,8,8,0,2,20,10,10,0,17,4,13,0,0,0,0,0,JANUARI
SULAWESI BARAT,MAMASA,TABULAHAN,TAMPAK KURRA,64,50,38,23,18,13,3,25,6,0,33,3,7,4,3,0,47,40,7,39,39,10,29,8,62,53,9,32,JANUARI
SULAWESI BARAT,MAMASA,TABULAHAN,GANDANG DEWATA,45,58,30,10,7,4,0,18,0,11,16,14,4,0,4,0,21,14,7,5,14,1,13,1,52,21,31,34,JANUARI
SULAWESI BARAT,MAMASA,TABULAHAN,BURANA,57,52,12,7,6,3,2,5,0,4,8,4,10,9,1,9,35,34,1,25,32,8,24,8,7,2,5,6,JANUARI
SULAWESI BARAT,MAMASA,TABULAHAN,SALUBAKKA,94,24,2,0,0,0,0,0,0,0,2,0,14,3,11,2,11,8,3,1,4,0,4,0,17,11,6,3,JANUARI
SULAWESI BARAT,MAMASA,TABULAHAN,PANGANDARAN,95,54,31,21,8,6,4,17,5,0,3,18,7,1,6,1,47,30,17,24,20,6,14,0,16,12,4,10,JANUARI
SULAWESI BARAT,MAMASA,TABULAHAN,TALOPAK,84,16,9,6,2,0,0,4,0,5,8,0,6,4,2,4,12,9,3,6,8,5,3,4,3,3,0,2,JANUARI
SULAWESI BARAT,MAMASA,TABULAHAN,PEU',94,61,43,8,5,4,2,19,11,9,33,0,0,0,0,0,11,10,1,10,6,2,4,1,12,8,4,12,JANUARI
SULAWESI BARAT,MAMASA,TABULAHAN,TIMORO,57,12,7,0,0,0,0,2,5,0,4,3,2,0,2,0,12,10,2,10,7,0,7,0,14,14,0,8,JANUARI
SULAWESI BARAT,MAMASA,TABULAHAN,LAKAHANG UTAMA,71,23,3,1,1,0,0,2,1,0,1,2,14,8,6,6,11,6,5,4,7,4,3,0,4,1,3,2,JANUARI
SULAWESI BARAT,MAMASA,TANDUK KALUA,MINAKE,57,18,2,0,0,0,0,0,1,0,0,1,4,1,3,1,13,9,4,4,8,1,7,0,20,15,5,13,JANUARI
SULAWESI BARAT,MAMASA,TANDUK KALUA,MALABO,73,40,19,16,11,8,7,3,9,0,18,0,4,3,1,3,35,5,30,4,25,15,10,9,10,9,1,3,JANUARI
SULAWESI BARAT,MAMASA,TANDUK KALUA,SINDAGAMANIK,82,35,29,13,8,3,2,5,15,1,15,10,16,1,15,0,10,6,4,4,9,6,3,4,1,1,0,1,JANUARI
SULAWESI BARAT,MAMASA,TANDUK KALUA,PARONDOBULAWAN,55,78,14,13,3,0,0,5,0,8,6,5,1,0,1,0,53,30,23,19,48,26,22,13,50,16,34,5,JANUARI
SULAWESI BARAT,MAMASA,TANDUK KALUA,TAMALANTIK,60,29,29,3,2,0,0,1,0,28,15,2,7,0,7,0,12,7,5,0,11,8,3,8,13,11,2,3,JANUARI
SULAWESI BARAT,MAMASA,TANDUK KALUA,MANNABABA,68,32,9,4,1,0,0,1,5,3,6,0,9,3,6,1,11,9,2,8,4,1,3,0,13,12,1,12,JANUARI
SULAWESI BARAT,MAMASA,TANDUK KALUA,MESAKADA,80,47,30,7,2,2,2,6,1,0,9,11,13,9,4,5,13,7,6,3,12,4,8,1,10,4,6,6,JANUARI
SULAWESI BARAT,MAMASA,TANDUK KALUA,BALLABATU,45,66,5,5,5,2,0,1,2,1,1,0,3,2,1,2,66,64,2,0,64,12,52,6,37,19,18,14,JANUARI
SULAWESI BARAT,MAMASA,TANDUK KALUA,PAMBE,46,74,5,1,1,0,0,1,1,0,0,4,2,0,2,0,30,23,7,21,16,15,1,2,22,0,22,22,JANUARI
SULAWESI BARAT,MAMASA,TANDUK KALUA,SALURANO,47,69,65,43,31,18,15,42,7,0,19,7,5,0,5,0,57,57,0,31,0,0,0,0,45,11,34,40,JANUARI
SULAWESI BARAT,MAMASA,TANDUK KALUA,TALIMBUNG,87,73,29,28,10,2,1,14,0,3,4,12,3,1,2,0,56,17,39,0,43,20,23,18,64,29,35,5,JANUARI
SULAWESI BARAT,MAMASA,TANDUK KALUA,KANAN,54,41,36,25,17,5,1,10,17,1,25,10,6,0,6,0,39,12,27,8,20,20,0,13,25,13,12,18,JANUARI
SULAWESI BARAT,MAMASA,TAWALIAN,TAWALIAN,43,15,11,5,2,1,1,3,0,4,7,1,5,4,1,1,13,7,6,5,7,7,0,5,17,15,2,12,JANUARI
SULAWESI BARAT,MAMASA,TAWALIAN,TAWALIAN TIMUR,51,48,39,10,6,6,4,24,0,7,38,0,4,1,3,1,26,25,1,18,23,18,5,15,47,0,47,6,JANUARI
SULAWESI BARAT,MAMASA,TAWALIAN,KARIANGO,31,68,62,55,1,1,1,10,34,12,41,16,3,1,2,1,18,14,4,4,14,2,12,1,60,20,40,7,JANUARI
SULAWESI BARAT,MAMASA,TAWALIAN,RANTETANGNGA,51,66,37,24,7,2,2,1,14,1,34,1,9,3,6,0,19,5,14,0,1,1,0,0,1,1,0,0,JANUARI
SULAWESI BARAT,POLEWALI MANDAR,ALLU,PETOOSANG,67,44,23,1,0,0,0,14,1,1,18,1,5,2,3,0,20,14,6,12,7,5,2,2,9,7,2,8,JANUARI
SULAWESI BARAT,POLEWALI MANDAR,ALLU,MOMBI,84,74,25,24,24,7,1,6,5,9,12,1,15,4,11,4,54,51,3,31,34,18,16,9,47,39,8,13,JANUARI
SULAWESI BARAT,POLEWALI MANDAR,ALLU,KALUMAMMANG,97,62,53,21,1,0,0,35,15,3,51,2,12,6,6,4,40,16,24,1,14,12,2,11,54,13,41,23,JANUARI
SULAWESI BARAT,POLEWALI MANDAR,ALLU,PAO-PAO,35,55,0,0,0,0,0,0,0,0,0,0,1,1,0,1,15,15,0,1,7,7,0,4,39,15,24,8,JANUARI
SULAWESI BARAT,POLEWALI MANDAR,ALLU,PUPPU URING,54,22,14,7,1,1,0,11,0,0,2,6,4,3,1,3,21,17,4,17,14,14,0,10,10,3,7,7,JANUARI
SULAWESI BARAT,POLEWALI MANDAR,ALLU,SARAGIAN,74,31,29,8,0,0,0,22,1,5,19,7,6,0,6,0,20,12,8,9,10,7,3,6,25,15,10,1,JANUARI
SULAWESI BARAT,POLEWALI MANDAR,ALLU,SAYOANG,64,56,54,13,12,0,0,10,34,1,21,1,10,6,4,4,13,12,1,11,12,5,7,1,6,3,3,4,JANUARI
SULAWESI BARAT,POLEWALI MANDAR,ALLU,ALU,92,64,32,6,5,5,2,7,23,0,21,3,6,3,3,0,24,23,1,19,16,9,7,4,8,3,5,4,JANUARI
SULAWESI BARAT,POLEWALI MANDAR,ANREAPI,ANREAPI,63,20,0,0,0,0,0,0,0,0,0,0,11,0,11,0,19,11,8,1,18,6,12,5,17,3,14,12,JANUARI
SULAWESI BARAT,POLEWALI MANDAR,ANREAPI,DUAMPANUA,96,29,9,3,1,1,1,0,3,2,7,1,17,11,6,3,14,10,4,0,7,7,0,0,1,0,1,0,JANUARI
SULAWESI BARAT,POLEWALI MANDAR,ANREAPI,KELAPA DUA,56,78,33,8,5,0,0,18,13,1,25,5,3,3,0,2,29,29,0,8,9,4,5,2,51,51,0,18,JANUARI
SULAWESI BARAT,POLEWALI MANDAR,ANREAPI,PAPPANDANGAN,91,53,20,18,14,7,7,1,12,0,0,5,4,0,4,0,33,26,7,11,11,6,5,3,35,23,12,30,JANUARI
SULAWESI BARAT,POLEWALI MANDAR,ANREAPI,KUNYI,55,60,33,1,0,0,0,21,10,1,13,0,7,5,2,2,44,28,16,10,22,0,22,0,34,22,12,31,JANUARI
SULAWESI BARAT,POLEWALI MANDAR,BALANIPA,BALANIPA,33,72,24,1,0,0,0,10,13,0,23,0,4,4,0,0,62,20,42,14,17,9,8,8,13,6,7,11,JANUARI
SULAWESI BARAT,POLEWALI MANDAR,BALANIPA,TAMMAJARRA,32,80,39,28,16,0,0,6,32,0,30,2,2,2,0,1,61,25,36,20,1,0,1,0,18,14,4,14,JANUARI
SULAWESI BARAT,POLEWALI MANDAR,BALANIPA,TAMANGGALLE,82,18,7,4,2,2,0,5,1,0,0,2,14,1,13,1,16,5,11,4,10,2,8,1,4,1,3,4,JANUARI
SULAWESI BARAT,POLEWALI MANDAR,BALANIPA,MOSSO,48,35,12,4,3,2,2,10,0,0,7,0,2,0,2,0,25,24,1,1,4,4,0,4,16,3,13,3,JANUARI
SULAWESI BARAT,POLEWALI MANDAR,BALANIPA,GALUNG TULUK,39,20,3,1,1,0,0,3,0,0,1,1,6,5,1,0,14,9,5,8,1,1,0,0,14,3,11,1,JANUARI
SULAWESI BARAT,POLEWALI MANDAR,BALANIPA,SABANG SUBIK,55,22,20,20,9,2,0,16,0,2,2,14,7,4,3,3,11,5,6,5,1,1,0,1,6,0,6,3,JANUARI
SULAWESI BARAT,POLEWALI MANDAR,BALANIPA,PAMBUSUANG,92,12,5,4,0,0,0,1,2,0,4,0,10,2,8,1,11,10,1,2,1,0,1,0,6,6,0,3,JANUARI
SULAWESI BARAT,POLEWALI MANDAR,BALANIPA,BALA,78,76,30,18,18,6,3,21,3,0,19,10,5,4,1,2,39,36,3,15,28,20,8,3,27,17,10,22,JANUARI
SULAWESI BARAT,POLEWALI MANDAR,BALANIPA,LAMBANAN,79,22,18,7,6,3,1,15,2,0,6,10,8,3,5,3,19,16,3,14,9,0,9,0,23,10,13,10,JANUARI
SULAWESI BARAT,POLEWALI MANDAR,BALANIPA,LEGO,60,31,17,9,1,0,0,8,6,0,16,0,8,2,6,1,14,13,1,8,14,12,2,4,15,4,11,2,JANUARI
SULAWESI BARAT,POLEWALI MANDAR,BALANIPA,PALLIS,56,41,17,9,9,5,4,4,4,5,16,1,3,0,3,0,17,5,12,0,16,3,13,0,14,6,8,6,JANUARI
SULAWESI BARAT,POLEWALI MANDAR,BINUANG,AMASSANGAN,72,27,15,4,0,0,0,15,0,0,12,1,3,1,2,1,11,9,2,8,9,0,9,0,7,4,3,7,JANUARI
SULAWESI BARAT,POLEWALI MANDAR,BINUANG,TONYAMAN,35,16,16,13,4,4,0,0,8,5,2,4,7,4,3,2,12,8,4,7,6,6,0,2,12,4,8,2,JANUARI
SULAWESI BARAT,POLEWALI MANDAR,BINUANG,KUAJANG,33,79,65,51,34,19,2,48,11,1,13,24,1,0,1,0,45,11,34,1,41,13,28,13,19,11,8,3,JANUARI
SULAWESI BARAT,POLEWALI MANDAR,BINUANG,PAKU,62,64,46,3,1,0,0,21,17,5,27,1,10,2,8,0,52,25,27,6,26,18,8,18,49,30,19,15,JANUARI
SULAWESI BARAT,POLEWALI MANDAR,BINUANG,MIRRING,59,75,7,7,0,0,0,4,2,0,0,1,5,1,4,1,56,11,45,2,29,18,11,10,56,20,36,3,JANUARI
SULAWESI BARAT,POLEWALI MANDAR,BINUANG,BATETANGNGA,67,25,20,0,0,0,0,16,2,1,12,5,11,6,5,5,12,5,7,4,8,4,4,3,20,5,15,19,JANUARI
SULAWESI BARAT,POLEWALI MANDAR,BINUANG,MAMMI,55,50,2,0,0,0,0,0,1,1,0,1,1,0,1,0,41,28,13,28,18,3,15,2,3,1,2,1,JANUARI
SULAWESI BARAT,POLEWALI MANDAR,BINUANG,KALEOK,49,59,43,24,23,6,1,3,38,1,32,10,5,0,5,0,37,37,0,14,26,20,6,0,32,2,30,13,JANUARI
SULAWESI BARAT,POLEWALI MANDAR,BINUANG,AMOLA,74,32,31,0,0,0,0,0,4,20,10,14,13,7,6,6,29,29,0,7,7,7,0,3,29,5,24,10,JANUARI
SULAWESI BARAT,POLEWALI MANDAR,BINUANG,REA,75,31,12,4,4,3,3,2,7,0,4,5,3,3,0,3,15,13,2,8,11,3,8,0,13,7,6,12,JANUARI
SULAWESI BARAT,POLEWALI MANDAR,BULO,BULO,96,78,60,38,13,6,2,6,12,31,23,25,0,0,0,0,67,9,58,8,8,2,6,1,33,31,2,5,JANUARI
SULAWESI BARAT,POLEWALI MANDAR,BULO,PULLIWA,65,56,15,13,2,2,0,1,0,1,14,0,5,3,2,1,48,32,16,3,0,0,0,0,35,25,10,20,JANUARI
SULAWESI BARAT,POLEWALI MANDAR,BULO,PATAMBANUA,66,57,57,18,10,3,2,27,1,19,53,0,10,9,1,7,43,21,22,19,29,19,10,14,60,50,10,29,JANUARI
SULAWESI BARAT,POLEWALI MANDAR,BULO,KAROMBANG,31,32,15,9,9,6,0,14,0,0,5,4,1,0,1,0,25,12,13,8,7,6,1,3,17,1,16,3,JANUARI
SULAWESI BARAT,POLEWALI MANDAR,BULO,DAALA TIMUR,92,22,10,5,1,0,0,6,4,0,6,0,1,1,0,1,17,5,12,2,6,6,0,1,11,10,1,1,JANUARI
SULAWESI BARAT,POLEWALI MANDAR,BULO,LENGGO,46,77,2,0,0,0,0,1,0,0,2,0,3,0,3,0,74,29,45,12,9,1,8,1,31,21,10,22,JANUARI
SULAWESI BARAT,POLEWALI MANDAR,BULO,SABURA,76,32,12,2,0,0,0,3,3,6,5,4,2,1,1,1,31,8,23,3,31,17,14,4,26,8,18,19,JANUARI
SULAWESI BARAT,POLEWALI MANDAR,BULO,SEPPORRAKI,41,38,11,6,6,1,0,2,8,0,10,1,4,4,0,4,24,22,2,12,5,0,5,0,15,10,5,0,JANUARI
SULAWESI BARAT,POLEWALI MANDAR,BULO,IHING,45,40,33,21,0,0,0,4,17,0,14,16,4,1,3,0,35,22,13,5,21,16,5,0,13,12,1,2,JANUARI
SULAWESI BARAT,POLEWALI MANDAR,CAMPALAGIAN,PAPPANG,47,73,32,23,8,3,2,12,7,1,2,9,6,2,4,2,32,32,0,18,23,17,6,10,19,19,0,19,JANUARI
SULAWESI BARAT,POLEWALI MANDAR,CAMPALAGIAN,LALIKO,34,53,19,4,0,0,0,4,2,0,6,8,3,0,3,0,35,11,24,2,4,3,1,3,2,2,0,0,JANUARI
SULAWESI BARAT,POLEWALI MANDAR,CAMPALAGIAN,BONDE,86,18,15,8,1,0,0,1,1,7,8,6,16,0,16,0,10,6,4,2,7,0,7,0,2,0,2,2,JANUARI
SULAWESI BARAT,POLEWALI MANDAR,CAMPALAGIAN,KATUMBANGAN LEMO,96,28,26,25,14,7,0,4,5,3,0,24,7,6,1,5,24,8,16,1,23,16,7,15,35,0,35,27,JANUARI
SULAWESI BARAT,POLEWALI MANDAR,CAMPALAGIAN,PANYAMPA,91,42,25,5,4,0,0,4,19,2,3,10,10,1,9,0,11,10,1,5,10,3,7,0,14,3,11,13,JANUARI
SULAWESI BARAT,POLEWALI MANDAR,CAMPALAGIAN,SURUANG,90,62,42,2,1,1,1,18,18,3,34,3,14,5,9,1,58,52,6,1,5,1,4,0,7,4,3,7,JANUARI
SULAWESI BARAT,POLEWALI MANDAR,CAMPALAGIAN,LAMPOKO,45,57,39,1,0,0,0,12,0,20,31,0,5,0,5,0,15,12,3,1,4,4,0,4,34,23,11,5,JANUARI
SULAWESI BARAT,POLEWALI MANDAR,CAMPALAGIAN,KATUMBANGAN,100,60,50,44,18,14,10,23,6,5,40,1,7,1,6,0,14,9,5,6,12,10,2,10,17,0,17,11,JANUARI
SULAWESI BARAT,POLEWALI MANDAR,CAMPALAGIAN,LAPEO,49,30,29,5,0,0,0,11,3,8,23,3,4,0,4,0,28,18,10,0,28,16,12,7,9,6,3,5,JANUARI
SULAWESI BARAT,POLEWALI MANDAR,CAMPALAGIAN,PARAPPE,44,28,26,4,4,0,0,11,7,4,5,7,4,1,3,0,23,10,13,2,0,0,0,0,19,10,9,6,JANUARI
SULAWESI BARAT,POLEWALI MANDAR,CAMPALAGIAN,ONGKO,81,61,9,1,0,0,0,8,0,1,7,2,10,9,1,8,51,36,15,28,40,13,27,6,16,13,3,5,JANUARI
SULAWESI BARAT,POLEWALI MANDAR,CAMPALAGIAN,KENJE,62,47,25,25,15,14,7,11,6,1,5,13,8,8,0,3,21,10,11,4,5,5,0,1,9,2,7,9,JANUARI
SULAWESI BARAT,POLEWALI MANDAR,CAMPALAGIAN,SUMARRANG,69,22,5,2,0,0,0,5,0,0,3,2,2,2,0,0,22,18,4,5,11,10,1,3,3,3,0,3,JANUARI
SULAWESI BARAT,POLEWALI MANDAR,CAMPALAGIAN,BOTTO,91,45,13,13,4,1,0,8,0,1,1,8,18,11,7,1,39,32,7,3,19,7,12,1,12,1,11,10,JANUARI
SULAWESI BARAT,POLEWALI MANDAR,CAMPALAGIAN,GATTUNGAN,44,32,3,0,0,0,0,1,1,1,1,1,5,2,3,2,19,11,8,4,19,6,13,1,25,14,11,9,JANUARI
SULAWESI BARAT,POLEWALI MANDAR,CAMPALAGIAN,PADANG TIMUR,99,63,56,49,32,25,12,37,7,0,40,6,0,0,0,0,22,8,14,2,4,4,0,0,42,34,8,3,JANUARI
SULAWESI BARAT,POLEWALI MANDAR,CAMPALAGIAN,PADANG,77,34,20,1,1,0,0,4,12,2,4,3,0,0,0,0,30,5,25,2,15,9,6,4,15,0,15,15,JANUARI
SULAWESI BARAT,POLEWALI MANDAR,CAMPALAGIAN,LAGI-AGI,34,39,18,13,12,1,1,16,1,0,14,1,3,1,2,1,32,15,17,7,12,11,1,0,18,12,6,0,JANUARI
SULAWESI BARAT,POLEWALI MANDAR,LIMBORO,LIMBORO,45,43,34,2,0,0,0,8,17,6,18,12,6,1,5,1,39,36,3,9,27,26,1,19,2,0,2,2,JANUARI
SULAWESI BARAT,POLEWALI MANDAR,LIMBORO,LEMBANG LEMBANG,62,29,25,20,1,1,0,5,2,7,4,20,9,1,8,1,17,11,6,0,6,4,2,3,22,5,17,14,JANUARI
SULAWESI BARAT,POLEWALI MANDAR,LIMBORO,TANDASURA,74,77,23,18,8,5,0,15,3,4,21,2,6,4,2,2,13,7,6,7,9,9,0,6,17,5,12,7,JANUARI
SULAWESI BARAT,POLEWALI MANDAR,LIMBORO,SAMASUNDU,92,60,24,18,11,3,1,18,1,3,17,1,1,0,1,0,53,41,12,7,22,4,18,0,25,14,11,19,JANUARI
SULAWESI BARAT,POLEWALI MANDAR,LIMBORO,NAPO,95,30,8,6,5,2,0,0,7,1,4,0,18,6,12,6,28,18,10,16,9,8,1,0,20,15,5,12,JANUARI
SULAWESI BARAT,POLEWALI MANDAR,LIMBORO,TODANG TODANG,46,51,3,1,0,0,0,0,2,0,3,0,3,3,0,0,42,36,6,14,27,27,0,7,15,14,1,0,JANUARI
SULAWESI BARAT,POLEWALI MANDAR,LIMBORO,PENDULANGAN,76,68,48,21,4,0,0,10,27,11,9,3,4,0,4,0,60,60,0,56,4,2,2,0,28,5,23,28,JANUARI
SULAWESI BARAT,POLEWALI MANDAR,LIMBORO,RENGGEANG,45,27,9,4,0,0,0,0,6,1,2,0,3,3,0,0,15,7,8,6,6,6,0,4,9,5,4,2,JANUARI
SULAWESI BARAT,POLEWALI MANDAR,LIMBORO,SALARRI,93,80,13,12,3,1,1,2,7,2,9,4,11,8,3,2,79,29,50,20,63,22,41,10,108,26,82,89,JANUARI
SULAWESI BARAT,POLEWALI MANDAR,LIMBORO,TANGAN BARU,48,20,17,16,1,1,1,4,1,10,1,6,6,4,2,0,18,11,7,1,9,7,2,3,1,1,0,1,JANUARI
SULAWESI BARAT,POLEWALI MANDAR,LIMBORO,PALECE,67,20,1,1,1,1,0,1,0,0,0,0,3,3,0,3,19,18,1,9,1,1,0,1,14,3,11,6,JANUARI
SULAWESI BARAT,POLEWALI MANDAR,LUYO,BATUPANGA,74,54,4,4,2,2,1,3,0,0,3,0,5,0,5,0,21,10,11,9,11,9,2,6,29,13,16,13,JANUARI
SULAWESI BARAT,POLEWALI MANDAR,LUYO,MAMBU,37,50,22,6,2,0,0,3,8,4,15,2,3,1,2,0,37,5,32,3,37,16,21,10,12,2,10,2,JANUARI
SULAWESI BARAT,POLEWALI MANDAR,LUYO,TENGGELANG,36,46,4,0,0,0,0,3,0,1,2,0,6,5,1,4,19,9,10,2,6,4,2,4,33,8,25,4,JANUARI
SULAWESI BARAT,POLEWALI MANDAR,LUYO,BARU,33,30,10,10,8,3,2,2,4,0,10,0,4,2,2,0,24,9,15,9,1,0,1,0,5,4,1,1,JANUARI
SULAWESI BARAT,POLEWALI MANDAR,LUYO,PUSSUI,79,23,22,15,1,0,0,0,3,0,21,1,7,2,5,2,10,9,1,6,6,2,4,1,19,16,3,17,JANUARI
SULAWESI BARAT,POLEWALI MANDAR,LUYO,MAPILI BARAT,84,69,34,8,0,0,0,11,20,2,1,27,1,0,1,0,13,11,2,4,9,8,1,8,20,16,4,14,JANUARI
SULAWESI BARAT,POLEWALI MANDAR,LUYO,SAMBALI WALI,68,21,11,0,0,0,0,11,0,0,0,9,10,5,5,5,17,8,9,4,13,3,10,3,2,2,0,0,JANUARI
SULAWESI BARAT,POLEWALI MANDAR,LUYO,BATUPANGA DAALA,37,36,25,11,10,9,2,4,14,1,7,6,3,0,3,0,15,9,6,7,4,4,0,1,4,4,0,3,JANUARI
SULAWESI BARAT,POLEWALI MANDAR,LUYO,LUYO,62,18,7,2,2,2,0,3,0,1,6,1,1,1,0,0,11,7,4,1,5,2,3,0,2,1,1,1,JANUARI
SULAWESI BARAT,POLEWALI MANDAR,LUYO,PUSSUI BARAT,63,22,1,1,0,0,0,1,0,0,0,1,5,2,3,2,10,6,4,0,3,3,0,0,8,6,2,6,JANUARI
SULAWESI BARAT,POLEWALI MANDAR,LUYO,PUCCADI,42,26,8,0,0,0,0,0,3,5,6,1,2,1,1,1,15,15,0,11,0,0,0,0,2,1,1,2,JANUARI
SULAWESI BARAT,POLEWALI MANDAR,MAPILLI,MAPILI,60,68,37,24,1,0,0,5,13,15,15,15,2,2,0,0,27,22,5,17,5,4,1,2,24,7,17,20,JANUARI
SULAWESI BARAT,POLEWALI MANDAR,MAPILLI,UGIBARU,93,42,20,5,4,1,0,6,0,0,0,11,12,9,3,0,21,17,4,10,11,0,11,0,1,1,0,1,JANUARI
SULAWESI BARAT,POLEWALI MANDAR,MAPILLI,RUMPA,75,53,16,9,7,1,1,13,0,1,14,1,9,3,6,1,41,19,22,11,34,29,5,6,51,47,4,1,JANUARI
SULAWESI BARAT,POLEWALI MANDAR,MAPILLI,KURMA,96,52,29,26,10,8,7,10,2,1,6,14,13,13,0,10,44,5,39,2,25,10,15,5,46,39,7,37,JANUARI
SULAWESI BARAT,POLEWALI MANDAR,MAPILLI,BUKU,52,46,11,10,7,0,0,6,5,0,1,4,6,6,0,3,11,9,2,6,5,2,3,2,18,11,7,15,JANUARI
SULAWESI BARAT,POLEWALI MANDAR,MAPILLI,BONNE BONNE,50,33,10,8,1,1,1,2,3,4,5,3,10,6,4,2,28,9,19,4,2,1,1,0,9,2,7,4,JANUARI
SULAWESI BARAT,POLEWALI MANDAR,MAPILLI,BEROANGIN,87,14,7,0,0,0,0,2,0,3,4,2,5,0,5,0,12,5,7,2,11,6,5,4,5,1,4,4,JANUARI
SULAWESI BARAT,POLEWALI MANDAR,MAPILLI,SEGERANG,59,42,30,2,1,1,1,25,0,0,29,0,7,1,6,0,21,7,14,3,21,21,0,2,28,13,15,9,JANUARI
SULAWESI BARAT,POLEWALI MANDAR,MAPILLI,BONRA,96,71,42,12,0,0,0,8,30,0,14,15,15,7,8,3,66,18,48,4,7,7,0,3,42,25,17,15,JANUARI
SULAWESI BARAT,POLEWALI MANDAR,MAPILLI,SATTOKO,75,45,20,14,4,3,0,8,2,5,5,4,15,4,11,0,13,9,4,6,10,3,7,3,33,24,9,2,JANUARI
SULAWESI BARAT,POLEWALI MANDAR,MAPILLI,RAPPANG BARAT,60,42,10,7,7,1,1,1,0,4,1,1,11,8,3,8,23,23,0,12,5,1,4,1,3,3,0,1,JANUARI
SULAWESI BARAT,POLEWALI MANDAR,MAPILLI,LANDI KANUSUANG,53,17,5,5,3,0,0,4,0,1,4,0,9,1,8,1,13,13,0,4,8,1,7,1,2,2,0,1,JANUARI
SULAWESI BARAT,POLEWALI MANDAR,MATAKALI,MATAKALI,42,26,16,0,0,0,0,7,7,2,10,5,0,0,0,0,12,10,2,4,8,4,4,0,9,7,2,6,JANUARI
SULAWESI BARAT,POLEWALI MANDAR,MATAKALI,PETAMPANUA,44,37,26,1,1,1,1,16,6,1,17,6,3,0,3,0,19,14,5,12,8,6,2,1,13,13,0,8,JANUARI
SULAWESI BARAT,POLEWALI MANDAR,MATAKALI,BARUMBUNG,58,69,63,23,19,10,5,33,20,5,36,15,7,2,5,1,20,11,9,11,0,0,0,0,14,2,12,0,JANUARI
SULAWESI BARAT,POLEWALI MANDAR,MATAKALI,PASIANG,47,43,33,27,20,15,3,19,0,7,12,17,3,3,0,1,17,10,7,6,0,0,0,0,3,2,1,2,JANUARI
SULAWESI BARAT,POLEWALI MANDAR,MATAKALI,TONROLIMA,92,79,71,18,8,3,3,32,8,14,9,4,8,2,6,0,72,24,48,17,17,12,5,10,20,7,13,2,JANUARI
SULAWESI BARAT,POLEWALI MANDAR,MATAKALI,INDOMAKKOMBONG,90,78,31,21,17,1,1,0,24,6,31,0,16,0,16,0,54,51,3,33,21,1,20,1,75,40,35,31,JANUARI
SULAWESI BARAT,POLEWALI MANDAR,MATAKALI,BUNGA-BUNGA,66,29,19,14,14,11,9,10,0,0,16,3,7,4,3,1,23,11,12,6,13,7,6,2,8,4,4,6,JANUARI
SULAWESI BARAT,POLEWALI MANDAR,MATANGNGA,MATANGNGA,43,15,13,1,1,0,0,12,1,0,3,1,6,6,0,0,15,9,6,7,15,7,8,3,20,20,0,6,JANUARI
SULAWESI BARAT,POLEWALI MANDAR,MATANGNGA,LILLI,64,64,23,4,2,1,1,14,3,4,20,2,9,2,7,1,63,54,9,41,29,10,19,5,69,43,26,62,JANUARI
SULAWESI BARAT,POLEWALI MANDAR,MATANGNGA,RANGOAN,34,20,8,6,1,1,1,3,4,0,2,2,0,0,0,0,11,5,6,3,10,3,7,2,21,5,16,0,JANUARI
SULAWESI BARAT,POLEWALI MANDAR,MATANGNGA,TAPUA,50,76,59,15,4,3,3,33,17,4,28,20,7,6,1,6,71,65,6,65,26,1,25,0,14,5,9,8,JANUARI
SULAWESI BARAT,POLEWALI MANDAR,MATANGNGA,MAMBU TAPUA,58,65,23,7,2,0,0,22,1,0,13,3,9,9,0,8,24,23,1,12,24,9,15,3,56,26,30,47,JANUARI
SULAWESI BARAT,POLEWALI MANDAR,MATANGNGA,BA'BA TAPUA,88,61,41,3,1,1,0,35,1,5,3,34,2,1,1,1,55,7,48,0,12,11,1,4,0,0,0,0,JANUARI
SULAWESI BARAT,POLEWALI MANDAR,MATANGNGA,KATIMBANG,72,58,41,33,12,12,4,15,11,1,37,4,3,0,3,0,37,35,2,1,14,11,3,4,22,6,16,6,JANUARI
SULAWESI BARAT,POLEWALI MANDAR,POLEWALI,POLEWALI,53,28,5,3,1,1,1,2,2,0,3,1,10,3,7,0,12,10,2,8,7,3,4,2,4,1,3,2,JANUARI
SULAWESI BARAT,POLEWALI MANDAR,POLEWALI,WATTANG,66,79,3,1,0,0,0,2,0,0,1,0,8,1,7,1,57,33,24,32,54,22,32,3,93,30,63,39,JANUARI
SULAWESI BARAT,POLEWALI MANDAR,POLEWALI,SULEWATANG,88,56,26,13,11,5,2,6,1,15,14,4,13,11,2,11,20,6,14,2,20,20,0,16,54,52,2,22,JANUARI
SULAWESI BARAT,POLEWALI MANDAR,POLEWALI,LANTORA,38,48,32,24,19,16,1,23,5,1,3,2,4,4,0,4,20,14,6,14,16,9,7,1,27,6,21,4,JANUARI
SULAWESI BARAT,POLEWALI MANDAR,POLEWALI,TAKATIDUNG,76,48,17,12,10,3,2,7,7,0,16,0,13,13,0,13,18,18,0,13,3,3,0,0,5,4,1,4,JANUARI
SULAWESI BARAT,POLEWALI MANDAR,POLEWALI,PEKKABATA,47,65,41,3,3,3,1,12,19,5,40,1,6,6,0,5,10,10,0,10,7,7,0,5,8,7,1,3,JANUARI
SULAWESI BARAT,POLEWALI MANDAR,POLEWALI,MADATE,73,29,0,0,0,0,0,0,0,0,0,0,13,9,4,9,26,7,19,1,14,6,8,6,24,16,8,11,JANUARI
SULAWESI BARAT,POLEWALI MANDAR,POLEWALI,MANDING,72,76,27,20,10,4,1,7,16,2,1,7,10,3,7,2,76,58,18,21,69,40,29,2,26,14,12,9,JANUARI
SULAWESI BARAT,POLEWALI MANDAR,POLEWALI,DARMA,92,33,23,21,7,3,0,19,3,0,11,9,1,0,1,0,19,12,7,11,1,1,0,1,9,4,5,8,JANUARI
SULAWESI BARAT,POLEWALI MANDAR,TAPANGO,PELITAKAN,42,37,16,14,1,0,0,10,1,2,0,4,2,2,0,0,32,19,13,3,16,7,9,6,16,2,14,16,JANUARI
SULAWESI BARAT,POLEWALI MANDAR,TAPANGO,TAPANGO,85,47,9,5,5,5,1,4,3,1,1,2,17,8,9,2,40,28,12,14,1,0,1,0,23,7,16,10,JANUARI
SULAWESI BARAT,POLEWALI MANDAR,TAPANGO,RAPPANG,88,10,10,3,1,1,1,1,0,0,7,0,13,8,5,1,10,7,3,1,0,0,0,0,3,3,0,1,JANUARI
SULAWESI BARAT,POLEWALI MANDAR,TAPANGO,DAKKA,39,55,14,3,3,1,1,4,7,0,7,4,6,3,3,2,22,12,10,12,8,3,5,3,9,4,5,3,JANUARI
SULAWESI BARAT,POLEWALI MANDAR,TAPANGO,BATU,41,23,12,6,1,1,0,5,4,1,11,0,2,2,0,2,20,19,1,19,11,4,7,3,20,4,16,10,JANUARI
SULAWESI BARAT,POLEWALI MANDAR,TAPANGO,RISO,77,28,21,21,17,14,5,4,6,5,8,9,15,8,7,8,10,5,5,0,10,10,0,0,15,12,3,8,JANUARI
SULAWESI BARAT,POLEWALI MANDAR,TAPANGO,PALATTA,55,13,9,3,1,1,0,8,1,0,9,0,10,8,2,6,13,8,5,5,5,3,2,1,11,4,7,11,JANUARI
SULAWESI BARAT,POLEWALI MANDAR,TAPANGO,TAPANGO BARAT,93,54,10,9,4,3,0,10,0,0,9,0,11,8,3,5,27,8,19,5,27,0,27,0,56,31,25,27,JANUARI
SULAWESI BARAT,POLEWALI MANDAR,TAPANGO,KURRAK,85,69,13,5,0,0,0,4,9,0,3,3,16,4,12,0,13,5,8,4,8,4,4,1,52,17,35,36,JANUARI
SULAWESI BARAT,POLEWALI MANDAR,TAPANGO,BUSSU,59,36,32,23,16,0,0,16,11,4,2,14,0,0,0,0,17,12,5,0,0,0,0,0,8,2,6,2,JANUARI
SULAWESI BARAT,POLEWALI MANDAR,TAPANGO,TUTTULA,37,72,17,1,1,0,0,13,2,2,9,0,7,4,3,1,56,50,6,7,2,0,2,0,2,2,0,0,JANUARI
SULAWESI BARAT,POLEWALI MANDAR,TAPANGO,JAMBU MALEA,85,66,56,18,13,4,0,9,33,3,34,8,12,12,0,6,20,18,2,13,8,0,8,0,2,2,0,2,JANUARI
SULAWESI BARAT,POLEWALI MANDAR,TAPANGO,KALIMBUA,78,51,2,1,0,0,0,1,1,0,0,1,1,0,1,0,12,8,4,8,9,4,5,2,43,4,39,38,JANUARI
SULAWESI BARAT,POLEWALI MANDAR,TAPANGO,BANATO REJO,61,10,1,0,0,0,0,1,0,0,0,0,2,2,0,2,10,10,0,1,9,5,4,4,14,9,5,6,JANUARI
SULAWESI BARAT,POLEWALI MANDAR,TINAMBUNG,TINAMBUNG,75,66,52,13,7,7,2,45,0,5,1,10,8,1,7,0,42,34,8,15,5,3,2,2,6,6,0,3,JANUARI
SULAWESI BARAT,POLEWALI MANDAR,TINAMBUNG,KARAMA,73,32,19,2,1,1,1,13,1,2,17,1,8,5,3,3,26,21,5,15,14,2,12,2,20,7,13,16,JANUARI
SULAWESI BARAT,POLEWALI MANDAR,TINAMBUNG,TANGNGA TANGNGA,58,55,22,8,2,0,0,18,4,0,11,3,10,4,6,0,40,11,29,6,12,10,2,8,42,26,16,24,JANUARI
SULAWESI BARAT,POLEWALI MANDAR,TINAMBUNG,LEKOPADIS,66,57,38,20,12,7,1,17,13,0,9,13,6,3,3,3,55,37,18,33,7,6,1,3,19,0,19,6,JANUARI
SULAWESI BARAT,POLEWALI MANDAR,TINAMBUNG,GALUNG LOMBOK,99,68,1,0,0,0,0,0,1,0,1,0,7,7,0,3,55,36,19,7,11,5,6,3,38,32,6,4,JANUARI
SULAWESI BARAT,POLEWALI MANDAR,TINAMBUNG,TANDUNG,41,46,5,4,2,2,2,0,0,2,4,1,1,1,0,0,19,8,11,7,5,3,2,2,30,11,19,5,JANUARI
SULAWESI BARAT,POLEWALI MANDAR,TINAMBUNG,BATULAYA,65,26,21,11,0,0,0,5,5,10,1,20,10,0,10,0,13,5,8,3,5,3,2,1,4,3,1,1,JANUARI
SULAWESI BARAT,POLEWALI MANDAR,TINAMBUNG,SEPABATU,85,25,15,13,7,7,2,3,4,0,4,11,13,9,4,5,13,7,6,6,2,1,1,1,0,0,0,0,JANUARI
SULAWESI BARAT,POLEWALI MANDAR,TUTAR,TARAMANU,79,53,53,11,6,2,1,37,14,0,53,0,5,2,3,1,40,16,24,8,14,6,8,3,9,5,4,2,JANUARI
SULAWESI BARAT,POLEWALI MANDAR,TUTAR,AMBOPADANG,82,21,9,9,0,0,0,7,2,0,3,0,8,7,1,6,16,11,5,8,0,0,0,0,7,2,5,4,JANUARI
SULAWESI BARAT,POLEWALI MANDAR,TUTAR,TUBBI,81,38,16,4,2,1,1,9,5,1,8,5,9,6,3,4,12,11,1,6,4,4,0,2,9,8,1,1,JANUARI
SULAWESI BARAT,POLEWALI MANDAR,TUTAR,RATTE,95,45,21,6,6,6,1,19,0,1,8,1,10,4,6,0,13,10,3,4,6,3,3,1,15,13,2,12,JANUARI
SULAWESI BARAT,POLEWALI MANDAR,TUTAR,BESOANGIN,30,71,25,14,13,6,6,2,4,5,5,20,4,0,4,0,67,25,42,7,33,0,33,0,39,4,35,10,JANUARI
SULAWESI BARAT,POLEWALI MANDAR,TUTAR,PIRIANG TAPIKO,68,48,21,17,8,6,2,13,5,1,13,0,6,4,2,0,14,14,0,2,13,12,1,3,30,20,10,18,JANUARI
SULAWESI BARAT,POLEWALI MANDAR,TUTAR,PEBURRU,46,23,2,1,1,1,1,1,0,0,2,0,8,5,3,0,17,15,2,9,8,4,4,3,10,2,8,6,JANUARI
SULAWESI BARAT,POLEWALI MANDAR,TUTAR,TALOBA,90,50,23,6,6,4,3,11,7,1,5,4,11,7,4,6,40,38,2,28,23,9,14,6,58,14,44,21,JANUARI
SULAWESI BARAT,POLEWALI MANDAR,TUTAR,POLLEWANI,86,20,13,2,2,1,0,13,0,0,12,0,0,0,0,0,12,12,0,6,7,4,3,0,21,7,14,3,JANUARI
SULAWESI BARAT,POLEWALI MANDAR,TUTAR,ARABUA,82,61,11,5,1,1,1,3,5,0,11,0,12,0,12,0,56,6,50,1,2,0,2,0,8,5,3,2,JANUARI
SULAWESI BARAT,POLEWALI MANDAR,TUTAR,BESOANGIN UTARA,62,78,18,17,16,9,2,12,3,0,4,4,8,3,5,0,77,14,63,10,42,42,0,13,77,25,52,53,JANUARI
SULAWESI BARAT,POLEWALI MANDAR,TUTAR,PODA,46,41,32,8,7,4,4,7,9,9,16,2,4,2,2,2,30,7,23,0,12,0,12,0,0,0,0,0,JANUARI
SULAWESI BARAT,POLEWALI MANDAR,TUTAR,TARAMANU TUA,46,32,17,8,3,0,0,16,0,0,8,4,6,2,4,1,16,15,1,9,6,3,3,3,7,0,7,3,JANUARI
SULAWESI BARAT,POLEWALI MANDAR,WONOMULYO,SIDODADI,64,26,3,1,0,0,0,2,1,0,2,1,11,2,9,0,13,6,7,1,10,0,10,0,7,4,3,5,JANUARI
SULAWESI BARAT,POLEWALI MANDAR,WONOMULYO,SIDOREJO,77,33,3,1,0,0,0,0,2,1,3,0,10,9,1,6,10,7,3,5,9,2,7,0,4,0,4,2,JANUARI
SULAWESI BARAT,POLEWALI MANDAR,WONOMULYO,SUMBEREJO,66,18,1,1,0,0,0,0,0,1,1,0,0,0,0,0,14,11,3,3,14,3,11,0,1,1,0,0,JANUARI
SULAWESI BARAT,POLEWALI MANDAR,WONOMULYO,BUMIAYU,77,75,61,14,4,3,2,44,5,9,56,5,15,0,15,0,62,37,25,23,45,32,13,19,29,2,27,4,JANUARI
SULAWESI BARAT,POLEWALI MANDAR,WONOMULYO,KEBUNSARI,78,19,2,0,0,0,0,1,0,1,0,2,12,10,2,3,16,5,11,4,2,1,1,1,0,0,0,0,JANUARI
SULAWESI BARAT,POLEWALI MANDAR,WONOMULYO,BANUA BARU,35,64,6,6,3,3,3,3,0,0,1,1,7,7,0,5,31,26,5,24,1,0,1,0,12,11,1,11,JANUARI
SULAWESI BARAT,POLEWALI MANDAR,WONOMULYO,NEPO,67,65,51,36,10,9,4,44,0,2,0,5,1,0,1,0,28,23,5,1,18,0,18,0,53,36,17,44,JANUARI
SULAWESI BARAT,POLEWALI MANDAR,WONOMULYO,SUGIHWARAS,71,65,53,30,7,1,0,5,17,9,30,20,12,0,12,0,12,8,4,6,11,7,4,1,30,24,6,18,JANUARI
SULAWESI BARAT,POLEWALI MANDAR,WONOMULYO,CAMPURJO,38,59,43,35,2,0,0,10,21,9,42,1,0,0,0,0,36,21,15,12,20,6,14,4,43,35,8,24,JANUARI
SULAWESI BARAT,POLEWALI MANDAR,WONOMULYO,BUMIMULYO,42,58,13,9,6,5,3,3,4,3,6,2,5,0,5,0,16,5,11,3,5,1,4,0,21,13,8,16,JANUARI
SULAWESI BARAT,POLEWALI MANDAR,WONOMULYO,TUMPILING,70,20,12,8,5,2,1,10,0,0,12,0,9,8,1,3,18,15,3,8,10,2,8,2,7,3,4,0,JANUARI
SULAWESI BARAT,POLEWALI MANDAR,WONOMULYO,BAKKA-BAKKA,36,18,6,3,1,1,0,1,3,1,6,0,3,3,0,1,18,8,10,2,10,10,0,2,21,19,2,5,JANUARI
SULAWESI BARAT,POLEWALI MANDAR,WONOMULYO,ARJO SARI,60,58,19,15,6,5,0,11,4,1,12,4,8,2,6,1,36,26,10,21,27,27,0,10,29,25,4,12,JANUARI
SULAWESI BARAT,POLEWALI MANDAR,WONOMULYO,GALESON,48,11,1,0,0,0,0,0,0,0,0,1,3,3,0,0,10,10,0,2,9,8,1,8,12,6,6,11,JANUARI
SULAWESI BARAT,MAMUJU,MAMUJU,BINANGA,99,41,12,10,5,0,0,5,4,2,12,0,18,11,7,1,41,6,35,0,9,8,1,0,28,9,19,24,JANUARI
SULAWESI BARAT,MAMUJU,MAMUJU,MAMUNYU,66,14,1,1,1,1,1,0,0,0,0,0,10,7,3,5,10,9,1,1,10,4,6,0,15,12,3,0,JANUARI
SULAWESI BARAT,MAMUJU,MAMUJU,KAREMA,82,72,49,39,4,1,0,8,19,5,49,0,3,1,2,1,35,31,4,12,28,2,26,0,55,12,43,53,JANUARI
SULAWESI BARAT,MAMUJU,MAMUJU,RIMUKU,100,27,0,0,0,0,0,0,0,0,0,0,2,0,2,0,17,5,12,1,1,1,0,1,6,5,1,4,JANUARI
SULAWESI BARAT,MAMUJU,MAMUJU,BAMBU,48,78,53,30,24,6,1,24,3,15,52,1,5,4,1,4,57,20,37,15,45,18,27,9,41,23,18,37,JANUARI
SULAWESI BARAT,MAMUJU,MAMUJU,KARAMPUANG,79,46,31,0,0,0,0,4,14,13,29,2,10,3,7,2,35,33,2,26,13,2,11,2,24,12,12,16,JANUARI
SULAWESI BARAT,MAMUJU,MAMUJU,TADUI,60,78,57,52,28,28,9,31,3,9,50,0,7,5,2,2,17,6,11,6,5,0,5,0,57,55,2,43,JANUARI
SULAWESI BARAT,MAMUJU,MAMUJU,BATU PANNU,68,23,1,1,0,0,0,1,0,0,1,0,4,3,1,0,16,6,10,3,15,8,7,5,20,4,16,7,JANUARI
SULAWESI BARAT,MAMUJU,TAPALANG,GALUNG,54,61,13,7,5,2,0,8,2,2,12,0,10,9,1,9,57,18,39,14,18,14,4,9,48,2,46,25,JANUARI
SULAWESI BARAT,MAMUJU,TAPALANG,KASAMBANG,30,49,29,0,0,0,0,22,1,0,4,5,2,0,2,0,19,10,9,9,13,0,13,0,21,2,19,5,JANUARI
SULAWESI BARAT,MAMUJU,TAPALANG,DAYANGINNA,89,28,13,8,4,3,3,1,3,4,6,2,1,0,1,0,13,6,7,3,12,0,12,0,3,0,3,1,JANUARI
SULAWESI BARAT,MAMUJU,TAPALANG,OROBATU,32,36,21,20,16,14,3,7,11,0,2,1,6,0,6,0,23,7,16,3,0,0,0,0,10,10,0,5,JANUARI
SULAWESI BARAT,MAMUJU,TAPALANG,TAKANDEANG,78,78,77,55,1,0,0,27,33,14,63,8,2,1,1,0,42,15,27,3,3,2,1,2,35,14,21,12,JANUARI
SULAWESI BARAT,MAMUJU,TAPALANG,BELA,79,45,16,5,1,1,0,11,1,0,3,0,6,0,6,0,35,23,12,18,0,0,0,0,29,21,8,6,JANUARI
SULAWESI BARAT,MAMUJU,TAPALANG,TAAN,98,77,17,3,1,1,0,7,8,1,11,2,14,5,9,2,46,23,23,11,38,2,36,0,20,16,4,9,JANUARI
SULAWESI BARAT,MAMUJU,TAPALANG,TAMPALANG,40,49,1,1,1,0,0,1,0,0,1,0,4,2,2,0,45,41,4,41,27,26,1,19,32,16,16,21,JANUARI
SULAWESI BARAT,MAMUJU,TAPALANG,RANTEDODA,97,53,29,10,5,3,1,2,23,2,0,11,15,1,14,0,37,26,11,18,20,20,0,13,26,14,12,2,JANUARI
SULAWESI BARAT,MAMUJU,TAPALANG,KOPEANG,72,61,37,7,7,2,0,2,16,15,7,22,12,2,10,0,34,24,10,14,29,4,25,0,3,3,0,3,JANUARI
SULAWESI BARAT,MAMUJU,KALUKKU,SINYONYOI,73,80,53,19,5,4,2,36,14,0,25,2,10,4,6,3,52,9,43,9,0,0,0,0,31,18,13,3,JANUARI
SULAWESI BARAT,MAMUJU,KALUKKU,BEBANGA,40,17,13,9,3,3,0,5,3,2,9,3,8,3,5,0,15,15,0,3,6,0,6,0,0,0,0,0,JANUARI
SULAWESI BARAT,MAMUJU,KALUKKU,KALUKKU,55,56,6,2,2,0,0,2,2,0,4,1,6,3,3,0,31,19,12,9,29,27,2,25,14,7,7,1,JANUARI
SULAWESI BARAT,MAMUJU,KALUKKU,SINYONYOI SELATAN,37,33,31,30,5,5,4,23,2,0,0,30,1,0,1,0,19,19,0,14,1,0,1,0,10,6,4,4,JANUARI
SULAWESI BARAT,MAMUJU,KALUKKU,SONDOANG,50,41,41,0,0,0,0,39,1,0,25,1,10,4,6,1,10,7,3,0,6,2,4,2,30,15,15,29,JANUARI
SULAWESI BARAT,MAMUJU,KALUKKU,BERU-BERU,90,15,4,2,0,0,0,0,4,0,3,1,9,4,5,4,14,11,3,6,6,2,4,2,8,3,5,8,JANUARI
SULAWESI BARAT,MAMUJU,KALUKKU,BELANG BELANG,62,25,7,0,0,0,0,1,2,3,4,3,4,4,0,4,25,7,18,2,4,3,1,2,1,0,1,1,JANUARI
SULAWESI BARAT,MAMUJU,KALUKKU,KABULOANG,56,28,14,10,7,1,1,11,0,0,1,5,9,4,5,1,27,27,0,11,7,6,1,1,5,4,1,3,JANUARI
SULAWESI BARAT,MAMUJU,KALUKKU,KEANG,56,69,24,0,0,0,0,17,4,0,17,4,4,3,1,2,24,11,13,10,24,15,9,14,46,40,6,26,JANUARI
SULAWESI BARAT,MAMUJU,KALUKKU,POKKANG,32,26,23,21,4,1,0,22,1,0,23,0,0,0,0,0,14,12,2,6,10,0,10,0,16,10,6,13,JANUARI
SULAWESI BARAT,MAMUJU,KALUKKU,GULILING,90,57,10,2,1,1,0,9,0,1,9,0,6,0,6,0,56,41,15,1,18,6,12,0,27,3,24,23,JANUARI
SULAWESI BARAT,MAMUJU,KALUKKU,UHAIMATE,75,25,24,8,4,0,0,22,2,0,10,4,8,7,1,3,14,7,7,5,13,5,8,4,6,0,6,2,JANUARI
SULAWESI BARAT,MAMUJU,KALUKKU,KALUKKU BARAT,99,69,43,13,9,5,2,34,1,2,32,4,2,0,2,0,35,34,1,6,14,4,10,1,42,25,17,34,JANUARI
SULAWESI BARAT,MAMUJU,KALUKKU,PAMMULUKANG,63,50,18,10,9,6,1,3,7,4,1,5,8,3,5,0,22,16,6,9,17,17,0,15,48,32,16,42,JANUARI
SULAWESI BARAT,MAMUJU,KALUMPANG,KALUMPANG,74,78,54,28,4,3,1,18,33,2,14,29,8,1,7,0,26,10,16,4,19,3,16,0,1,1,0,0,JANUARI
SULAWESI BARAT,MAMUJU,KALUMPANG,KARATAUN,34,44,20,18,1,0,0,7,3,4,11,2,4,3,1,3,44,43,1,8,23,4,19,3,3,3,0,1,JANUARI
SULAWESI BARAT,MAMUJU,KALUMPANG,KARAMA,73,79,59,36,1,1,1,31,22,1,55,0,0,0,0,0,24,23,1,16,11,8,3,8,24,21,3,15,JANUARI
SULAWESI BARAT,MAMUJU,KALUMPANG,SIRAUN,61,71,38,31,25,25,0,22,11,0,6,11,11,7,4,5,11,5,6,4,6,1,5,0,20,7,13,16,JANUARI
SULAWESI BARAT,MAMUJU,KALUMPANG,TUMOGA,48,73,63,45,11,5,1,43,3,8,42,11,0,0,0,0,62,28,34,25,60,39,21,29,81,50,31,1,JANUARI
SULAWESI BARAT,MAMUJU,KALUMPANG,SALUMAKKI,64,72,10,6,1,1,1,6,0,1,0,6,12,8,4,5,31,24,7,10,22,2,20,1,58,4,54,2,JANUARI
SULAWESI BARAT,MAMUJU,KALUMPANG,POLIO,77,76,11,7,3,3,2,6,3,0,11,0,5,2,3,1,75,20,55,19,10,9,1,4,21,1,20,16,JANUARI
SULAWESI BARAT,MAMUJU,KALUMPANG,LIMBONG,58,13,9,0,0,0,0,3,2,0,2,2,11,3,8,3,13,10,3,2,10,2,8,1,19,8,11,10,JANUARI
SULAWESI BARAT,MAMUJU,KALUMPANG,SANDAPANG,95,12,8,6,0,0,0,8,0,0,2,4,10,2,8,2,10,8,2,7,10,0,10,0,13,2,11,11,JANUARI
SULAWESI BARAT,MAMUJU,KALUMPANG,KONDO BULO,73,72,18,16,8,8,3,5,1,1,6,10,4,4,0,3,39,9,30,8,35,13,22,1,25,5,20,20,JANUARI
SULAWESI BARAT,MAMUJU,KALUMPANG,MAKKALIKI,64,63,24,7,2,0,0,7,0,5,17,2,2,0,2,0,37,28,9,13,6,5,1,0,17,1,16,11,JANUARI
SULAWESI BARAT,MAMUJU,KALUMPANG,BATU MAKKADA,94,73,15,6,1,1,1,10,4,0,10,3,8,4,4,4,71,61,10,22,71,4,67,3,104,101,3,91,JANUARI
SULAWESI BARAT,MAMUJU,KALUMPANG,LASA',37,25,11,8,1,0,0,4,7,0,6,0,4,3,1,2,19,5,14,5,6,5,1,0,12,12,0,11,JANUARI
SULAWESI BARAT,MAMUJU,PAPALANG,TOABO,62,56,44,6,0,0,0,20,14,6,23,3,6,4,2,3,32,13,19,12,29,15,14,12,66,37,29,14,JANUARI
SULAWESI BARAT,MAMUJU,PAPALANG,PAPALANG,81,42,15,2,0,0,0,1,2,12,3,1,9,6,3,1,24,12,12,5,16,8,8,1,32,14,18,13,JANUARI
SULAWESI BARAT,MAMUJU,PAPALANG,BONDA,32,65,50,6,5,0,0,48,2,0,46,1,6,3,3,3,37,8,29,0,28,28,0,4,21,9,12,2,JANUARI
SULAWESI BARAT,MAMUJU,PAPALANG,TOPORE,54,51,15,8,2,1,0,1,7,7,6,2,0,0,0,0,46,5,41,5,21,7,14,7,38,26,12,29,JANUARI
SULAWESI BARAT,MAMUJU,PAPALANG,SALUKAYU,95,64,16,1,0,0,0,5,2,5,12,4,19,15,4,8,49,31,18,12,10,10,0,10,0,0,0,0,JANUARI
SULAWESI BARAT,MAMUJU,PAPALANG,SUKADAMAI,44,57,35,27,20,3,1,28,3,1,10,20,6,6,0,5,24,20,4,17,15,3,12,0,16,11,5,3,JANUARI
SULAWESI BARAT,MAMUJU,PAPALANG,BODA-BODA,80,44,18,6,3,0,0,5,6,1,4,0,9,6,3,6,26,7,19,7,1,1,0,1,9,3,6,0,JANUARI
SULAWESI BARAT,MAMUJU,PAPALANG,SISANGO,71,58,34,34,31,5,3,7,13,10,26,5,12,7,5,4,19,11,8,6,6,2,4,0,43,37,6,2,JANUARI
SULAWESI BARAT,MAMUJU,PAPALANG,BATU AMPA,56,34,1,0,0,0,0,0,1,0,1,0,5,5,0,1,30,24,6,15,21,5,16,3,14,0,14,8,JANUARI
SULAWESI BARAT,MAMUJU,SAMPAGA,BUNDE,79,30,10,6,0,0,0,6,3,0,7,3,0,0,0,0,25,5,20,5,10,5,5,5,30,22,8,24,JANUARI
SULAWESI BARAT,MAMUJU,SAMPAGA,KALONDING,46,30,29,4,2,0,0,11,2,12,18,2,8,1,7,0,12,10,2,1,6,6,0,1,19,15,4,3,JANUARI
SULAWESI BARAT,MAMUJU,SAMPAGA,TARAILU,55,62,48,47,37,29,13,17,17,0,45,0,9,9,0,0,10,7,3,1,5,2,3,0,25,11,14,10,JANUARI
SULAWESI BARAT,MAMUJU,SAMPAGA,SAMPAGA,65,61,56,55,44,9,8,45,3,0,50,0,2,0,2,0,44,8,36,8,18,1,17,1,8,0,8,2,JANUARI
SULAWESI BARAT,MAMUJU,SAMPAGA,TANAMBUAH,52,47,32,24,13,8,1,29,0,1,9,20,6,6,0,0,32,23,9,18,22,17,5,3,38,16,22,17,JANUARI
SULAWESI BARAT,MAMUJU,SAMPAGA,SALUBARANA,58,53,13,2,2,2,1,3,6,0,12,1,0,0,0,0,37,5,32,0,17,2,15,2,2,0,2,0,JANUARI
SULAWESI BARAT,MAMUJU,SAMPAGA,LOSSO,81,64,31,31,16,16,11,16,0,4,22,7,4,1,3,0,56,41,15,22,13,1,12,0,36,13,23,22,JANUARI
SULAWESI BARAT,MAMUJU,TOMMO,TOMMO,70,29,1,1,0,0,0,1,0,0,1,0,6,0,6,0,22,9,13,2,12,6,6,2,10,8,2,4,JANUARI
SULAWESI BARAT,MAMUJU,TOMMO,CAMPALOGA,73,67,45,10,5,5,5,24,5,10,6,13,3,1,2,0,25,6,19,0,6,1,5,0,1,1,0,0,JANUARI
SULAWESI BARAT,MAMUJU,TOMMO,BUANA SAKTI,35,48,33,6,1,0,0,2,9,17,14,15,0,0,0,0,28,20,8,6,16,12,4,1,21,4,17,7,JANUARI
SULAWESI BARAT,MAMUJU,TOMMO,TAMEMONGGA,56,18,6,3,1,1,0,6,0,0,2,0,2,2,0,2,18,13,5,9,17,5,12,2,22,8,14,8,JANUARI
SULAWESI BARAT,MAMUJU,TOMMO,TAMEJARRA,64,80,28,7,0,0,0,3,5,10,14,10,4,4,0,1,28,15,13,6,4,3,1,1,1,1,0,1,JANUARI
SULAWESI BARAT,MAMUJU,TOMMO,RANTEMARIO,33,28,18,4,3,1,1,15,0,1,2,8,2,1,1,1,27,6,21,3,22,13,9,9,28,10,18,9,JANUARI
SULAWESI BARAT,MAMUJU,TOMMO,MALINO,42,31,14,1,1,0,0,9,4,0,7,4,7,2,5,1,11,11,0,0,5,1,4,1,9,3,6,2,JANUARI
SULAWESI BARAT,MAMUJU,TOMMO,KAKULLASANG,61,30,25,16,13,5,4,13,7,1,5,13,4,1,3,0,15,11,4,5,2,0,2,0,20,10,10,17,JANUARI
SULAWESI BARAT,MAMUJU,TOMMO,LELING,93,35,16,16,16,11,8,1,4,1,15,0,15,8,7,7,16,8,8,1,14,5,9,4,26,13,13,11,JANUARI
SULAWESI BARAT,MAMUJU,TOMMO,KALEPU,55,64,25,1,0,0,0,5,3,14,22,2,1,1,0,0,30,5,25,5,26,12,14,3,70,4,66,60,JANUARI
SULAWESI BARAT,MAMUJU,TOMMO,SANDANA,68,67,59,17,15,3,3,53,3,0,4,44,11,1,10,0,44,11,33,10,2,0,2,0,11,10,1,3,JANUARI
SULAWESI BARAT,MAMUJU,TOMMO,LELING BARAT,53,53,51,35,6,2,2,38,4,3,23,11,3,2,1,1,39,10,29,2,24,19,5,10,40,40,0,6,JANUARI
SULAWESI BARAT,MAMUJU,TOMMO,LELING UTARA,32,20,16,5,1,0,0,8,5,2,4,11,1,1,0,0,15,14,1,9,12,6,6,4,5,0,5,2,JANUARI
SULAWESI BARAT,MAMUJU,TOMMO,SALUDENGEN,38,79,50,10,10,6,1,13,31,1,24,26,3,1,2,1,64,47,17,13,37,10,27,2,28,21,7,7,JANUARI
SULAWESI BARAT,MAMUJU,SIMBORO DAN KEPULAUAN,SIMBORO,41,68,36,3,1,1,1,0,15,4,5,23,0,0,0,0,12,7,5,6,11,7,4,2,14,14,0,4,JANUARI
SULAWESI BARAT,MAMUJU,SIMBORO DAN KEPULAUAN,RANGAS,82,23,16,2,0,0,0,14,2,0,9,3,15,12,3,4,18,9,9,7,17,13,4,2,8,4,4,4,JANUARI
SULAWESI BARAT,MAMUJU,SIMBORO DAN KEPULAUAN,BOTTENG,81,16,14,6,0,0,0,11,1,2,0,6,6,1,5,1,10,5,5,2,10,5,5,4,7,1,6,4,JANUARI
SULAWESI BARAT,MAMUJU,SIMBORO DAN KEPULAUAN,SALETTO,81,34,29,6,3,3,1,28,0,0,9,8,13,4,9,4,21,21,0,0,20,4,16,3,16,11,5,2,JANUARI
SULAWESI BARAT,MAMUJU,SIMBORO DAN KEPULAUAN,SUMARE,99,16,9,4,2,1,0,1,6,1,6,0,1,0,1,0,15,6,9,4,3,1,2,0,4,2,2,2,JANUARI
SULAWESI BARAT,MAMUJU,SIMBORO DAN KEPULAUAN,BOTTENG UTARA,53,53,26,13,9,0,0,14,11,1,2,10,5,4,1,0,29,7,22,6,15,15,0,5,11,1,10,2,JANUARI
SULAWESI BARAT,MAMUJU,SIMBORO DAN KEPULAUAN,TAPANDULLU,34,65,0,0,0,0,0,0,0,0,0,0,4,1,3,1,28,28,0,24,22,2,20,2,60,31,29,18,JANUARI
SULAWESI BARAT,MAMUJU,SIMBORO DAN KEPULAUAN,PATI'DI,81,28,12,4,3,2,0,0,2,4,10,2,13,5,8,0,28,8,20,1,20,0,20,0,11,2,9,6,JANUARI
SULAWESI BARAT,MAMUJU,TAPALANG BARAT,DUNGKAIT,97,32,27,15,2,1,1,10,16,0,1,5,10,1,9,0,20,20,0,13,20,13,7,3,3,1,2,0,JANUARI
SULAWESI BARAT,MAMUJU,TAPALANG BARAT,LEBANI,75,76,22,4,3,3,1,11,5,2,3,13,10,5,5,4,63,16,47,10,14,1,13,0,46,12,34,7,JANUARI
SULAWESI BARAT,MAMUJU,TAPALANG BARAT,LABUANG RANO,77,65,56,48,20,10,9,15,1,26,18,36,6,2,4,2,60,54,6,27,11,9,2,2,9,2,7,5,JANUARI
SULAWESI BARAT,MAMUJU,TAPALANG BARAT,PASABU,98,61,59,22,21,14,14,12,3,15,56,3,19,4,15,4,58,33,25,0,24,9,15,3,41,33,8,12,JANUARI
SULAWESI BARAT,MAMUJU,TAPALANG BARAT,TANETE PAO,55,18,16,0,0,0,0,11,0,1,3,6,5,4,1,1,18,16,2,14,15,11,4,9,7,4,3,4,JANUARI
SULAWESI BARAT,MAMUJU,TAPALANG BARAT,PANGASAAN,51,73,22,17,8,7,0,21,1,0,14,7,1,1,0,1,39,35,4,14,16,7,9,2,59,10,49,43,JANUARI
SULAWESI BARAT,MAMUJU,TAPALANG BARAT,AHU,97,70,48,15,8,1,0,48,0,0,46,0,14,6,8,6,37,9,28,0,26,20,6,13,49,4,45,42,JANUARI
SULAWESI BARAT,MAMUJU,BONEHAU,BONEHAU,75,56,24,16,4,3,0,3,2,19,19,3,6,4,2,4,42,19,23,17,27,3,24,1,24,5,19,11,JANUARI
SULAWESI BARAT,MAMUJU,BONEHAU,SALUTIWO,61,51,51,20,0,0,0,9,39,2,18,20,2,1,1,0,44,16,28,0,43,1,42,1,25,9,16,0,JANUARI
SULAWESI BARAT,MAMUJU,BONEHAU,BUTTUADA,57,53,11,0,0,0,0,6,3,0,11,0,9,9,0,4,12,10,2,6,1,0,1,0,21,1,20,4,JANUARI
SULAWESI BARAT,MAMUJU,BONEHAU,TAMALEA,36,43,8,1,1,0,0,6,2,0,0,5,0,0,0,0,42,37,5,11,27,16,11,2,38,26,12,24,JANUARI
SULAWESI BARAT,MAMUJU,BONEHAU,LUMIKA,82,23,12,2,1,1,1,8,3,0,0,9,10,3,7,0,20,12,8,0,2,2,0,1,2,1,1,2,JANUARI
SULAWESI BARAT,MAMUJU,BONEHAU,MAPPU,77,28,0,0,0,0,0,0,0,0,0,0,0,0,0,0,23,18,5,2,11,1,10,1,1,1,0,1,JANUARI
SULAWESI BARAT,MAMUJU,BONEHAU,BANUADA,48,74,67,44,9,9,6,51,1,2,9,11,7,6,1,3,50,47,3,24,43,9,34,1,60,4,56,41,JANUARI
SULAWESI BARAT,MAMUJU,BONEHAU,HINUA,80,15,0,0,0,0,0,0,0,0,0,0,9,9,0,9,14,12,2,4,2,1,1,0,10,8,2,0,JANUARI
SULAWESI BARAT,MAMUJU,BONEHAU,KINATANG,64,10,10,10,6,0,0,1,3,0,7,3,3,3,0,2,10,8,2,7,8,1,7,0,14,10,4,11,JANUARI
SULAWESI BARAT,MAMUJU,KEP. BALA BALAKANG,BALA BALAKANG,65,55,28,9,1,0,0,3,22,0,22,0,13,10,3,4,16,14,2,3,5,0,5,0,9,9,0,0,JANUARI
SULAWESI BARAT,MAMUJU,KEP. BALA BALAKANG,BALA-BALAKANG TIMUR,42,64,34,2,1,1,1,29,1,3,26,1,1,0,1,0,18,6,12,3,0,0,0,0,18,10,8,16,JANUARI
SULAWESI BARAT,MAMUJU TENGAH,TOBADAK,MAHAHE,62,20,16,5,2,2,2,3,7,0,2,11,6,5,1,1,19,9,10,8,13,6,7,1,0,0,0,0,FEBRUARI
SULAWESI BARAT,MAMUJU TENGAH,TOBADAK,SALOBAJA,62,28,6,4,1,0,0,3,2,0,0,0,1,1,0,1,23,16,7,0,20,5,15,0,35,11,24,29,FEBRUARI
SULAWESI BARAT,MAMUJU TENGAH,TOBADAK,TOBADAK,35,78,31,26,15,10,9,4,16,1,29,1,2,1,1,1,58,26,32,14,57,51,6,13,83,1,82,75,FEBRUARI
SULAWESI BARAT,MAMUJU TENGAH,TOBADAK,PALONGAAN,82,27,9,4,4,0,0,1,8,0,9,0,3,0,3,0,23,18,5,12,19,13,6,13,24,23,1,15,FEBRUARI
SULAWESI BARAT,MAMUJU TENGAH,TOBADAK,BATU PARIGI,71,67,38,3,1,0,0,12,17,4,34,4,12,7,5,1,29,11,18,5,23,11,12,1,50,15,35,33,FEBRUARI
SULAWESI BARAT,MAMUJU TENGAH,TOBADAK,BAMBADARU,100,43,2,2,1,0,0,1,1,0,0,0,6,2,4,1,15,14,1,10,4,3,1,1,29,9,20,19,FEBRUARI
SULAWESI BARAT,MAMUJU TENGAH,TOBADAK,SEJATI,52,74,71,66,56,25,21,45,4,1,31,18,9,5,4,0,62,51,11,29,25,8,17,3,59,49,10,6,FEBRUARI
SULAWESI BARAT,MAMUJU TENGAH,TOBADAK,SALOADAK,96,43,14,6,2,0,0,9,5,0,0,14,15,10,5,0,19,18,1,7,16,0,16,0,4,0,4,0,FEBRUARI
SULAWESI BARAT,MAMUJU TENGAH,PANGALE,POLO PANGALE,51,53,29,13,12,1,1,15,6,1,23,1,8,8,0,1,45,33,12,16,32,0,32,0,57,29,28,32,FEBRUARI
SULAWESI BARAT,MAMUJU TENGAH,PANGALE,PANGALE,31,48,46,39,22,6,3,23,1,5,6,32,4,0,4,0,36,27,9,2,1,0,1,0,7,6,1,0,FEBRUARI
SULAWESI BARAT,MAMUJU TENGAH,PANGALE,SARTANAMAJU,55,13,8,1,0,0,0,7,0,0,1,2,2,2,0,2,12,8,4,8,2,1,1,1,1,1,0,1,FEBRUARI
SULAWESI BARAT,MAMUJU TENGAH,PANGALE,POLO LERENG,41,24,3,2,2,0,0,0,2,0,2,1,1,0,1,0,13,10,3,1,8,7,1,1,22,10,12,0,FEBRUARI
SULAWESI BARAT,MAMUJU TENGAH,PANGALE,KUO,82,16,2,1,0,0,0,2,0,0,0,0,15,12,3,1,14,14,0,4,14,14,0,1,25,1,24,24,FEBRUARI
SULAWESI BARAT,MAMUJU TENGAH,PANGALE,POLO CAMBA,90,18,14,1,0,0,0,13,0,1,0,2,7,3,4,1,11,9,2,5,3,2,1,1,8,4,4,3,FEBRUARI
SULAWESI BARAT,MAMUJU TENGAH,PANGALE,LAMBA-LAMBA,62,78,13,11,2,0,0,10,1,2,13,0,0,0,0,0,65,22,43,7,15,8,7,3,23,7,16,10,FEBRUARI
SULAWESI BARAT,MAMUJU TENGAH,PANGALE,KOMBILING,96,58,47,23,1,1,1,39,2,2,11,32,18,7,11,0,46,7,39,1,44,31,13,23,45,1,44,22,FEBRUARI
SULAWESI BARAT,MAMUJU TENGAH,PANGALE,LEMO-LEMO,37,54,6,6,0,0,0,1,1,0,0,3,5,1,4,1,41,30,11,6,30,1,29,1,31,31,0,22,FEBRUARI
SULAWESI BARAT,MAMUJU TENGAH,BUDONG-BUDONG,BABANA,64,11,9,0,0,0,0,3,4,0,7,0,12,7,5,2,10,8,2,0,4,1,3,1,4,3,1,1,FEBRUARI
SULAWESI BARAT,MAMUJU TENGAH,BUDONG-BUDONG,LUMU,98,77,36,35,15,11,1,26,7,0,35,1,6,2,4,1,51,48,3,35,33,8,25,4,20,4,16,5,FEBRUARI
SULAWESI BARAT,MAMUJU TENGAH,BUDONG-BUDONG,PONTANAKAYANG,37,18,6,1,1,0,0,4,1,0,5,1,3,3,0,3,11,9,2,5,2,2,0,2,2,0,2,1,FEBRUARI
SULAWESI BARAT,MAMUJU TENGAH,BUDONG-BUDONG,SALOGATTA,57,58,21,3,2,1,0,9,10,1,16,0,4,4,0,2,10,8,2,8,4,0,4,0,24,9,15,0,FEBRUARI
SULAWESI BARAT,MAMUJU TENGAH,BUDONG-BUDONG,KIRE,32,52,23,7,3,2,1,1,0,16,21,2,2,0,2,0,41,16,25,10,17,9,8,0,14,0,14,14,FEBRUARI
SULAWESI BARAT,MAMUJU TENGAH,BUDONG-BUDONG,TINALI,47,44,14,4,3,0,0,7,4,1,12,0,5,3,2,0,38,33,5,4,13,7,6,2,43,16,27,21,FEBRUARI
SULAWESI BARAT,MAMUJU TENGAH,BUDONG-BUDONG,SALUMANURUNG,63,43,19,7,2,1,1,5,0,10,13,5,12,2,10,0,36,11,25,0,28,4,24,3,41,34,7,0,FEBRUARI
SULAWESI BARAT,MAMUJU TENGAH,BUDONG-BUDONG,PASAPA,43,19,3,1,0,0,0,3,0,0,0,2,3,0,3,0,14,6,8,2,13,7,6,5,10,10,0,6,FEBRUARI
SULAWESI BARAT,MAMUJU TENGAH,BUDONG-BUDONG,BOJO,84,50,40,21,3,0,0,32,4,4,10,9,2,0,2,0,25,12,13,3,8,3,5,0,6,5,1,4,FEBRUARI
SULAWESI BARAT,MAMUJU TENGAH,BUDONG-BUDONG,BARAKKANG,67,23,22,14,14,6,6,14,1,1,19,0,8,3,5,2,14,7,7,5,7,3,4,2,22,17,5,2,FEBRUARI
SULAWESI BARAT,MAMUJU TENGAH,BUDONG-BUDONG,LEMBAH HADA,91,47,42,14,7,0,0,40,1,1,39,0,1,1,0,0,40,21,19,9,24,7,17,3,24,7,17,5,FEBRUARI
SULAWESI BARAT,MAMUJU TENGAH,TOPOYO,BUDONG-BUDONG,56,25,16,3,3,3,3,11,1,1,2,11,8,4,4,0,15,12,3,6,1,1,0,0,12,1,11,9,FEBRUARI
SULAWESI BARAT,MAMUJU TENGAH,TOPOYO,TOPOYO,86,49,46,31,5,2,1,18,3,19,42,0,17,13,4,0,37,35,2,7,19,9,10,2,19,1,18,1,FEBRUARI
SULAWESI BARAT,MAMUJU TENGAH,TOPOYO,TUMBU,57,74,27,6,4,3,3,1,10,10,22,5,2,2,0,1,52,9,43,5,1,1,0,0,44,12,32,36,FEBRUARI
SULAWESI BARAT,MAMUJU TENGAH,TOPOYO,KABUBU,47,40,16,14,1,0,0,15,0,0,2,1,3,3,0,3,25,16,9,0,21,15,6,15,18,16,2,11,FEBRUARI
SULAWESI BARAT,MAMUJU TENGAH,TOPOYO,WAEPUTEH,30,42,0,0,0,0,0,0,0,0,0,0,3,2,1,2,13,13,0,2,1,1,0,1,30,9,21,18,FEBRUARI
SULAWESI BARAT,MAMUJU TENGAH,TOPOYO,TANGKOU,68,55,50,27,2,0,0,9,13,19,40,8,7,2,5,2,12,5,7,5,4,0,4,0,39,25,14,3,FEBRUARI
SULAWESI BARAT,MAMUJU TENGAH,TOPOYO,TABOLANG,53,22,16,4,2,2,1,1,6,0,15,1,8,3,5,2,19,14,5,3,6,4,2,2,20,11,9,20,FEBRUARI
SULAWESI BARAT,MAMUJU TENGAH,TOPOYO,PARAILI,91,67,64,24,20,8,7,53,3,0,2,41,18,16,2,11,42,23,19,5,7,1,6,1,15,1,14,0,FEBRUARI
SULAWESI BARAT,MAMUJU TENGAH,TOPOYO,SALUPANGKANG,46,11,11,2,0,0,0,1,10,0,3,2,5,1,4,1,10,6,4,0,7,6,1,2,6,4,2,6,FEBRUARI
SULAWESI BARAT,MAMUJU TENGAH,TOPOYO,SALUPANGKANG IV,72,14,1,0,0,0,0,0,0,0,1,0,4,0,4,0,14,12,2,11,6,5,1,5,2,0,2,1,FEBRUARI
SULAWESI BARAT,MAMUJU TENGAH,TOPOYO,TAPPILINA,83,72,56,28,19,12,10,45,1,0,22,22,1,0,1,0,61,48,13,2,53,0,53,0,37,16,21,10,FEBRUARI
SULAWESI BARAT,MAMUJU TENGAH,TOPOYO,BAMBAMANURUNG,35,23,19,6,5,2,0,16,2,1,16,0,6,5,1,1,11,7,4,6,5,3,2,1,16,4,12,15,FEBRUARI
SULAWESI BARAT,MAMUJU TENGAH,TOPOYO,SALULEKBO,35,35,29,29,3,2,2,13,5,2,24,0,5,5,0,1,33,31,2,30,0,0,0,0,4,0,4,4,FEBRUARI
SULAWESI BARAT,MAMUJU TENGAH,TOPOYO,PANGALLOANG,72,12,6,0,0,0,0,0,1,0,0,6,13,0,13,0,10,5,5,3,9,2,7,2,2,2,0,2,FEBRUARI
SULAWESI BARAT,MAMUJU TENGAH,TOPOYO,SINABATTA,65,43,2,2,1,0,0,0,2,0,2,0,7,6,1,5,33,20,13,10,29,19,10,16,0,0,0,0,FEBRUARI
SULAWESI BARAT,MAMUJU TENGAH,KAROSSA,KAROSSA,58,63,43,38,26,16,14,24,4,1,1,29,0,0,0,0,19,14,5,1,8,1,7,0,28,23,5,9,FEBRUARI
SULAWESI BARAT,MAMUJU TENGAH,KAROSSA,TASOKKO,59,49,7,0,0,0,0,2,5,0,3,2,3,2,1,2,48,7,41,5,47,18,29,16,67,59,8,1,FEBRUARI
SULAWESI BARAT,MAMUJU TENGAH,KAROSSA,LARA,43,23,15,1,1,1,0,14,0,0,11,1,7,4,3,1,16,8,8,8,16,3,13,2,25,13,12,13,FEBRUARI
SULAWESI BARAT,MAMUJU TENGAH,KAROSSA,KADAILA,57,57,5,0,0,0,0,1,2,0,1,2,11,0,11,0,25,18,7,9,18,2,16,1,2,2,0,2,FEBRUARI
SULAWESI BARAT,MAMUJU TENGAH,KAROSSA,KAYU CALLA,90,24,5,5,3,1,1,0,3,1,2,1,12,8,4,1,24,6,18,6,6,2,4,0,21,4,17,4,FEBRUARI
SULAWESI BARAT,MAMUJU TENGAH,KAROSSA,LEMBAH HOPO,31,55,46,43,32,29,9,1,27,4,30,5,5,1,4,0,43,38,5,15,16,2,14,2,43,35,8,28,FEBRUARI
SULAWESI BARAT,MAMUJU TENGAH,KAROSSA,BENGGAULU,69,34,17,13,4,1,0,17,0,0,11,4,4,2,2,1,27,10,17,8,11,8,3,5,5,5,0,5,FEBRUARI
SULAWESI BARAT,MAMUJU TENGAH,KAROSSA,SUKA MAJU,33,45,1,0,0,0,0,0,1,0,1,0,1,1,0,1,15,14,1,1,14,11,3,0,43,9,34,12,FEBRUARI
SULAWESI BARAT,MAMUJU TENGAH,KAROSSA,KAMBUNONG,60,43,14,3,0,0,0,14,0,0,11,3,5,0,5,0,29,18,11,18,27,13,14,12,43,21,22,17,FEBRUARI
SULAWESI BARAT,MAMUJU TENGAH,KAROSSA,SALUBIRO,44,10,0,0,0,0,0,0,0,0,0,0,3,1,2,1,10,10,0,9,1,1,0,0,8,3,5,2,FEBRUARI
SULAWESI BARAT,MAMUJU TENGAH,KAROSSA,SANJANGO,76,69,43,13,10,6,2,26,1,8,16,22,15,0,15,0,68,61,7,18,42,16,26,5,77,13,64,26,FEBRUARI
SULAWESI BARAT,PASANGKAYU,BAMBAIRA,TAMPAURE,71,26,22,7,4,2,2,17,1,1,11,9,9,7,2,0,23,11,12,2,18,17,1,5,17,5,12,15,FEBRUARI
SULAWESI BARAT,PASANGKAYU,BAMBAIRA,BAMBAIRA,90,52,28,19,6,4,2,8,17,0,3,16,3,3,0,1,50,49,1,11,19,10,9,0,32,24,8,20,FEBRUARI
SULAWESI BARAT,PASANGKAYU,BAMBAIRA,KASOLOANG,74,62,29,13,11,11,1,22,6,0,11,15,4,3,1,3,14,10,4,7,9,2,7,1,27,23,4,25,FEBRUARI
SULAWESI BARAT,PASANGKAYU,BAMBAIRA,KALUKU NANGKA,54,40,3,1,1,1,0,3,0,0,2,0,10,1,9,1,20,7,13,0,12,5,7,3,40,7,33,27,FEBRUARI
SULAWESI BARAT,PASANGKAYU,BAMBALAMOTU,RANDOMAYANG,83,42,39,24,9,7,2,3,5,0,14,6,4,2,2,0,39,10,29,1,39,8,31,6,64,54,10,28,FEBRUARI
SULAWESI BARAT,PASANGKAYU,BAMBALAMOTU,BAMBALAMOTU,51,70,4,3,3,3,0,0,2,0,2,0,1,1,0,0,35,29,6,13,28,8,20,0,58,57,1,39,FEBRUARI
SULAWESI BARAT,PASANGKAYU,BAMBALAMOTU,POLEWALI,69,79,53,20,0,0,0,24,29,0,41,5,6,4,2,4,71,54,17,50,44,4,40,4,44,15,29,14,FEBRUARI
SULAWESI BARAT,PASANGKAYU,BAMBALAMOTU,PANGIANG,31,47,27,2,0,0,0,7,10,1,2,13,5,5,0,3,29,21,8,7,8,1,7,1,5,1,4,4,FEBRUARI
SULAWESI BARAT,PASANGKAYU,BAMBALAMOTU,KALOLA,51,79,68,44,24,12,0,54,12,1,15,51,10,9,1,7,15,6,9,2,14,2,12,0,13,8,5,2,FEBRUARI
SULAWESI BARAT,PASANGKAYU,BAMBALAMOTU,WULAI,99,62,37,32,2,0,0,5,3,18,27,6,16,13,3,12,51,29,22,16,23,11,12,10,16,16,0,12,FEBRUARI
SULAWESI BARAT,PASANGKAYU,BARAS,BARAS,67,75,14,5,4,0,0,1,12,1,10,3,12,1,11,1,22,17,5,13,8,4,4,0,9,5,4,5,FEBRUARI
SULAWESI BARAT,PASANGKAYU,BARAS,BULU PARIGI,64,42,11,7,0,0,0,1,10,0,6,1,4,2,2,1,24,21,3,12,11,6,5,3,14,3,11,5,FEBRUARI
SULAWESI BARAT,PASANGKAYU,BARAS,BALANTI,92,65,60,48,33,33,5,17,2,25,25,3,1,0,1,0,55,48,7,12,27,1,26,0,55,55,0,10,FEBRUARI
SULAWESI BARAT,PASANGKAYU,BARAS,MOTU,76,66,41,2,2,2,1,8,2,6,9,4,13,9,4,9,48,5,43,2,34,1,33,1,68,16,52,20,FEBRUARI
SULAWESI BARAT,PASANGKAYU,BARAS,TOWONI,41,75,55,22,9,6,6,2,18,10,50,0,8,0,8,0,74,53,21,0,2,2,0,0,46,1,45,21,FEBRUARI
SULAWESI BARAT,PASANGKAYU,BARAS,KASANO,66,74,18,15,5,1,1,0,4,11,9,4,3,3,0,1,16,15,1,8,8,1,7,1,48,6,42,36,FEBRUARI
SULAWESI BARAT,PASANGKAYU,BULU TABA,SUMBER SARI,92,42,11,0,0,0,0,0,10,1,2,7,6,6,0,1,38,18,20,5,18,11,7,3,34,9,25,20,FEBRUARI
SULAWESI BARAT,PASANGKAYU,BULU TABA,LELEJAE,71,58,5,5,0,0,0,5,0,0,2,0,12,4,8,3,13,13,0,0,7,7,0,7,17,15,2,1,FEBRUARI
SULAWESI BARAT,PASANGKAYU,BULU TABA,BUKIT HARAPAN,83,40,34,11,1,0,0,26,7,0,23,7,1,1,0,1,39,27,12,12,4,0,4,0,21,18,3,13,FEBRUARI
SULAWESI BARAT,PASANGKAYU,BULU TABA,LILIMORI,39,46,39,26,22,3,0,27,4,7,12,9,1,1,0,1,30,15,15,6,22,2,20,2,18,12,6,4,FEBRUARI
SULAWESI BARAT,PASANGKAYU,BULU TABA,KARAVE,51,18,13,8,8,0,0,12,1,0,1,12,6,5,1,1,16,14,2,13,9,9,0,5,1,0,1,0,FEBRUARI
SULAWESI BARAT,PASANGKAYU,BULU TABA,KASTABUANA,86,17,7,3,1,1,0,2,2,3,7,0,1,1,0,0,15,15,0,3,12,3,9,2,17,17,0,10,FEBRUARI
SULAWESI BARAT,PASANGKAYU,BULU TABA,OMPI,84,58,48,40,14,9,9,38,1,0,13,30,9,9,0,4,40,11,29,9,26,10,16,4,49,13,36,20,FEBRUARI
SULAWESI BARAT,PASANGKAYU,DAPURANG,DAPURANG,79,57,55,24,14,5,3,43,1,1,18,13,12,2,10,0,55,25,30,25,46,28,18,27,36,23,13,24,FEBRUARI
SULAWESI BARAT,PASANGKAYU,DAPURANG,BENGGAULU,97,40,18,12,0,0,0,6,0,9,3,14,3,0,3,0,14,6,8,2,13,8,5,8,38,20,18,12,FEBRUARI
SULAWESI BARAT,PASANGKAYU,DAPURANG,TIRTABUANA,42,54,6,3,2,0,0,6,0,0,1,1,8,1,7,1,29,17,12,17,29,22,7,11,59,34,25,3,FEBRUARI
SULAWESI BARAT,PASANGKAYU,DAPURANG,BULU BONGGU,53,56,0,0,0,0,0,0,0,0,0,0,0,0,0,0,54,25,29,3,49,4,45,4,16,1,15,14,FEBRUARI
SULAWESI BARAT,PASANGKAYU,DAPURANG,SARASA,57,45,45,0,0,0,0,5,30,6,37,2,6,0,6,0,27,16,11,14,13,3,10,2,8,1,7,2,FEBRUARI
SULAWESI BARAT,PASANGKAYU,DURIPOKU,TAMMARUNANG,71,11,1,0,0,0,0,1,0,0,1,0,8,6,2,3,10,9,1,9,9,5,4,0,10,8,2,3,FEBRUARI
SULAWESI BARAT,PASANGKAYU,DURIPOKU,SAPTANAJAYA,55,63,31,18,16,9,2,3,23,3,21,9,2,0,2,0,10,6,4,4,10,0,10,0,30,21,9,27,FEBRUARI
SULAWESI BARAT,PASANGKAYU,DURIPOKU,TARANGGI,53,43,43,41,10,10,6,18,6,3,16,27,5,4,1,0,33,24,9,14,17,10,7,9,21,18,3,14,FEBRUARI
SULAWESI BARAT,PASANGKAYU,DURIPOKU,SIPAKAINGA,89,39,5,4,1,1,1,0,4,0,0,2,2,1,1,0,17,6,11,3,3,3,0,0,1,1,0,0,FEBRUARI
SULAWESI BARAT,PASANGKAYU,LARIANG,KULU,91,18,13,10,3,2,1,10,0,2,0,10,8,4,4,1,12,7,5,4,6,4,2,3,1,0,1,0,FEBRUARI
SULAWESI BARAT,PASANGKAYU,LARIANG,PARABU,30,80,20,0,0,0,0,16,0,4,12,7,1,0,1,0,25,18,7,7,4,4,0,1,11,1,10,4,FEBRUARI
SULAWESI BARAT,PASANGKAYU,LARIANG,KENANGAN,76,10,9,1,0,0,0,7,0,2,3,4,8,3,5,0,10,9,1,7,5,0,5,0,9,3,6,2,FEBRUARI
SULAWESI BARAT,PASANGKAYU,LARIANG,BAJAWALI,51,22,15,11,11,9,5,10,0,0,8,7,10,10,0,2,22,11,11,3,12,1,11,0,23,23,0,17,FEBRUARI
SULAWESI BARAT,PASANGKAYU,LARIANG,SINGGANI,92,39,34,1,0,0,0,25,4,5,7,22,9,1,8,0,36,7,29,6,4,1,3,0,6,4,2,5,FEBRUARI
SULAWESI BARAT,PASANGKAYU,LARIANG,BATU MATORU,41,55,9,7,6,0,0,5,1,1,1,2,3,0,3,0,25,23,2,16,3,1,2,1,14,7,7,3,FEBRUARI
SULAWESI BARAT,PASANGKAYU,LARIANG,BAMBAKORO,60,11,10,2,1,1,1,7,1,0,10,0,3,3,0,1,11,8,3,3,3,0,3,0,8,0,8,8,FEBRUARI
SULAWESI BARAT,PASANGKAYU,PASANGKAYU,KARYA BERSAMA,70,52,37,5,0,0,0,16,4,6,36,0,13,9,4,0,10,6,4,6,7,7,0,7,21,13,8,16,FEBRUARI
SULAWESI BARAT,PASANGKAYU,PASANGKAYU,AKO,43,50,43,28,5,0,0,34,2,4,7,26,3,2,1,0,43,5,38,5,39,11,28,5,22,10,12,15,FEBRUARI
SULAWESI BARAT,PASANGKAYU,PASANGKAYU,PASANGKAYU,57,73,65,61,8,1,0,30,16,3,47,13,3,3,0,3,18,6,12,5,3,1,2,1,16,0,16,16,FEBRUARI
SULAWESI BARAT,PASANGKAYU,PASANGKAYU,MARTAJAYA,58,18,0,0,0,0,0,0,0,0,0,0,4,1,3,0,16,5,11,3,3,0,3,0,3,0,3,0,FEBRUARI
SULAWESI BARAT,PASANGKAYU,PASANGKAYU,PAKAVA,80,34,0,0,0,0,0,0,0,0,0,0,1,1,0,1,14,9,5,6,6,0,6,0,1,0,1,0,FEBRUARI
SULAWESI BARAT,PASANGKAYU,PASANGKAYU,GUNUNG SARI,95,76,34,1,1,0,0,13,17,0,6,27,7,0,7,0,44,9,35,7,14,1,13,0,53,26,27,30,FEBRUARI
SULAWESI BARAT,PASANGKAYU,PEDONGGA,MALEI,51,43,29,26,1,1,1,17,1,2,12,6,1,0,1,0,38,35,3,14,10,2,8,0,29,14,15,3,FEBRUARI
SULAWESI BARAT,PASANGKAYU,PEDONGGA,PEDANDA,64,61,25,15,14,2,2,16,0,3,21,0,2,2,0,0,10,10,0,3,3,2,1,2,2,1,1,0,FEBRUARI
SULAWESI BARAT,PASANGKAYU,PEDONGGA,BATU OGE,58,48,3,2,2,1,0,3,0,0,2,1,7,7,0,7,12,9,3,1,2,2,0,1,18,12,6,14,FEBRUARI
SULAWESI BARAT,PASANGKAYU,PEDONGGA,MARTASARI,94,36,16,5,4,4,3,5,7,0,2,9,17,1,16,1,34,10,24,6,31,4,27,4,0,0,0,0,FEBRUARI
SULAWESI BARAT,PASANGKAYU,SARJO,SARJO,47,72,36,24,19,16,5,24,5,1,16,12,7,2,5,0,70,28,42,8,30,28,2,14,9,3,6,1,FEBRUARI
SULAWESI BARAT,PASANGKAYU,SARJO,MAPONU,100,61,61,34,10,1,0,21,29,5,14,39,9,6,3,3,22,8,14,0,20,19,1,14,54,40,14,8,FEBRUARI
SULAWESI BARAT,PASANGKAYU,SARJO,LETAWA,75,53,37,36,3,3,0,21,7,2,37,0,7,5,2,1,29,23,6,18,3,0,3,0,17,17,0,16,FEBRUARI
SULAWESI BARAT,PASANGKAYU,SARJO,SARUDE,52,45,33,18,9,8,2,30,1,0,33,0,0,0,0,0,38,7,31,1,11,8,3,8,0,0,0,0,FEBRUARI
SULAWESI BARAT,PASANGKAYU,SARUDU,DODA,34,18,0,0,0,0,0,0,0,0,0,0,1,1,0,0,15,8,7,8,5,5,0,4,10,2,8,9,FEBRUARI
SULAWESI BARAT,PASANGKAYU,SARUDU,SARUDU,39,26,10,1,0,0,0,2,3,1,7,3,0,0,0,0,16,8,8,2,6,5,1,5,20,8,12,18,FEBRUARI
SULAWESI BARAT,PASANGKAYU,SARUDU,BULU MARIO,78,33,6,1,0,0,0,5,1,0,5,1,8,0,8,0,17,10,7,6,3,2,1,2,18,13,5,6,FEBRUARI
SULAWESI BARAT,PASANGKAYU,SARUDU,KUMASARI,70,33,23,6,5,2,2,17,3,1,12,8,6,3,3,1,13,10,3,7,0,0,0,0,13,6,7,12,FEBRUARI
SULAWESI BARAT,PASANGKAYU,SARUDU,PATIKA,51,42,31,13,7,1,1,13,11,4,31,0,8,0,8,0,24,8,16,2,5,2,3,1,33,14,19,13,FEBRUARI
SULAWESI BARAT,PASANGKAYU,TIKKE RAYA,MAKMUR JAYA,40,25,19,11,1,0,0,7,9,0,2,13,1,1,0,1,25,20,5,20,10,10,0,0,19,15,4,1,FEBRUARI
SULAWESI BARAT,PASANGKAYU,TIKKE RAYA,LARIANG,43,22,9,3,1,0,0,9,0,0,5,3,4,3,1,3,10,7,3,0,8,2,6,2,17,7,10,5,FEBRUARI
SULAWESI BARAT,PASANGKAYU,TIKKE RAYA,TIKKE,94,48,13,6,1,0,0,3,1,4,3,6,3,3,0,1,18,13,5,6,4,1,3,0,0,0,0,0,FEBRUARI
SULAWESI BARAT,PASANGKAYU,TIKKE RAYA,PAJALELE,47,45,34,1,1,0,0,29,4,0,31,2,4,3,1,1,26,12,14,1,6,5,1,5,27,4,23,23,FEBRUARI
SULAWESI BARAT,PASANGKAYU,TIKKE RAYA,JENGENG RAYA,42,36,20,5,1,1,0,2,0,4,6,8,0,0,0,0,18,10,8,5,13,8,5,7,8,2,6,4,FEBRUARI
SULAWESI BARAT,MAJENE,BANGGAE,BANGGAE,54,63,54,48,33,16,14,34,2,3,30,10,0,0,0,0,53,24,29,1,17,4,13,2,56,26,30,13,FEBRUARI
SULAWESI BARAT,MAJENE,BANGGAE,BARU,57,50,7,2,0,0,0,2,4,0,0,5,2,1,1,0,43,23,20,12,1,1,0,1,20,20,0,4,FEBRUARI
SULAWESI BARAT,MAJENE,BANGGAE,PANGALI ALI,88,61,40,36,28,6,6,22,3,8,16,15,14,8,6,5,61,31,30,29,37,13,24,7,23,5,18,0,FEBRUARI
SULAWESI BARAT,MAJENE,BANGGAE,TOTOLI,85,51,25,11,3,3,1,21,3,0,12,3,12,3,9,2,49,23,26,0,6,3,3,2,24,8,16,1,FEBRUARI
SULAWESI BARAT,MAJENE,BANGGAE,RANGAS,81,52,8,5,4,3,1,3,1,3,1,7,3,0,3,0,24,14,10,13,6,1,5,0,0,0,0,0,FEBRUARI
SULAWESI BARAT,MAJENE,BANGGAE,GALUNG,43,26,24,24,15,12,1,15,4,3,19,4,4,2,2,2,15,12,3,3,4,0,4,0,5,5,0,3,FEBRUARI
SULAWESI BARAT,MAJENE,BANGGAE,PALIPI SOREANG,93,24,5,2,2,2,1,3,1,0,2,1,9,6,3,3,19,15,4,11,9,7,2,6,20,12,8,5,FEBRUARI
SULAWESI BARAT,MAJENE,BANGGAE,PAMBOBORANG,93,69,58,6,4,0,0,54,0,0,11,22,4,3,1,2,42,20,22,19,39,9,30,1,37,14,23,21,FEBRUARI
SULAWESI BARAT,MAJENE,BANGGAE TIMUR,BAURUNG,34,68,0,0,0,0,0,0,0,0,0,0,5,4,1,1,56,52,4,28,28,3,25,1,64,56,8,49,FEBRUARI
SULAWESI BARAT,MAJENE,BANGGAE TIMUR,BARUGA,34,37,28,21,19,19,11,14,0,3,5,22,1,1,0,1,32,23,9,20,15,0,15,0,40,25,15,24,FEBRUARI
SULAWESI BARAT,MAJENE,BANGGAE TIMUR,BARUGA DHUA,81,74,53,49,35,14,4,23,9,8,38,5,6,4,2,3,24,12,12,11,11,2,9,1,6,2,4,3,FEBRUARI
SULAWESI BARAT,MAJENE,BANGGAE TIMUR,LABUANG,66,46,15,12,3,3,1,10,4,0,10,0,3,2,1,0,11,8,3,6,4,4,0,1,26,13,13,23,FEBRUARI
SULAWESI BARAT,MAJENE,BANGGAE TIMUR,TANDE,40,49,7,4,0,0,0,6,1,0,2,4,8,5,3,0,13,11,2,2,11,7,4,2,39,21,18,14,FEBRUARI
SULAWESI BARAT,MAJENE,BANGGAE TIMUR,LEMBANG,75,19,1,1,1,0,0,0,0,1,1,0,8,1,7,1,13,5,8,3,12,4,8,3,21,2,19,10,FEBRUARI
SULAWESI BARAT,MAJENE,BANGGAE TIMUR,LABUANG UTARA,62,12,1,1,0,0,0,1,0,0,0,1,5,3,2,3,10,7,3,1,7,2,5,1,5,3,2,1,FEBRUARI
SULAWESI BARAT,MAJENE,BANGGAE TIMUR,TANDE TIMUR,64,62,57,12,7,6,3,1,8,22,30,19,8,7,1,5,19,7,12,6,16,16,0,2,45,11,34,20,FEBRUARI
SULAWESI BARAT,MAJENE,BANGGAE TIMUR,BUTTU BARUGA,40,61,2,0,0,0,0,0,2,0,2,0,7,7,0,7,20,10,10,0,0,0,0,0,6,2,4,6,FEBRUARI
SULAWESI BARAT,MAJENE,MALUNDA,MALUNDA,96,70,56,33,10,7,7,38,10,1,3,17,12,10,2,1,15,5,10,1,0,0,0,0,31,16,15,26,FEBRUARI
SULAWESI BARAT,MAJENE,MALUNDA,LAMUNGANG BATU,89,75,70,11,2,2,2,21,22,3,31,15,16,1,15,0,50,41,9,16,43,2,41,0,71,62,9,23,FEBRUARI
SULAWESI BARAT,MAJENE,MALUNDA,BAMBANGAN,58,63,27,7,4,1,0,3,6,18,17,4,11,5,6,4,39,38,1,28,38,24,14,9,53,22,31,18,FEBRUARI
SULAWESI BARAT,MAJENE,MALUNDA,LOMBANG,70,79,13,0,0,0,0,6,6,1,1,3,8,5,3,1,53,11,42,11,35,0,35,0,29,22,7,22,FEBRUARI
SULAWESI BARAT,MAJENE,MALUNDA,LOMBONG,76,35,19,18,16,8,3,5,8,2,9,6,4,4,0,0,34,33,1,3,16,15,1,9,29,10,19,24,FEBRUARI
SULAWESI BARAT,MAJENE,MALUNDA,MEKKATTA,35,31,22,2,1,0,0,7,5,0,14,1,5,4,1,2,17,10,7,4,13,12,1,3,17,16,1,8,FEBRUARI
SULAWESI BARAT,MAJENE,MALUNDA,MALIAYA,39,77,42,0,0,0,0,40,0,0,32,5,2,2,0,1,59,6,53,5,38,2,36,2,81,26,55,75,FEBRUARI
SULAWESI BARAT,MAJENE,MALUNDA,LOMBANG TIMUR,30,61,11,8,7,1,0,0,8,1,10,1,3,2,1,1,10,9,1,8,6,5,1,5,37,37,0,11,FEBRUARI
SULAWESI BARAT,MAJENE,MALUNDA,SALUTAHONGAN,66,60,59,30,27,26,3,18,38,0,26,6,3,1,2,1,48,47,1,45,1,1,0,1,13,11,2,0,FEBRUARI
SULAWESI BARAT,MAJENE,MALUNDA,LOMBONG TIMUR,43,19,10,3,3,2,1,1,8,0,6,0,3,1,2,1,16,15,1,8,16,0,16,0,11,6,5,10,FEBRUARI
SULAWESI BARAT,MAJENE,MALUNDA,MEKKATTA SELATAN,72,69,48,29,5,4,0,30,15,1,4,17,1,0,1,0,32,29,3,5,16,4,12,3,48,1,47,25,FEBRUARI
SULAWESI BARAT,MAJENE,MALUNDA,KAYUANGIN,51,19,2,1,0,0,0,2,0,0,0,2,9,6,3,6,10,8,2,8,2,0,2,0,10,3,7,3,FEBRUARI
SULAWESI BARAT,MAJENE,PAMBOANG,LALAMPANUA,70,27,1,0,0,0,0,0,1,0,0,1,8,7,1,5,26,6,20,2,12,3,9,2,7,4,3,3,FEBRUARI
SULAWESI BARAT,MAJENE,PAMBOANG,SIRINDU,51,62,18,16,3,3,2,2,7,1,10,6,6,2,4,1,61,44,17,38,21,1,20,1,10,8,2,10,FEBRUARI
SULAWESI BARAT,MAJENE,PAMBOANG,ADOLANG,89,14,10,8,5,2,0,1,7,0,3,6,2,0,2,0,12,10,2,1,12,6,6,4,15,11,4,0,FEBRUARI
SULAWESI BARAT,MAJENE,PAMBOANG,BABABULO,97,65,26,9,0,0,0,19,3,3,16,6,8,7,1,0,20,13,7,8,0,0,0,0,34,13,21,21,FEBRUARI
SULAWESI BARAT,MAJENE,PAMBOANG,BONDE,76,38,18,16,7,6,0,6,0,4,13,5,5,1,4,1,23,18,5,13,14,4,10,3,18,4,14,7,FEBRUARI
SULAWESI BARAT,MAJENE,PAMBOANG,BETTENG,88,71,11,9,5,2,0,2,4,1,0,0,7,6,1,1,37,14,23,14,27,23,4,13,36,15,21,24,FEBRUARI
SULAWESI BARAT,MAJENE,PAMBOANG,SIMBANG,54,12,7,4,2,1,1,4,2,0,0,4,4,1,3,0,11,11,0,3,3,1,2,1,3,1,2,2,FEBRUARI
SULAWESI BARAT,MAJENE,PAMBOANG,BONDE UTARA,57,32,27,23,21,21,7,17,3,0,11,6,9,5,4,0,16,15,1,15,13,6,7,2,3,2,1,2,FEBRUARI
SULAWESI BARAT,MAJENE,PAMBOANG,BABABULO UTARA,75,70,51,21,0,0,0,8,4,10,12,20,4,0,4,0,41,9,32,5,12,11,1,6,15,10,5,5,FEBRUARI
SULAWESI BARAT,MAJENE,PAMBOANG,BUTTU PAMBOANG,69,10,1,1,1,0,0,1,0,0,0,1,4,4,0,2,10,5,5,4,5,0,5,0,1,0,1,0,FEBRUARI
SULAWESI BARAT,MAJENE,PAMBOANG,BANUA ADOLANG,99,19,6,3,3,2,2,4,0,0,5,1,12,12,0,11,19,18,1,1,14,6,8,5,11,7,4,7,FEBRUARI
SULAWESI BARAT,MAJENE,PAMBOANG,ADOLANG DHUA,33,69,37,3,2,1,0,14,12,3,26,8,6,0,6,0,38,13,25,5,0,0,0,0,42,18,24,26,FEBRUARI
SULAWESI BARAT,MAJENE,PAMBOANG,TINAMBUNG,32,12,9,5,5,3,1,3,0,0,7,1,2,1,1,1,12,11,1,5,11,11,0,0,13,1,12,13,FEBRUARI
SULAWESI BARAT,MAJENE,PAMBOANG,PESULOANG,72,38,5,1,0,0,0,2,0,2,3,2,12,4,8,4,15,9,6,8,11,2,9,1,32,1,31,25,FEBRUARI
SULAWESI BARAT,MAJENE,PAMBOANG,BALOMBONG,37,12,7,3,1,0,0,6,1,0,2,2,5,0,5,0,12,5,7,1,9,5,4,2,10,4,6,7,FEBRUARI
SULAWESI BARAT,MAJENE,SENDANA,MOSSO,93,55,9,1,0,0,0,3,6,0,1,8,14,9,5,6,13,13,0,9,11,11,0,7,23,10,13,9,FEBRUARI
SULAWESI BARAT,MAJENE,SENDANA,MOSSO DHUA,54,15,3,3,0,0,0,1,2,0,3,0,4,0,4,0,10,5,5,3,4,4,0,1,0,0,0,0,FEBRUARI
SULAWESI BARAT,MAJENE,SENDANA,TOTOLISI SENDANA,49,43,8,0,0,0,0,1,5,1,8,0,3,2,1,0,22,5,17,1,3,2,1,1,30,21,9,22,FEBRUARI
SULAWESI BARAT,MAJENE,SENDANA,TALLUBANUA,57,54,22,8,4,2,2,19,1,0,8,12,0,0,0,0,19,10,9,9,8,2,6,0,6,0,6,3,FEBRUARI
SULAWESI BARAT,MAJENE,SENDANA,LALATEDZONG,84,73,44,5,5,4,4,39,0,0,32,8,12,5,7,0,69,14,55,1,18,10,8,6,23,23,0,6,FEBRUARI
SULAWESI BARAT,MAJENE,SENDANA,BINANGA,63,61,27,13,6,6,1,21,2,1,26,1,7,5,2,4,42,25,17,7,41,21,20,11,17,6,11,14,FEBRUARI
SULAWESI BARAT,MAJENE,SENDANA,PUTTADA,82,51,30,28,12,11,11,14,2,1,26,3,15,3,12,1,34,9,25,2,2,1,1,1,7,6,1,5,FEBRUARI
SULAWESI BARAT,MAJENE,SENDANA,PAMINGGALAN,37,50,5,3,2,2,1,0,3,1,2,0,7,0,7,0,45,34,11,16,29,0,29,0,28,13,15,16,FEBRUARI
SULAWESI BARAT,MAJENE,SENDANA,LEPPANGANG,79,62,28,24,22,2,2,2,14,4,11,8,8,3,5,2,32,14,18,9,2,0,2,0,22,13,9,13,FEBRUARI
SULAWESI BARAT,MAJENE,SENDANA,PUNDAU,33,11,2,0,0,0,0,1,1,0,2,0,4,2,2,1,11,6,5,3,4,3,1,2,1,0,1,0,FEBRUARI
SULAWESI BARAT,MAJENE,SENDANA,SENDANA,38,60,6,6,4,3,2,3,0,1,0,5,2,1,1,0,27,10,17,6,22,6,16,3,54,50,4,3,FEBRUARI
SULAWESI BARAT,MAJENE,SENDANA,BANUA SENDANA,51,31,1,0,0,0,0,0,0,0,0,1,8,4,4,4,18,9,9,2,11,3,8,1,3,0,3,3,FEBRUARI
SULAWESI BARAT,MAJENE,SENDANA,TALLUBANUA UTARA,31,47,19,10,4,3,3,12,1,2,0,18,1,1,0,1,44,8,36,2,33,4,29,1,40,4,36,15,FEBRUARI
SULAWESI BARAT,MAJENE,SENDANA,LIMBORO RAMBU-RAMBU,47,54,9,9,4,2,0,0,8,0,9,0,3,3,0,3,33,11,22,7,2,0,2,0,36,17,19,31,FEBRUARI
SULAWESI BARAT,MAJENE,SENDANA,LIMBUA,48,22,7,1,0,0,0,2,2,1,1,2,3,1,2,1,14,6,8,2,12,5,7,2,4,3,1,1,FEBRUARI
SULAWESI BARAT,MAJENE,SENDANA,BUKIT SAMANG,53,34,31,7,4,4,2,28,0,0,29,1,7,3,4,1,21,19,2,0,19,9,10,9,16,6,10,4,FEBRUARI
SULAWESI BARAT,MAJENE,TAMMERODO SENDANA,SEPPONG,65,42,32,23,15,15,0,30,1,1,29,2,3,1,2,0,10,9,1,6,9,6,3,6,12,6,6,3,FEBRUARI
SULAWESI BARAT,MAJENE,TAMMERODO SENDANA,TAMMERODO,31,74,6,2,0,0,0,5,0,0,1,1,0,0,0,0,66,8,58,8,6,4,2,1,28,14,14,28,FEBRUARI
SULAWESI BARAT,MAJENE,TAMMERODO SENDANA,ULIDANG,43,49,43,27,20,11,10,5,5,14,25,4,2,0,2,0,34,24,10,8,34,10,24,8,42,17,25,10,FEBRUARI
SULAWESI BARAT,MAJENE,TAMMERODO SENDANA,TALLAMBALAO,61,78,3,3,0,0,0,2,0,0,3,0,6,1,5,1,71,51,20,16,41,7,34,2,90,12,78,20,FEBRUARI
SULAWESI BARAT,MAJENE,TAMMERODO SENDANA,TAMMERODO UTARA,92,23,19,7,2,2,0,3,6,9,4,11,13,4,9,1,22,6,16,4,1,1,0,1,7,3,4,6,FEBRUARI
SULAWESI BARAT,MAJENE,TAMMERODO SENDANA,MANYAMBA,75,47,47,32,4,2,0,26,11,3,23,18,0,0,0,0,21,11,10,8,17,8,9,4,38,32,6,36,FEBRUARI
SULAWESI BARAT,MAJENE,TAMMERODO SENDANA,AWO,68,48,37,30,26,10,4,24,0,0,14,4,11,10,1,6,20,7,13,3,17,13,4,4,17,3,14,1,FEBRUARI
SULAWESI BARAT,MAJENE,TUBO SENDANA,ONANG,86,47,26,3,2,2,0,18,0,7,6,6,1,1,0,0,12,6,6,2,8,1,7,0,20,2,18,20,FEBRUARI
SULAWESI BARAT,MAJENE,TUBO SENDANA,TUBO,56,73,62,33,23,23,23,6,24,6,44,10,0,0,0,0,23,6,17,5,13,7,6,3,50,38,12,11,FEBRUARI
SULAWESI BARAT,MAJENE,TUBO SENDANA,ONANG UTARA,65,68,11,1,0,0,0,8,3,0,9,1,10,8,2,5,13,11,2,6,7,2,5,1,38,19,19,1,FEBRUARI
SULAWESI BARAT,MAJENE,TUBO SENDANA,TUBO SELATAN,91,19,1,1,1,0,0,0,0,1,0,0,17,12,5,8,14,7,7,0,8,8,0,0,8,7,1,6,FEBRUARI
SULAWESI BARAT,MAJENE,TUBO SENDANA,BONDE BONDE,40,17,10,10,8,4,3,2,1,2,8,2,6,5,1,3,13,11,2,9,6,1,5,0,2,0,2,2,FEBRUARI
SULAWESI BARAT,MAJENE,TUBO SENDANA,TUBO TENGAH,74,65,38,26,10,2,2,19,7,5,15,0,10,4,6,3,16,12,4,10,3,3,0,1,43,34,9,16,FEBRUARI
SULAWESI BARAT,MAJENE,TUBO SENDANA,TUBO POANG,54,73,26,11,3,0,0,20,3,0,5,0,10,10,0,9,47,28,19,12,24,19,5,4,2,2,0,2,FEBRUARI
SULAWESI BARAT,MAJENE,ULUMANDA,KABIRAAN,76,40,20,10,4,3,2,14,1,0,9,3,5,5,0,1,12,6,6,6,6,4,2,4,32,28,4,17,FEBRUARI
SULAWESI BARAT,MAJENE,ULUMANDA,SAMBABO,94,11,2,2,0,0,0,1,0,0,2,0,7,5,2,3,11,9,2,8,7,0,7,0,3,0,3,2,FEBRUARI
SULAWESI BARAT,MAJENE,ULUMANDA,TANDEALLO,30,37,29,28,14,4,2,6,13,8,21,2,1,0,1,0,14,14,0,3,13,6,7,5,22,10,12,13,FEBRUARI
SULAWESI BARAT,MAJENE,ULUMANDA,ULUMANDA,96,72,37,33,4,1,1,23,9,4,26,9,16,12,4,0,11,11,0,8,10,3,7,1,1,1,0,0,FEBRUARI
SULAWESI BARAT,MAJENE,ULUMANDA,SALUTAMBUNG,80,76,14,10,2,2,0,12,1,1,0,11,11,11,0,8,65,29,36,27,36,27,9,11,74,32,42,63,FEBRUARI
SULAWESI BARAT,MAJENE,ULUMANDA,POPENGA,57,15,1,0,0,0,0,1,0,0,1,0,6,1,5,0,11,10,1,0,2,2,0,2,1,0,1,0,FEBRUARI
SULAWESI BARAT,MAJENE,ULUMANDA,SULAI,52,15,6,2,1,1,1,3,2,0,0,1,2,2,0,1,14,12,2,1,11,11,0,9,3,1,2,3,FEBRUARI
SULAWESI BARAT,MAJENE,ULUMANDA,PANGGALO,51,59,38,20,10,8,6,5,1,14,6,2,7,2,5,2,27,18,9,4,26,11,15,3,54,6,48,0,FEBRUARI
SULAWESI BARAT,MAMASA,ARALLE,ARALLE,30,75,71,54,52,23,19,46,5,1,35,7,2,1,1,1,72,52,20,35,10,1,9,1,42,25,17,1,FEBRUARI
SULAWESI BARAT,MAMASA,ARALLE,RALLE ANAK,86,20,20,0,0,0,0,7,0,9,15,5,1,1,0,1,10,5,5,2,6,0,6,0,16,13,3,5,FEBRUARI
SULAWESI BARAT,MAMASA,ARALLE,PANETEAN,52,25,20,4,4,0,0,15,0,5,3,15,2,1,1,0,16,12,4,9,14,8,6,8,9,6,3,4,FEBRUARI
SULAWESI BARAT,MAMASA,ARALLE,UHAILANU,30,67,28,22,7,7,3,13,0,9,20,8,4,0,4,0,61,22,39,14,48,45,3,35,38,34,4,16,FEBRUARI
SULAWESI BARAT,MAMASA,ARALLE,ARALLE UTARA,72,73,34,30,26,3,3,11,3,9,34,0,10,4,6,0,26,8,18,3,13,7,6,3,17,13,4,9,FEBRUARI
SULAWESI BARAT,MAMASA,ARALLE,UHAIDAHO,92,35,8,8,6,5,1,2,1,0,6,0,1,0,1,0,17,16,1,10,6,1,5,0,30,9,21,26,FEBRUARI
SULAWESI BARAT,MAMASA,ARALLE,BARURU,35,22,12,12,9,4,4,3,3,1,8,3,4,4,0,0,18,5,13,0,0,0,0,0,2,2,0,2,FEBRUARI
SULAWESI BARAT,MAMASA,ARALLE,RALLEANAK UTARA,36,37,5,3,2,0,0,0,3,2,2,0,7,6,1,4,31,30,1,4,14,5,9,3,25,5,20,11,FEBRUARI
SULAWESI BARAT,MAMASA,ARALLE,PAMOSEANG PANGGA,86,58,25,11,3,3,2,20,3,0,14,1,13,6,7,5,37,26,11,5,2,2,0,0,15,12,3,6,FEBRUARI
SULAWESI BARAT,MAMASA,ARALLE,KALABE,43,41,41,14,5,2,2,33,1,3,0,30,0,0,0,0,16,14,2,3,2,1,1,1,15,6,9,1,FEBRUARI
SULAWESI BARAT,MAMASA,ARALLE,ARALLE SELATAN,58,19,4,3,2,0,0,3,1,0,3,1,10,3,7,3,19,10,9,0,0,0,0,0,11,4,7,0,FEBRUARI
SULAWESI BARAT,MAMASA,ARALLE,HAHANGAN,85,67,12,10,4,4,0,9,3,0,12,0,15,2,13,1,13,13,0,12,0,0,0,0,41,9,32,14,FEBRUARI
SULAWESI BARAT,MAMASA,BALLA,BALLA,32,80,4,1,0,0,0,3,1,0,4,0,5,1,4,0,45,42,3,15,23,19,4,14,13,2,11,13,FEBRUARI
SULAWESI BARAT,MAMASA,BALLA,BALLA BARAT,85,64,26,6,3,1,1,4,11,5,10,12,1,0,1,0,38,16,22,5,29,16,13,3,34,26,8,22,FEBRUARI
SULAWESI BARAT,MAMASA,BALLA,BALLA SATANETEAN,57,70,33,22,19,16,13,3,2,12,30,2,6,6,0,1,35,33,2,30,8,0,8,0,32,4,28,1,FEBRUARI
SULAWESI BARAT,MAMASA,BALLA,BALLA TUMUKA,45,72,6,5,1,1,0,5,0,0,5,1,2,2,0,1,24,12,12,2,23,5,18,5,56,40,16,51,FEBRUARI
SULAWESI BARAT,MAMASA,BALLA,SEPAKUAN,36,22,15,2,0,0,0,1,14,0,9,4,4,2,2,2,11,9,2,6,4,4,0,4,4,3,1,2,FEBRUARI
SULAWESI BARAT,MAMASA,BALLA,PIDARA,50,60,32,26,20,20,10,19,2,0,17,14,1,1,0,1,20,13,7,12,17,0,17,0,21,12,9,3,FEBRUARI
SULAWESI BARAT,MAMASA,BALLA,BAMBAPUANG,88,21,16,9,4,3,2,3,6,5,1,5,13,13,0,13,16,11,5,0,12,9,3,9,21,16,5,10,FEBRUARI
SULAWESI BARAT,MAMASA,BALLA,BALLA TIMUR,41,38,14,10,0,0,0,9,1,0,5,9,1,0,1,0,12,9,3,2,4,0,4,0,30,25,5,18,FEBRUARI
SULAWESI BARAT,MAMASA,BAMBANG,MOKALLANG,55,78,31,19,17,13,10,19,0,0,31,0,10,3,7,2,69,51,18,39,10,1,9,0,30,15,15,29,FEBRUARI
SULAWESI BARAT,MAMASA,BAMBANG,MASOSO,79,80,48,12,10,7,2,46,0,0,44,1,0,0,0,0,74,55,19,45,41,12,29,1,93,70,23,37,FEBRUARI
SULAWESI BARAT,MAMASA,BAMBANG,SALUASSING,61,52,49,24,19,4,2,45,0,1,30,3,11,0,11,0,49,10,39,3,19,4,15,0,39,18,21,18,FEBRUARI
SULAWESI BARAT,MAMASA,BAMBANG,SALUBULO,75,44,30,10,8,6,5,0,1,8,4,14,9,2,7,0,31,13,18,6,3,2,1,0,9,5,4,2,FEBRUARI
SULAWESI BARAT,MAMASA,BAMBANG,SALUKADI,58,48,12,7,5,0,0,11,0,0,1,0,10,6,4,5,23,8,15,4,12,6,6,3,43,42,1,30,FEBRUARI
SULAWESI BARAT,MAMASA,BAMBANG,SALUKEPOPOK,59,45,21,1,0,0,0,4,13,1,7,4,4,0,4,0,35,18,17,8,28,15,13,6,11,0,11,2,FEBRUARI
SULAWESI BARAT,MAMASA,BAMBANG,ULUMAMBI BARAT,74,76,49,14,11,3,0,2,8,5,13,22,1,0,1,0,71,48,23,5,41,11,30,5,19,11,8,5,FEBRUARI
SULAWESI BARAT,MAMASA,BAMBANG,LIMBADEBATA,69,42,21,0,0,0,0,10,0,4,21,0,11,3,8,3,15,6,9,1,7,0,7,0,27,20,7,12,FEBRUARI
SULAWESI BARAT,MAMASA,BAMBANG,TANETE TOMBA,36,20,9,6,5,0,0,0,8,1,4,3,3,1,2,0,10,8,2,5,2,1,1,1,3,3,0,3,FEBRUARI
SULAWESI BARAT,MAMASA,BAMBANG,BAMBANG,91,61,25,19,19,16,1,13,1,5,15,9,5,0,5,0,60,41,19,14,39,38,1,23,49,15,34,31,FEBRUARI
SULAWESI BARAT,MAMASA,BAMBANG,RANTELEMO,47,75,57,20,19,15,0,22,28,6,3,22,8,4,4,1,66,50,16,5,28,0,28,0,26,25,1,19,FEBRUARI
SULAWESI BARAT,MAMASA,BAMBANG,SALUDENGEN,69,11,5,1,0,0,0,3,0,0,3,1,6,3,3,2,10,5,5,2,8,1,7,0,6,1,5,6,FEBRUARI
SULAWESI BARAT,MAMASA,BAMBANG,ULUMAMBI,66,18,16,10,5,2,2,5,2,2,15,1,1,1,0,0,16,8,8,6,9,0,9,0,18,8,10,9,FEBRUARI
SULAWESI BARAT,MAMASA,BAMBANG,BAMBANG TIMUR,83,70,44,36,17,17,15,15,11,1,31,11,8,8,0,5,31,15,16,6,20,2,18,0,14,7,7,8,FEBRUARI
SULAWESI BARAT,MAMASA,BAMBANG,MINANGA,77,73,40,37,31,12,8,20,3,4,30,0,6,0,6,0,20,9,11,4,16,4,12,3,53,42,11,44,FEBRUARI
SULAWESI BARAT,MAMASA,BAMBANG,SIKAMASE,54,63,32,12,0,0,0,10,2,17,29,2,9,2,7,0,51,51,0,35,1,1,0,1,9,2,7,9,FEBRUARI
SULAWESI BARAT,MAMASA,BAMBANG,RANTETARIMA,90,29,26,2,1,0,0,8,18,0,9,10,17,16,1,2,13,11,2,6,12,7,5,5,0,0,0,0,FEBRUARI
SULAWESI BARAT,MAMASA,BAMBANG,SALURURU,92,10,0,0,0,0,0,0,0,0,0,0,18,3,15,1,10,8,2,7,5,4,1,0,7,3,4,4,FEBRUARI
SULAWESI BARAT,MAMASA,BAMBANG,SALUTABANG,96,65,20,3,2,1,1,19,0,0,16,2,15,3,12,3,52,31,21,5,44,31,13,9,46,40,6,43,FEBRUARI
SULAWESI BARAT,MAMASA,BAMBANG,BALATANA,41,49,11,11,1,1,1,6,4,0,5,5,3,0,3,0,37,26,11,13,25,18,7,11,32,11,21,26,FEBRUARI
SULAWESI BARAT,MAMASA,BUNTUMALANGKA,BUNTUMALANGKA,59,10,3,0,0,0,0,0,2,0,3,0,9,9,0,3,10,7,3,2,3,3,0,0,6,2,4,4,FEBRUARI
SULAWESI BARAT,MAMASA,BUNTUMALANGKA,RANTEBERAN,48,50,16,9,8,5,1,1,8,4,12,1,2,2,0,1,23,20,3,15,17,0,17,0,27,16,11,3,FEBRUARI
SULAWESI BARAT,MAMASA,BUNTUMALANGKA,KEBANGA,47,69,36,31,15,0,0,7,21,1,7,2,0,0,0,0,42,8,34,7,35,32,3,14,35,9,26,4,FEBRUARI
SULAWESI BARAT,MAMASA,BUNTUMALANGKA,SALURINDU,74,59,42,2,2,2,0,7,20,10,33,7,7,0,7,0,40,29,11,27,28,28,0,25,50,14,36,48,FEBRUARI
SULAWESI BARAT,MAMASA,BUNTUMALANGKA,TAORA,72,19,0,0,0,0,0,0,0,0,0,0,4,1,3,1,10,5,5,4,8,0,8,0,20,9,11,17,FEBRUARI
SULAWESI BARAT,MAMASA,BUNTUMALANGKA,KABAE,44,80,47,47,37,3,2,37,8,0,8,7,2,2,0,1,31,17,14,16,29,0,29,0,24,21,3,22,FEBRUARI
SULAWESI BARAT,MAMASA,BUNTUMALANGKA,SALUTAMBUN BARAT,78,45,5,3,0,0,0,4,0,1,2,0,0,0,0,0,33,18,15,13,14,7,7,5,18,6,12,2,FEBRUARI
SULAWESI BARAT,MAMASA,BUNTUMALANGKA,PENATANGAN,90,56,26,15,13,10,0,6,5,4,14,10,10,4,6,4,55,31,24,25,22,8,14,0,2,2,0,0,FEBRUARI
SULAWESI BARAT,MAMASA,BUNTUMALANGKA,SALUTAMBUN TIMUR,98,13,1,1,0,0,0,0,0,1,1,0,12,7,5,4,11,10,1,1,5,4,1,3,14,4,10,11,FEBRUARI
SULAWESI BARAT,MAMASA,BUNTUMALANGKA,SALUTAMBUN,56,69,1,1,0,0,0,0,0,1,0,1,0,0,0,0,41,19,22,2,34,31,3,29,15,10,5,8,FEBRUARI
SULAWESI BARAT,MAMASA,BUNTUMALANGKA,ARALLE TIMUR,98,68,24,17,7,4,3,17,1,1,17,6,14,6,8,0,62,18,44,4,8,6,2,0,24,5,19,11,FEBRUARI
SULAWESI BARAT,MAMASA,MAMASA,MAMASA,53,75,69,40,22,21,20,33,15,0,44,3,8,0,8,0,54,15,39,11,10,3,7,2,31,28,3,3,FEBRUARI
SULAWESI BARAT,MAMASA,MAMASA,RAMBUSARATU,98,17,7,2,2,0,0,3,4,0,3,4,8,5,3,3,12,9,3,6,8,6,2,2,18,1,17,7,FEBRUARI
SULAWESI BARAT,MAMASA,MAMASA,OSANGO,60,76,47,28,13,6,6,1,21,13,42,5,10,4,6,4,44,17,27,4,33,15,18,5,17,12,5,0,FEBRUARI
SULAWESI BARAT,MAMASA,MAMASA,LAMBANAN,93,50,11,5,1,0,0,6,1,2,10,0,13,7,6,0,44,15,29,12,26,24,2,19,25,19,6,14,FEBRUARI
SULAWESI BARAT,MAMASA,MAMASA,LEMBANA SALULO,63,74,5,4,3,2,1,1,2,1,2,0,1,1,0,0,42,12,30,7,31,31,0,11,31,31,0,22,FEBRUARI
SULAWESI BARAT,MAMASA,MAMASA,TAUPE,64,20,4,1,1,1,0,3,0,1,2,0,4,4,0,2,14,12,2,0,9,6,3,5,19,14,5,8,FEBRUARI
SULAWESI BARAT,MAMASA,MAMASA,BUNTU BUDA,67,54,19,2,1,0,0,9,3,5,12,4,1,1,0,1,19,18,1,5,13,5,8,1,36,11,25,4,FEBRUARI
SULAWESI BARAT,MAMASA,MAMASA,TONDOK BAKARU,53,25,15,0,0,0,0,6,1,7,11,4,3,3,0,1,19,9,10,0,11,4,7,0,8,6,2,8,FEBRUARI
SULAWESI BARAT,MAMASA,MAMASA,PEBASSIAN,70,24,19,10,2,2,0,19,0,0,9,4,0,0,0,0,23,9,14,1,10,4,6,3,0,0,0,0,FEBRUARI
SULAWESI BARAT,MAMASA,MAMASA,MAMBULILING,95,20,14,14,1,0,0,1,10,0,4,10,8,4,4,2,18,16,2,16,12,11,1,4,26,17,9,11,FEBRUARI
SULAWESI BARAT,MAMASA,MAMASA,BOMBONG LAMBE,93,20,4,3,2,0,0,0,1,3,0,2,4,3,1,2,16,14,2,4,16,1,15,0,7,6,1,1,FEBRUARI
SULAWESI BARAT,MAMASA,MAMASA,BUBUN BATU,88,79,36,28,15,0,0,8,4,10,27,7,5,5,0,2,74,41,33,5,31,25,6,6,23,15,8,2,FEBRUARI
SULAWESI BARAT,MAMASA,MAMBI,MAMBI,34,23,16,13,4,0,0,1,13,2,15,1,4,2,2,1,16,9,7,1,16,0,16,0,18,4,14,6,FEBRUARI
SULAWESI BARAT,MAMASA,MAMBI,TALIPUKKI,60,59,13,11,7,6,3,1,2,7,8,2,4,2,2,0,38,34,4,2,5,3,2,2,13,8,5,0,FEBRUARI
SULAWESI BARAT,MAMASA,MAMBI,RANTEBULAHAN,55,25,23,1,1,0,0,1,18,3,20,3,9,1,8,0,18,13,5,9,6,3,3,3,4,3,1,0,FEBRUARI
SULAWESI BARAT,MAMASA,MAMBI,SONDONGLAYU,72,56,38,32,19,13,3,31,1,0,26,7,14,4,10,2,16,13,3,13,13,10,3,9,27,21,6,3,FEBRUARI
SULAWESI BARAT,MAMASA,MAMBI,SALUBANUA,98,55,53,24,1,0,0,52,1,0,25,1,0,0,0,0,25,22,3,6,0,0,0,0,17,14,3,6,FEBRUARI
SULAWESI BARAT,MAMASA,MAMBI,TAPALINA,50,58,58,48,48,9,8,0,22,27,48,6,10,2,8,1,18,8,10,6,6,2,4,1,28,5,23,3,FEBRUARI
SULAWESI BARAT,MAMASA,MAMBI,SENDANA,57,37,10,2,0,0,0,3,7,0,8,2,1,1,0,0,30,27,3,10,14,11,3,0,35,25,10,22,FEBRUARI
SULAWESI BARAT,MAMASA,MAMBI,PAMOSEAN,80,22,11,9,1,1,0,1,4,3,3,1,5,0,5,0,14,10,4,0,8,7,1,5,15,4,11,15,FEBRUARI
SULAWESI BARAT,MAMASA,MAMBI,SELUMAKA,58,10,10,9,9,1,1,1,8,0,4,4,7,2,5,2,10,5,5,4,8,0,8,0,0,0,0,0,FEBRUARI
SULAWESI BARAT,MAMASA,MAMBI,BUJUNG MANURUNG,89,61,7,3,0,0,0,6,0,0,3,1,17,11,6,3,14,13,1,0,0,0,0,0,40,17,23,11,FEBRUARI
SULAWESI BARAT,MAMASA,MAMBI,SALU ALO,31,11,8,4,0,0,0,2,1,4,2,1,3,3,0,0,11,7,4,0,3,0,3,0,2,1,1,1,FEBRUARI
SULAWESI BARAT,MAMASA,MAMBI,INDOBANUA,93,76,8,5,0,0,0,6,2,0,7,0,5,2,3,1,15,11,4,8,9,2,7,2,36,26,10,22,FEBRUARI
SULAWESI BARAT,MAMASA,MAMBI,SALUDURIAN,47,16,5,1,1,1,0,0,2,1,3,0,5,0,5,0,10,9,1,0,5,3,2,0,16,16,0,1,FEBRUARI
SULAWESI BARAT,MAMASA,MEHALAAN,MEHALAAN,77,45,22,21,10,1,1,5,1,4,2,18,8,5,3,4,26,6,20,0,26,12,14,5,56,35,21,7,FEBRUARI
SULAWESI BARAT,MAMASA,MEHALAAN,BOTTENG,82,61,17,5,5,5,0,4,10,3,11,5,7,6,1,0,49,10,39,10,41,11,30,11,12,12,0,6,FEBRUARI
SULAWESI BARAT,MAMASA,MEHALAAN,SALUKONTA,34,58,18,2,1,0,0,4,5,7,0,7,3,2,1,1,31,21,10,21,17,6,11,5,31,17,14,12,FEBRUARI
SULAWESI BARAT,MAMASA,MEHALAAN,MESAKADA,73,62,49,4,4,1,1,2,14,16,31,12,6,5,1,5,35,17,18,4,6,4,2,0,46,11,35,41,FEBRUARI
SULAWESI BARAT,MAMASA,MEHALAAN,MEHALAAN BARAT,43,11,4,2,2,2,1,2,0,1,0,2,2,2,0,2,11,11,0,8,8,1,7,1,2,0,2,2,FEBRUARI
SULAWESI BARAT,MAMASA,MEHALAAN,SALUAHOK,40,29,15,3,2,2,2,5,7,0,2,3,8,0,8,0,12,12,0,9,7,3,4,3,27,1,26,23,FEBRUARI
SULAWESI BARAT,MAMASA,MEHALAAN,SALUBALO,64,31,20,9,7,4,4,14,1,1,8,2,8,8,0,0,12,5,7,5,2,0,2,0,21,19,2,13,FEBRUARI
SULAWESI BARAT,MAMASA,MEHALAAN,PASSEMBUK,51,38,10,9,8,0,0,3,5,1,0,3,2,0,2,0,23,11,12,7,22,14,8,2,44,18,26,20,FEBRUARI
SULAWESI BARAT,MAMASA,MEHALAAN,KONDO,79,49,37,9,2,0,0,0,37,0,24,3,12,6,6,1,26,24,2,7,26,21,5,6,20,9,11,1,FEBRUARI
SULAWESI BARAT,MAMASA,MEHALAAN,LEKO SUKAMAJU,73,10,10,1,0,0,0,3,7,0,6,1,9,8,1,7,10,6,4,6,6,1,5,0,1,1,0,0,FEBRUARI
SULAWESI BARAT,MAMASA,MEHALAAN,ULUMEA,68,10,7,0,0,0,0,7,0,0,0,1,1,1,0,0,10,10,0,10,9,0,9,0,13,2,11,10,FEBRUARI
SULAWESI BARAT,MAMASA,MESSAWA,MESSAWA,37,56,42,19,19,12,7,9,14,6,6,22,1,1,0,0,46,29,17,4,24,9,15,4,6,3,3,3,FEBRUARI
SULAWESI BARAT,MAMASA,MESSAWA,RIPPUNG,100,14,12,5,2,2,1,10,1,0,11,0,8,6,2,4,14,13,1,7,2,0,2,0,1,1,0,0,FEBRUARI
SULAWESI BARAT,MAMASA,MESSAWA,MAKUANG,61,36,26,10,2,1,1,8,1,8,21,3,8,1,7,0,17,6,11,3,15,11,4,9,40,40,0,17,FEBRUARI
SULAWESI BARAT,MAMASA,MESSAWA,SEPANG,84,54,45,22,3,3,0,0,28,8,35,2,14,11,3,1,19,8,11,8,4,4,0,4,27,14,13,12,FEBRUARI
SULAWESI BARAT,MAMASA,MESSAWA,MALIMBONG,76,76,19,7,4,0,0,4,15,0,8,0,11,4,7,4,58,33,25,1,12,12,0,6,55,23,32,12,FEBRUARI
SULAWESI BARAT,MAMASA,MESSAWA,MATANDE,99,32,18,8,8,1,0,3,11,1,6,1,17,0,17,0,18,15,3,6,0,0,0,0,9,9,0,6,FEBRUARI
SULAWESI BARAT,MAMASA,MESSAWA,SIPAI,32,38,24,13,12,7,4,19,0,0,23,0,0,0,0,0,36,8,28,6,18,0,18,0,12,7,5,2,FEBRUARI
SULAWESI BARAT,MAMASA,MESSAWA,PASMA MAMBU,96,35,26,3,2,0,0,11,11,4,10,1,16,8,8,3,18,15,3,2,6,4,2,0,24,19,5,17,FEBRUARI
SULAWESI BARAT,MAMASA,MESSAWA,TANETE BATU,92,18,0,0,0,0,0,0,0,0,0,0,2,2,0,1,17,17,0,9,16,4,12,4,15,2,13,5,FEBRUARI
SULAWESI BARAT,MAMASA,NOSU,NOSU,98,71,26,14,10,8,6,8,12,0,0,15,13,11,2,11,35,27,8,7,32,7,25,4,23,8,15,6,FEBRUARI
SULAWESI BARAT,MAMASA,NOSU,MINANGA,79,11,0,0,0,0,0,0,0,0,0,0,1,0,1,0,10,9,1,6,7,0,7,0,6,2,4,3,FEBRUARI
SULAWESI BARAT,MAMASA,NOSU,BATUPAPAN,62,27,8,0,0,0,0,0,5,0,5,1,4,1,3,0,18,12,6,6,5,5,0,5,20,2,18,12,FEBRUARI
SULAWESI BARAT,MAMASA,NOSU,MASEWWE,83,23,15,14,2,1,1,6,5,3,7,2,6,1,5,1,13,5,8,0,9,3,6,1,3,3,0,3,FEBRUARI
SULAWESI BARAT,MAMASA,NOSU,SIWI,87,19,15,13,2,0,0,6,7,0,13,2,4,0,4,0,11,11,0,7,10,10,0,9,15,15,0,0,FEBRUARI
SULAWESI BARAT,MAMASA,NOSU,MINANGA TIMUR,42,49,36,23,6,0,0,20,2,8,17,16,7,3,4,2,34,7,27,5,15,5,10,5,37,24,13,29,FEBRUARI
SULAWESI BARAT,MAMASA,NOSU,PARINDING,92,40,9,5,0,0,0,8,0,1,9,0,14,13,1,12,37,26,11,24,24,4,20,3,9,6,3,5,FEBRUARI
SULAWESI BARAT,MAMASA,PANA,PANA,38,34,7,2,2,1,1,0,6,0,7,0,0,0,0,0,11,11,0,1,10,5,5,4,18,10,8,7,FEBRUARI
SULAWESI BARAT,MAMASA,PANA,MANIPI,96,71,2,0,0,0,0,1,1,0,2,0,15,9,6,4,69,19,50,13,23,18,5,6,61,29,32,3,FEBRUARI
SULAWESI BARAT,MAMASA,PANA,MAMULLU,88,24,6,2,1,0,0,3,2,1,1,0,6,1,5,0,12,5,7,4,1,0,1,0,17,4,13,15,FEBRUARI
SULAWESI BARAT,MAMASA,PANA,SAPAN,99,65,5,1,0,0,0,5,0,0,2,1,15,1,14,0,30,9,21,8,13,4,9,4,27,21,6,0,FEBRUARI
SULAWESI BARAT,MAMASA,PANA,DATUBARINGAN,97,71,54,18,5,4,0,10,3,20,44,4,3,0,3,0,34,14,20,13,15,8,7,0,58,47,11,37,FEBRUARI
SULAWESI BARAT,MAMASA,PANA,PANURA,84,54,36,6,6,1,1,16,7,1,28,4,2,0,2,0,14,6,8,0,4,1,3,0,24,4,20,17,FEBRUARI
SULAWESI BARAT,MAMASA,PANA,TALLANG BULAWAN,61,48,18,12,11,9,6,7,4,0,1,11,0,0,0,0,14,12,2,0,10,4,6,2,3,3,0,1,FEBRUARI
SULAWESI BARAT,MAMASA,PANA,KARAKA,49,80,80,50,46,34,20,15,29,12,40,8,5,1,4,0,17,9,8,2,4,1,3,1,13,8,5,13,FEBRUARI
SULAWESI BARAT,MAMASA,PANA,ULUSALU,52,38,18,18,4,3,0,5,0,11,2,2,1,1,0,0,13,6,7,3,11,5,6,3,3,3,0,1,FEBRUARI
SULAWESI BARAT,MAMASA,PANA,WERI,77,49,10,6,3,0,0,10,0,0,6,3,9,8,1,7,20,5,15,2,14,7,7,2,12,7,5,9,FEBRUARI
SULAWESI BARAT,MAMASA,PANA,SALUTAMBUN,61,10,0,0,0,0,0,0,0,0,0,0,6,5,1,4,10,9,1,0,8,1,7,1,5,5,0,5,FEBRUARI
SULAWESI BARAT,MAMASA,PANA,SALOAN,99,70,12,5,4,0,0,9,0,1,3,1,6,0,6,0,23,7,16,2,7,6,1,3,12,8,4,8,FEBRUARI
SULAWESI BARAT,MAMASA,PANA,ULUSALU INDAH,77,39,22,0,0,0,0,18,1,1,5,12,2,2,0,1,11,11,0,8,7,3,4,0,20,1,19,0,FEBRUARI
SULAWESI BARAT,MAMASA,RANTEBULAHAN TIMUR,SALUMOKANAN,79,17,14,1,0,0,0,3,4,1,3,1,11,2,9,1,14,8,6,6,13,3,10,0,23,12,11,10,FEBRUARI
SULAWESI BARAT,MAMASA,RANTEBULAHAN TIMUR,SALUMOKANAN BARAT,44,44,41,31,29,0,0,18,7,12,38,1,2,2,0,0,31,24,7,22,24,16,8,10,11,6,5,4,FEBRUARI
SULAWESI BARAT,MAMASA,RANTEBULAHAN TIMUR,BUANGIN,91,30,3,0,0,0,0,0,3,0,2,0,4,3,1,0,13,9,4,8,13,10,3,4,20,13,7,9,FEBRUARI
SULAWESI BARAT,MAMASA,RANTEBULAHAN TIMUR,BAMBANG BUDA,64,53,23,17,12,11,2,12,0,5,12,7,1,1,0,1,28,19,9,13,0,0,0,0,16,14,2,15,FEBRUARI
SULAWESI BARAT,MAMASA,RANTEBULAHAN TIMUR,LEKO,40,36,32,5,3,2,1,19,9,2,26,1,4,2,2,1,15,12,3,3,1,0,1,0,1,1,0,0,FEBRUARI
SULAWESI BARAT,MAMASA,RANTEBULAHAN TIMUR,KIRAK,77,48,41,7,1,1,1,17,3,19,20,15,9,6,3,2,33,6,27,2,10,6,4,5,42,20,22,41,FEBRUARI
SULAWESI BARAT,MAMASA,RANTEBULAHAN TIMUR,SALUMOKANAN UTARA,64,71,42,38,30,11,0,24,4,7,16,6,9,9,0,4,65,60,5,12,57,5,52,2,9,8,1,1,FEBRUARI
SULAWESI BARAT,MAMASA,RANTEBULAHAN TIMUR,SAMPALE,50,11,7,1,0,0,0,1,4,2,3,3,7,6,1,6,10,10,0,1,9,7,2,3,7,2,5,0,FEBRUARI
SULAWESI BARAT,MAMASA,SESENAPADANG,OROBUA,67,50,19,6,5,3,1,2,10,4,14,1,7,1,6,1,10,5,5,4,2,2,0,2,5,4,1,1,FEBRUARI
SULAWESI BARAT,MAMASA,SESENAPADANG,PALADAN,52,43,29,0,0,0,0,5,20,0,13,10,0,0,0,0,22,12,10,2,16,16,0,1,32,2,30,32,FEBRUARI
SULAWESI BARAT,MAMASA,SESENAPADANG,OROBUA TIMUR,40,42,20,12,3,2,0,16,1,0,17,3,3,2,1,2,22,15,7,2,15,11,4,4,39,13,26,37,FEBRUARI
SULAWESI BARAT,MAMASA,SESENAPADANG,RANTE PUANG,43,42,26,15,13,6,3,23,0,0,8,15,7,3,4,0,33,22,11,3,22,17,5,5,17,0,17,10,FEBRUARI
SULAWESI BARAT,MAMASA,SESENAPADANG,SATENETEAN,52,23,6,5,3,3,0,1,3,1,2,0,6,4,2,4,11,11,0,1,7,5,2,1,19,0,19,1,FEBRUARI
SULAWESI BARAT,MAMASA,SESENAPADANG,LISUAN ADA,64,46,45,43,16,16,14,30,1,0,45,0,11,3,8,1,38,13,25,5,3,2,1,0,21,7,14,7,FEBRUARI
SULAWESI BARAT,MAMASA,SESENAPADANG,OROBUA SELATAN,52,12,9,6,1,0,0,1,4,1,1,7,0,0,0,0,11,6,5,3,5,3,2,2,3,1,2,3,FEBRUARI
SULAWESI BARAT,MAMASA,SESENAPADANG,MALANGKENA PADANG,95,50,11,9,2,2,2,4,4,0,6,2,12,0,12,0,34,15,19,4,22,11,11,5,29,10,19,23,FEBRUARI
SULAWESI BARAT,MAMASA,SESENAPADANG,MALIMBONG,54,73,54,13,7,4,2,11,19,11,49,0,4,0,4,0,38,8,30,7,8,1,7,0,5,4,1,0,FEBRUARI
SULAWESI BARAT,MAMASA,SESENAPADANG,MARAMPAN OROBUA,63,42,8,0,0,0,0,2,2,3,3,5,2,0,2,0,10,7,3,3,6,2,4,1,19,14,5,13,FEBRUARI
SULAWESI BARAT,MAMASA,SUMARORONG,SUMARORONG,74,31,20,13,13,8,2,16,0,0,16,0,11,11,0,2,12,12,0,7,9,7,2,4,15,8,7,6,FEBRUARI
SULAWESI BARAT,MAMASA,SUMARORONG,TABONE,65,48,12,7,4,3,2,0,1,7,0,4,2,1,1,0,46,30,16,5,1,0,1,0,26,18,8,5,FEBRUARI
SULAWESI BARAT,MAMASA,SUMARORONG,BATANG URU,31,35,8,8,0,0,0,7,0,1,6,1,1,0,1,0,27,17,10,1,6,4,2,4,14,12,2,13,FEBRUARI
SULAWESI BARAT,MAMASA,SUMARORONG,SASAKAN,79,33,10,7,2,1,0,10,0,0,0,1,2,0,2,0,18,6,12,0,1,0,1,0,20,10,10,5,FEBRUARI
SULAWESI BARAT,MAMASA,SUMARORONG,TADISI,64,28,9,6,6,4,2,6,1,0,2,5,8,2,6,1,23,21,2,10,19,6,13,3,30,11,19,9,FEBRUARI
SULAWESI BARAT,MAMASA,SUMARORONG,SIBANAWA,87,10,1,1,1,1,1,0,0,0,0,0,16,10,6,10,10,10,0,3,5,1,4,1,12,4,8,1,FEBRUARI
SULAWESI BARAT,MAMASA,SUMARORONG,BATANGNGURU TIMUR,37,78,78,32,4,1,1,54,9,9,2,39,5,3,2,0,39,38,1,14,5,0,5,0,39,11,28,9,FEBRUARI
SULAWESI BARAT,MAMASA,SUMARORONG,SALUBALO,38,73,31,27,21,13,7,10,0,13,8,0,1,0,1,0,40,33,7,1,29,4,25,0,11,6,5,9,FEBRUARI
SULAWESI BARAT,MAMASA,SUMARORONG,BANEA,45,39,16,4,1,0,0,12,1,3,7,7,7,4,3,4,37,18,19,17,2,1,1,1,18,13,5,16,FEBRUARI
SULAWESI BARAT,MAMASA,SUMARORONG,RANTE KAMASE,30,28,21,4,4,0,0,11,10,0,16,3,1,1,0,0,13,12,1,1,7,6,1,6,8,4,4,2,FEBRUARI
SULAWESI BARAT,MAMASA,TABANG,TABANG,78,12,4,1,1,0,0,0,0,3,1,1,14,13,1,11,11,7,4,4,4,0,4,0,5,5,0,3,FEBRUARI
SULAWESI BARAT,MAMASA,TABANG,TADOKALUA,57,57,14,11,3,1,1,1,0,12,10,0,6,0,6,0,14,10,4,10,14,4,10,4,47,42,5,16,FEBRUARI
SULAWESI BARAT,MAMASA,TABANG,TABANG BARAT,86,74,36,2,0,0,0,8,20,3,1,5,13,3,10,3,26,25,1,15,8,6,2,4,19,0,19,14,FEBRUARI
SULAWESI BARAT,MAMASA,TABANG,MASUPU,36,19,10,8,0,0,0,7,3,0,5,3,0,0,0,0,17,14,3,13,14,8,6,2,11,10,1,6,FEBRUARI
SULAWESI BARAT,MAMASA,TABANG,KALAMA,59,15,7,1,1,0,0,2,3,0,3,2,8,8,0,5,15,7,8,7,3,2,1,2,2,2,0,0,FEBRUARI
SULAWESI BARAT,MAMASA,TABANG,BAKADISURA,48,44,20,20,0,0,0,20,0,0,7,6,0,0,0,0,21,14,7,3,1,1,0,0,27,23,4,17,FEBRUARI
SULAWESI BARAT,MAMASA,TABANG,SALUKONA,42,18,16,6,4,1,1,9,6,0,1,7,1,1,0,1,16,15,1,4,7,0,7,0,8,4,4,2,FEBRUARI
SULAWESI BARAT,MAMASA,TABULAHAN,LAKAHANG,69,31,5,5,1,1,0,2,0,1,0,3,11,11,0,1,25,18,7,9,13,2,11,1,7,1,6,7,FEBRUARI
SULAWESI BARAT,MAMASA,TABULAHAN,PERIANGAN,45,46,17,6,0,0,0,17,0,0,16,0,0,0,0,0,10,6,4,0,3,0,3,0,35,25,10,9,FEBRUARI
SULAWESI BARAT,MAMASA,TABULAHAN,MALATIRO,59,75,4,1,1,1,0,4,0,0,1,1,4,0,4,0,18,14,4,0,17,13,4,0,29,4,25,21,FEBRUARI
SULAWESI BARAT,MAMASA,TABULAHAN,TABULAHAN,33,24,0,0,0,0,0,0,0,0,0,0,5,2,3,0,23,13,10,9,22,5,17,3,25,0,25,14,FEBRUARI
SULAWESI BARAT,MAMASA,TABULAHAN,SALULEANG,60,67,17,11,10,4,2,7,6,1,14,2,6,3,3,1,18,5,13,5,8,2,6,2,8,7,1,4,FEBRUARI
SULAWESI BARAT,MAMASA,TABULAHAN,TAMPAK KURRA,31,75,19,13,4,1,0,13,1,2,9,3,5,1,4,1,19,19,0,6,18,12,6,9,1,1,0,1,FEBRUARI
SULAWESI BARAT,MAMASA,TABULAHAN,GANDANG DEWATA,63,30,18,11,1,1,0,11,3,0,9,3,5,1,4,1,22,19,3,12,2,1,1,1,14,8,6,9,FEBRUARI
SULAWESI BARAT,MAMASA,TABULAHAN,BURANA,91,14,12,1,1,0,0,11,1,0,0,6,18,10,8,1,11,11,0,10,7,3,4,1,9,8,1,1,FEBRUARI
SULAWESI BARAT,MAMASA,TABULAHAN,SALUBAKKA,56,16,10,1,1,1,0,3,1,2,6,4,1,1,0,0,12,12,0,5,3,2,1,0,5,5,0,4,FEBRUARI
SULAWESI BARAT,MAMASA,TABULAHAN,PANGANDARAN,93,45,27,11,6,0,0,23,2,0,27,0,17,11,6,8,19,19,0,10,5,5,0,4,24,17,7,1,FEBRUARI
SULAWESI BARAT,MAMASA,TABULAHAN,TALOPAK,46,78,53,51,50,11,10,29,2,10,21,13,9,3,6,3,47,44,3,40,29,10,19,8,77,41,36,34,FEBRUARI
SULAWESI BARAT,MAMASA,TABULAHAN,PEU',53,74,40,20,17,13,5,32,3,0,8,6,0,0,0,0,38,26,12,18,34,27,7,25,16,13,3,4,FEBRUARI
SULAWESI BARAT,MAMASA,TABULAHAN,TIMORO,59,16,9,9,3,3,2,6,1,0,3,0,6,4,2,3,12,9,3,1,3,0,3,0,4,2,2,0,FEBRUARI
SULAWESI BARAT,MAMASA,TABULAHAN,LAKAHANG UTAMA,85,67,11,0,0,0,0,9,1,1,5,3,5,1,4,1,18,18,0,7,10,4,6,0,27,26,1,4,FEBRUARI
SULAWESI BARAT,MAMASA,TANDUK KALUA,MINAKE,34,12,2,0,0,0,0,2,0,0,1,0,0,0,0,0,11,8,3,6,5,4,1,3,8,7,1,1,FEBRUARI
SULAWESI BARAT,MAMASA,TANDUK KALUA,MALABO,59,32,20,6,6,3,1,11,1,1,7,10,6,2,4,1,25,5,20,4,10,9,1,4,3,0,3,0,FEBRUARI
SULAWESI BARAT,MAMASA,TANDUK KALUA,SINDAGAMANIK,73,67,27,23,20,12,10,8,0,4,22,2,0,0,0,0,31,20,11,7,6,6,0,3,39,13,26,16,FEBRUARI
SULAWESI BARAT,MAMASA,TANDUK KALUA,PARONDOBULAWAN,54,60,30,0,0,0,0,24,1,5,3,8,6,5,1,0,23,10,13,7,2,2,0,1,12,8,4,11,FEBRUARI
SULAWESI BARAT,MAMASA,TANDUK KALUA,TAMALANTIK,44,23,22,7,2,0,0,19,3,0,7,9,0,0,0,0,12,11,1,9,6,1,5,0,10,7,3,2,FEBRUARI
SULAWESI BARAT,MAMASA,TANDUK KALUA,MANNABABA,58,52,50,48,9,3,3,9,0,7,8,18,0,0,0,0,19,7,12,4,11,3,8,1,32,7,25,31,FEBRUARI
SULAWESI BARAT,MAMASA,TANDUK KALUA,MESAKADA,91,57,17,11,7,4,0,8,6,3,6,5,9,5,4,4,31,16,15,2,7,1,6,1,8,2,6,5,FEBRUARI
SULAWESI BARAT,MAMASA,TANDUK KALUA,BALLABATU,84,78,45,15,11,8,6,19,0,6,28,6,3,0,3,0,58,56,2,53,5,4,1,2,26,19,7,6,FEBRUARI
SULAWESI BARAT,MAMASA,TANDUK KALUA,PAMBE,36,41,16,0,0,0,0,6,1,4,13,1,7,7,0,1,29,7,22,7,17,12,5,4,20,13,7,16,FEBRUARI
SULAWESI BARAT,MAMASA,TANDUK KALUA,SALURANO,82,19,4,2,2,0,0,1,0,3,0,1,2,1,1,0,18,5,13,0,17,9,8,0,15,10,5,1,FEBRUARI
SULAWESI BARAT,MAMASA,TANDUK KALUA,TALIMBUNG,79,43,42,19,6,4,0,17,16,9,6,23,7,3,4,0,39,31,8,11,27,21,6,13,41,41,0,22,FEBRUARI
SULAWESI BARAT,MAMASA,TANDUK KALUA,KANAN,90,28,8,6,4,3,3,0,4,0,7,1,10,7,3,3,28,25,3,21,10,7,3,4,10,5,5,10,FEBRUARI
SULAWESI BARAT,MAMASA,TAWALIAN,TAWALIAN,46,55,13,1,1,1,1,6,4,1,0,11,9,5,4,1,38,27,11,5,38,12,26,7,20,15,5,10,FEBRUARI
SULAWESI BARAT,MAMASA,TAWALIAN,TAWALIAN TIMUR,36,57,56,7,3,3,3,29,15,3,27,24,7,1,6,1,43,37,6,32,19,0,19,0,18,5,13,3,FEBRUARI
SULAWESI BARAT,MAMASA,TAWALIAN,KARIANGO,64,64,49,14,0,0,0,22,4,2,6,9,11,1,10,1,47,33,14,9,0,0,0,0,32,19,13,28,FEBRUARI
SULAWESI BARAT,MAMASA,TAWALIAN,RANTETANGNGA,45,23,1,1,1,0,0,1,0,0,0,0,7,5,2,5,15,9,6,4,8,7,1,3,24,3,21,9,FEBRUARI
SULAWESI BARAT,POLEWALI MANDAR,ALLU,PETOOSANG,72,60,19,1,1,0,0,16,0,3,8,11,14,5,9,2,55,45,10,44,6,6,0,5,6,0,6,1,FEBRUARI
SULAWESI BARAT,POLEWALI MANDAR,ALLU,MOMBI,85,12,7,3,3,1,1,2,1,1,1,6,15,13,2,7,10,7,3,4,7,4,3,0,9,7,2,7,FEBRUARI
SULAWESI BARAT,POLEWALI MANDAR,ALLU,KALUMAMMANG,85,39,17,3,2,2,1,5,0,3,16,1,10,6,4,6,31,5,26,5,27,16,11,6,7,2,5,5,FEBRUARI
SULAWESI BARAT,POLEWALI MANDAR,ALLU,PAO-PAO,74,51,31,6,1,1,0,7,17,6,21,7,3,2,1,1,20,11,9,2,4,0,4,0,33,12,21,11,FEBRUARI
SULAWESI BARAT,POLEWALI MANDAR,ALLU,PUPPU URING,45,68,54,0,0,0,0,19,26,1,8,34,8,7,1,0,19,6,13,1,1,0,1,0,2,2,0,0,FEBRUARI
SULAWESI BARAT,POLEWALI MANDAR,ALLU,SARAGIAN,57,68,12,3,1,0,0,12,0,0,3,0,3,2,1,1,44,18,26,7,39,20,19,11,35,26,9,5,FEBRUARI
SULAWESI BARAT,POLEWALI MANDAR,ALLU,SAYOANG,57,34,3,3,3,1,1,1,1,0,3,0,0,0,0,0,29,6,23,5,7,6,1,1,29,0,29,13,FEBRUARI
SULAWESI BARAT,POLEWALI MANDAR,ALLU,ALU,83,18,5,0,0,0,0,2,0,3,4,0,3,0,3,0,17,10,7,1,3,1,2,0,9,3,6,7,FEBRUARI
SULAWESI BARAT,POLEWALI MANDAR,ANREAPI,ANREAPI,62,64,4,2,0,0,0,0,0,0,2,0,0,0,0,0,18,15,3,14,12,5,7,0,55,31,24,22,FEBRUARI
SULAWESI BARAT,POLEWALI MANDAR,ANREAPI,DUAMPANUA,97,59,44,1,1,0,0,27,16,0,44,0,18,11,7,7,31,11,20,11,5,0,5,0,19,6,13,14,FEBRUARI
SULAWESI BARAT,POLEWALI MANDAR,ANREAPI,KELAPA DUA,50,14,3,1,1,0,0,0,3,0,3,0,9,4,5,0,12,10,2,9,3,0,3,0,12,9,3,7,FEBRUARI
SULAWESI BARAT,POLEWALI MANDAR,ANREAPI,PAPPANDANGAN,82,80,23,5,5,1,1,11,10,0,19,2,14,1,13,0,40,25,15,1,38,2,36,1,4,0,4,3,FEBRUARI
SULAWESI BARAT,POLEWALI MANDAR,ANREAPI,KUNYI,77,42,4,4,1,1,0,3,0,1,0,4,13,1,12,0,38,31,7,26,19,6,13,3,15,3,12,0,FEBRUARI
SULAWESI BARAT,POLEWALI MANDAR,BALANIPA,BALANIPA,62,50,45,25,20,20,2,30,11,1,29,4,6,5,1,1,33,11,22,4,19,1,18,1,42,41,1,37,FEBRUARI
SULAWESI BARAT,POLEWALI MANDAR,BALANIPA,TAMMAJARRA,79,27,22,10,0,0,0,9,0,0,7,0,6,4,2,1,21,7,14,6,14,9,5,1,19,3,16,12,FEBRUARI
SULAWESI BARAT,POLEWALI MANDAR,BALANIPA,TAMANGGALLE,35,65,52,19,12,8,1,49,1,1,51,0,2,2,0,2,65,16,49,13,51,2,49,2,67,56,11,22,FEBRUARI
SULAWESI BARAT,POLEWALI MANDAR,BALANIPA,MOSSO,71,66,19,15,14,7,7,3,1,7,2,11,13,12,1,5,13,11,2,10,6,6,0,5,24,16,8,7,FEBRUARI
SULAWESI BARAT,POLEWALI MANDAR,BALANIPA,GALUNG TULUK,89,59,49,49,26,11,9,13,19,3,41,8,7,4,3,4,15,12,3,0,1,1,0,0,9,4,5,2,FEBRUARI
SULAWESI BARAT,POLEWALI MANDAR,BALANIPA,SABANG SUBIK,64,63,45,17,10,10,3,21,5,6,18,12,10,9,1,3,32,20,12,6,24,15,9,8,36,0,36,12,FEBRUARI
SULAWESI BARAT,POLEWALI MANDAR,BALANIPA,PAMBUSUANG,92,10,0,0,0,0,0,0,0,0,0,0,2,2,0,0,10,9,1,6,1,0,1,0,7,3,4,5,FEBRUARI
SULAWESI BARAT,POLEWALI MANDAR,BALANIPA,BALA,84,28,13,4,3,1,0,2,6,2,9,2,0,0,0,0,21,16,5,7,9,6,3,4,23,13,10,18,FEBRUARI
SULAWESI BARAT,POLEWALI MANDAR,BALANIPA,LAMBANAN,82,35,2,0,0,0,0,1,0,1,0,2,11,7,4,1,22,10,12,7,3,1,2,0,1,0,1,1,FEBRUARI
SULAWESI BARAT,POLEWALI MANDAR,BALANIPA,LEGO,85,43,20,18,15,6,6,11,0,1,15,1,15,13,2,4,19,12,7,4,19,8,11,3,17,13,4,0,FEBRUARI
SULAWESI BARAT,POLEWALI MANDAR,BALANIPA,PALLIS,36,43,8,2,2,2,1,0,2,3,2,3,1,0,1,0,43,39,4,10,42,40,2,29,30,22,8,29,FEBRUARI
SULAWESI BARAT,POLEWALI MANDAR,BINUANG,AMASSANGAN,57,76,46,3,2,2,1,39,6,0,20,13,4,2,2,1,42,20,22,17,25,2,23,2,33,31,2,17,FEBRUARI
SULAWESI BARAT,POLEWALI MANDAR,BINUANG,TONYAMAN,90,36,30,27,27,22,8,14,6,1,1,27,18,9,9,0,36,21,15,11,20,18,2,11,12,6,6,12,FEBRUARI
SULAWESI BARAT,POLEWALI MANDAR,BINUANG,KUAJANG,49,24,4,0,0,0,0,1,2,1,0,2,7,7,0,2,22,7,15,6,8,6,2,2,23,20,3,15,FEBRUARI
SULAWESI BARAT,POLEWALI MANDAR,BINUANG,PAKU,40,23,12,11,7,7,7,5,0,0,5,2,6,5,1,0,18,15,3,13,14,14,0,11,5,3,2,1,FEBRUARI
SULAWESI BARAT,POLEWALI MANDAR,BINUANG,MIRRING,55,41,10,0,0,0,0,5,4,1,1,9,5,4,1,3,15,10,5,2,6,1,5,1,6,2,4,1,FEBRUARI
SULAWESI BARAT,POLEWALI MANDAR,BINUANG,BATETANGNGA,36,78,69,15,2,2,0,5,10,0,17,29,2,2,0,0,68,52,16,39,64,16,48,14,116,30,86,104,FEBRUARI
SULAWESI BARAT,POLEWALI MANDAR,BINUANG,MAMMI,54,18,3,2,0,0,0,1,1,0,3,0,0,0,0,0,10,9,1,8,8,4,4,2,15,15,0,9,FEBRUARI
SULAWESI BARAT,POLEWALI MANDAR,BINUANG,KALEOK,30,67,51,51,24,5,2,29,6,4,49,2,2,1,1,1,31,7,24,2,31,6,25,2,47,12,35,34,FEBRUARI
SULAWESI BARAT,POLEWALI MANDAR,BINUANG,AMOLA,87,48,3,1,0,0,0,3,0,0,0,0,11,5,6,3,33,28,5,6,28,26,2,18,56,50,6,11,FEBRUARI
SULAWESI BARAT,POLEWALI MANDAR,BINUANG,REA,68,20,11,1,0,0,0,2,0,2,7,2,7,1,6,0,18,14,4,2,7,3,4,1,9,2,7,9,FEBRUARI
SULAWESI BARAT,POLEWALI MANDAR,BULO,BULO,90,50,31,1,0,0,0,12,17,2,26,0,6,5,1,2,33,32,1,20,8,0,8,0,35,16,19,23,FEBRUARI
SULAWESI BARAT,POLEWALI MANDAR,BULO,PULLIWA,60,76,52,16,16,1,0,43,8,0,10,13,9,3,6,2,32,28,4,21,12,12,0,0,32,8,24,0,FEBRUARI
SULAWESI BARAT,POLEWALI MANDAR,BULO,PATAMBANUA,80,62,43,23,23,3,1,26,16,0,16,6,6,2,4,0,40,10,30,5,19,19,0,15,4,0,4,3,FEBRUARI
SULAWESI BARAT,POLEWALI MANDAR,BULO,KAROMBANG,59,44,19,14,4,4,0,1,14,0,17,0,10,6,4,2,13,5,8,1,8,2,6,1,8,0,8,0,FEBRUARI
SULAWESI BARAT,POLEWALI MANDAR,BULO,DAALA TIMUR,36,26,3,0,0,0,0,1,2,0,3,0,3,0,3,0,24,23,1,1,13,1,12,1,20,15,5,10,FEBRUARI
SULAWESI BARAT,POLEWALI MANDAR,BULO,LENGGO,32,61,14,10,1,1,0,0,2,12,2,10,1,1,0,1,16,8,8,1,14,5,9,1,38,17,21,36,FEBRUARI
SULAWESI BARAT,POLEWALI MANDAR,BULO,SABURA,46,24,22,2,0,0,0,18,3,0,6,13,2,0,2,0,24,19,5,4,7,2,5,1,8,4,4,0,FEBRUARI
SULAWESI BARAT,POLEWALI MANDAR,BULO,SEPPORRAKI,59,20,4,4,4,1,0,1,0,3,4,0,5,5,0,3,20,17,3,6,2,2,0,0,15,9,6,14,FEBRUARI
SULAWESI BARAT,POLEWALI MANDAR,BULO,IHING,95,49,40,35,7,4,4,14,16,2,31,0,1,0,1,0,21,17,4,9,9,7,2,5,21,2,19,21,FEBRUARI
SULAWESI BARAT,POLEWALI MANDAR,CAMPALAGIAN,PAPPANG,53,55,7,0,0,0,0,6,1,0,0,5,10,8,2,1,28,6,22,2,26,0,26,0,17,15,2,6,FEBRUARI
SULAWESI BARAT,POLEWALI MANDAR,CAMPALAGIAN,LALIKO,57,74,12,12,7,2,2,4,1,0,12,0,6,6,0,0,56,29,27,17,33,5,28,2,59,49,10,49,FEBRUARI
SULAWESI BARAT,POLEWALI MANDAR,CAMPALAGIAN,BONDE,53,80,30,8,1,0,0,24,1,4,12,6,5,4,1,2,28,28,0,26,1,0,1,0,11,3,8,7,FEBRUARI
SULAWESI BARAT,POLEWALI MANDAR,CAMPALAGIAN,KATUMBANGAN LEMO,78,70,22,19,0,0,0,1,12,3,22,0,0,0,0,0,43,26,17,2,3,1,2,1,25,22,3,2,FEBRUARI
SULAWESI BARAT,POLEWALI MANDAR,CAMPALAGIAN,PANYAMPA,74,58,39,0,0,0,0,30,6,1,29,6,14,4,10,4,38,6,32,3,3,0,3,0,35,12,23,10,FEBRUARI
SULAWESI BARAT,POLEWALI MANDAR,CAMPALAGIAN,SURUANG,36,33,11,9,8,5,3,8,0,0,4,3,5,5,0,2,28,24,4,11,23,20,3,6,42,8,34,33,FEBRUARI
SULAWESI BARAT,POLEWALI MANDAR,CAMPALAGIAN,LAMPOKO,74,76,3,0,0,0,0,2,1,0,2,0,10,6,4,0,49,15,34,14,38,2,36,0,48,45,3,41,FEBRUARI
SULAWESI BARAT,POLEWALI MANDAR,CAMPALAGIAN,KATUMBANGAN,67,64,64,63,16,14,1,48,13,1,17,31,9,7,2,2,14,7,7,2,13,4,9,2,52,25,27,35,FEBRUARI
SULAWESI BARAT,POLEWALI MANDAR,CAMPALAGIAN,LAPEO,58,16,8,2,2,2,0,1,0,4,7,0,0,0,0,0,13,9,4,4,6,2,4,0,11,5,6,10,FEBRUARI
SULAWESI BARAT,POLEWALI MANDAR,CAMPALAGIAN,PARAPPE,36,13,3,3,0,0,0,3,0,0,3,0,5,3,2,2,13,5,8,5,4,3,1,2,4,2,2,3,FEBRUARI
SULAWESI BARAT,POLEWALI MANDAR,CAMPALAGIAN,ONGKO,84,61,46,28,22,8,1,14,17,9,10,17,9,2,7,1,49,8,41,1,8,2,6,1,1,1,0,1,FEBRUARI
SULAWESI BARAT,POLEWALI MANDAR,CAMPALAGIAN,KENJE,70,13,1,0,0,0,0,0,0,0,1,0,11,10,1,6,13,10,3,5,12,8,4,4,19,8,11,4,FEBRUARI
SULAWESI BARAT,POLEWALI MANDAR,CAMPALAGIAN,SUMARRANG,58,30,14,12,9,4,4,8,0,1,8,5,1,1,0,1,24,21,3,16,0,0,0,0,12,3,9,0,FEBRUARI
SULAWESI BARAT,POLEWALI MANDAR,CAMPALAGIAN,BOTTO,38,19,0,0,0,0,0,0,0,0,0,0,7,2,5,2,14,7,7,4,10,5,5,2,9,8,1,4,FEBRUARI
SULAWESI BARAT,POLEWALI MANDAR,CAMPALAGIAN,GATTUNGAN,36,57,0,0,0,0,0,0,0,0,0,0,3,3,0,1,32,12,20,1,19,6,13,0,55,7,48,48,FEBRUARI
SULAWESI BARAT,POLEWALI MANDAR,CAMPALAGIAN,PADANG TIMUR,83,29,29,10,10,1,1,6,10,2,27,0,16,3,13,1,15,7,8,7,2,1,1,1,19,15,4,14,FEBRUARI
SULAWESI BARAT,POLEWALI MANDAR,CAMPALAGIAN,PADANG,46,80,54,2,2,1,0,44,9,0,13,29,9,9,0,1,19,10,9,2,7,4,3,2,5,3,2,3,FEBRUARI
SULAWESI BARAT,POLEWALI MANDAR,CAMPALAGIAN,LAGI-AGI,67,40,7,7,0,0,0,5,2,0,6,0,0,0,0,0,17,7,10,3,8,1,7,1,7,2,5,5,FEBRUARI
SULAWESI BARAT,POLEWALI MANDAR,LIMBORO,LIMBORO,75,32,17,6,2,1,1,0,9,5,1,11,10,5,5,3,24,16,8,15,23,21,2,10,32,7,25,13,FEBRUARI
SULAWESI BARAT,POLEWALI MANDAR,LIMBORO,LEMBANG LEMBANG,57,41,27,20,7,7,5,3,9,3,10,13,6,4,2,0,21,10,11,5,6,0,6,0,27,4,23,21,FEBRUARI
SULAWESI BARAT,POLEWALI MANDAR,LIMBORO,TANDASURA,52,29,22,11,5,5,0,10,1,7,19,1,3,0,3,0,26,11,15,8,13,13,0,7,22,5,17,5,FEBRUARI
SULAWESI BARAT,POLEWALI MANDAR,LIMBORO,SAMASUNDU,59,34,4,4,1,0,0,4,0,0,2,0,1,0,1,0,22,20,2,18,19,17,2,12,5,3,2,5,FEBRUARI
SULAWESI BARAT,POLEWALI MANDAR,LIMBORO,NAPO,63,19,18,0,0,0,0,6,5,0,4,5,11,10,1,0,15,8,7,2,7,1,6,1,10,5,5,6,FEBRUARI
SULAWESI BARAT,POLEWALI MANDAR,LIMBORO,TODANG TODANG,86,33,19,12,3,2,0,9,1,0,8,11,13,6,7,4,22,22,0,22,14,4,10,2,6,3,3,0,FEBRUARI
SULAWESI BARAT,POLEWALI MANDAR,LIMBORO,PENDULANGAN,94,12,0,0,0,0,0,0,0,0,0,0,15,1,14,1,11,9,2,0,8,8,0,7,6,1,5,5,FEBRUARI
SULAWESI BARAT,POLEWALI MANDAR,LIMBORO,RENGGEANG,89,34,4,4,2,2,1,2,1,0,3,1,5,0,5,0,31,28,3,25,13,8,5,5,35,21,14,19,FEBRUARI
SULAWESI BARAT,POLEWALI MANDAR,LIMBORO,SALARRI,91,41,2,0,0,0,0,0,0,1,0,2,13,5,8,1,13,11,2,3,2,2,0,2,28,14,14,26,FEBRUARI
SULAWESI BARAT,POLEWALI MANDAR,LIMBORO,TANGAN BARU,59,66,47,26,6,4,2,3,7,18,18,29,8,5,3,5,21,8,13,8,3,2,1,0,12,12,0,11,FEBRUARI
SULAWESI BARAT,POLEWALI MANDAR,LIMBORO,PALECE,63,31,5,1,0,0,0,0,0,4,1,3,1,0,1,0,18,16,2,10,14,10,4,5,1,0,1,0,FEBRUARI
SULAWESI BARAT,POLEWALI MANDAR,LUYO,BATUPANGA,82,74,66,10,6,4,3,44,8,9,54,8,8,8,0,1,27,14,13,14,17,10,7,0,15,3,12,3,FEBRUARI
SULAWESI BARAT,POLEWALI MANDAR,LUYO,MAMBU,61,29,12,3,2,2,2,3,5,0,0,6,3,2,1,2,23,10,13,4,20,19,1,8,8,1,7,8,FEBRUARI
SULAWESI BARAT,POLEWALI MANDAR,LUYO,TENGGELANG,41,31,13,1,1,0,0,8,3,1,3,9,7,6,1,3,18,16,2,4,14,13,1,5,21,19,2,11,FEBRUARI
SULAWESI BARAT,POLEWALI MANDAR,LUYO,BARU,63,72,58,48,30,15,1,57,0,0,48,7,11,9,2,4,19,10,9,4,18,10,8,6,49,14,35,28,FEBRUARI
SULAWESI BARAT,POLEWALI MANDAR,LUYO,PUSSUI,83,30,29,28,14,0,0,3,18,2,18,10,7,2,5,0,12,11,1,3,9,7,2,6,16,4,12,13,FEBRUARI
SULAWESI BARAT,POLEWALI MANDAR,LUYO,MAPILI BARAT,63,19,15,5,2,0,0,5,9,1,6,1,10,3,7,2,16,7,9,6,13,12,1,12,1,0,1,0,FEBRUARI
SULAWESI BARAT,POLEWALI MANDAR,LUYO,SAMBALI WALI,36,55,3,3,2,0,0,0,0,2,2,1,1,1,0,0,23,5,18,0,17,1,16,0,18,13,5,7,FEBRUARI
SULAWESI BARAT,POLEWALI MANDAR,LUYO,BATUPANGA DAALA,93,31,6,4,1,0,0,4,2,0,3,2,8,6,2,6,25,19,6,6,17,15,2,11,8,3,5,5,FEBRUARI
SULAWESI BARAT,POLEWALI MANDAR,LUYO,LUYO,95,36,9,7,6,4,2,2,0,1,7,2,6,0,6,0,16,7,9,6,11,5,6,0,19,9,10,0,FEBRUARI
SULAWESI BARAT,POLEWALI MANDAR,LUYO,PUSSUI BARAT,35,27,21,17,9,1,1,1,15,3,16,3,6,2,4,1,17,11,6,1,12,1,11,0,12,0,12,0,FEBRUARI
SULAWESI BARAT,POLEWALI MANDAR,LUYO,PUCCADI,41,54,5,1,1,1,1,0,1,3,0,3,0,0,0,0,14,5,9,5,8,2,6,0,20,20,0,18,FEBRUARI
SULAWESI BARAT,POLEWALI MANDAR,MAPILLI,MAPILI,77,13,1,1,1,1,1,0,0,0,1,0,5,0,5,0,13,13,0,3,0,0,0,0,8,4,4,8,FEBRUARI
SULAWESI BARAT,POLEWALI MANDAR,MAPILLI,UGIBARU,91,58,51,4,1,0,0,28,5,18,25,13,6,5,1,0,55,5,50,4,38,9,29,4,16,6,10,16,FEBRUARI
SULAWESI BARAT,POLEWALI MANDAR,MAPILLI,RUMPA,65,16,2,1,1,1,0,2,0,0,0,0,4,2,2,0,13,7,6,2,11,7,4,4,16,4,12,9,FEBRUARI
SULAWESI BARAT,POLEWALI MANDAR,MAPILLI,KURMA,76,68,22,14,2,1,1,9,8,2,10,0,3,3,0,1,10,10,0,10,5,0,5,0,38,24,14,19,FEBRUARI
SULAWESI BARAT,POLEWALI MANDAR,MAPILLI,BUKU,98,18,4,3,1,1,1,3,0,0,3,1,4,3,1,3,16,6,10,0,11,5,6,0,20,12,8,14,FEBRUARI
SULAWESI BARAT,POLEWALI MANDAR,MAPILLI,BONNE BONNE,39,16,13,8,1,1,0,1,7,0,9,1,0,0,0,0,12,8,4,7,1,1,0,0,2,2,0,2,FEBRUARI
SULAWESI BARAT,POLEWALI MANDAR,MAPILLI,BEROANGIN,38,29,26,25,24,18,1,18,7,0,3,17,2,1,1,1,26,22,4,19,13,8,5,1,23,5,18,16,FEBRUARI
SULAWESI BARAT,POLEWALI MANDAR,MAPILLI,SEGERANG,80,24,13,11,3,3,0,7,5,1,1,10,5,5,0,5,11,7,4,4,6,0,6,0,10,9,1,4,FEBRUARI
SULAWESI BARAT,POLEWALI MANDAR,MAPILLI,BONRA,37,32,6,6,0,0,0,4,0,0,5,0,2,2,0,2,21,17,4,17,21,18,3,15,32,23,9,28,FEBRUARI
SULAWESI BARAT,POLEWALI MANDAR,MAPILLI,SATTOKO,65,55,25,3,1,1,0,5,14,1,14,4,6,0,6,0,50,34,16,14,6,4,2,4,39,35,4,27,FEBRUARI
SULAWESI BARAT,POLEWALI MANDAR,MAPILLI,RAPPANG BARAT,32,32,31,15,6,1,1,12,9,8,16,5,3,3,0,0,12,12,0,5,5,2,3,2,14,5,9,10,FEBRUARI
SULAWESI BARAT,POLEWALI MANDAR,MAPILLI,LANDI KANUSUANG,57,50,8,1,0,0,0,6,0,0,2,6,5,4,1,1,31,13,18,12,9,1,8,1,13,12,1,7,FEBRUARI
SULAWESI BARAT,POLEWALI MANDAR,MATAKALI,MATAKALI,65,55,15,7,7,5,5,0,1,3,5,6,10,6,4,5,20,16,4,0,20,12,8,5,27,7,20,5,FEBRUARI
SULAWESI BARAT,POLEWALI MANDAR,MATAKALI,PETAMPANUA,49,11,11,1,1,1,1,5,3,0,8,3,9,3,6,0,11,10,1,1,1,0,1,0,4,3,1,4,FEBRUARI
SULAWESI BARAT,POLEWALI MANDAR,MATAKALI,BARUMBUNG,80,48,39,28,5,4,1,34,2,2,39,0,1,0,1,0,45,27,18,7,25,15,10,1,46,26,20,36,FEBRUARI
SULAWESI BARAT,POLEWALI MANDAR,MATAKALI,PASIANG,42,41,20,12,0,0,0,18,2,0,16,4,0,0,0,0,24,14,10,14,24,12,12,6,14,11,3,4,FEBRUARI
SULAWESI BARAT,POLEWALI MANDAR,MATAKALI,TONROLIMA,62,44,15,5,3,2,0,13,0,1,10,2,6,6,0,5,13,6,7,6,5,1,4,0,17,12,5,10,FEBRUARI
SULAWESI BARAT,POLEWALI MANDAR,MATAKALI,INDOMAKKOMBONG,35,57,53,19,18,17,4,34,2,4,49,4,7,0,7,0,36,32,4,6,5,2,3,0,15,4,11,2,FEBRUARI
SULAWESI BARAT,POLEWALI MANDAR,MATAKALI,BUNGA-BUNGA,61,56,3,0,0,0,0,0,3,0,3,0,5,1,4,0,24,6,18,2,6,3,3,2,27,8,19,11,FEBRUARI
SULAWESI BARAT,POLEWALI MANDAR,MATANGNGA,MATANGNGA,94,50,26,18,18,7,2,12,5,7,10,3,12,0,12,0,40,36,4,33,36,21,15,2,34,18,16,16,FEBRUARI
SULAWESI BARAT,POLEWALI MANDAR,MATANGNGA,LILLI,66,74,46,15,14,2,1,31,7,1,4,3,3,0,3,0,25,13,12,3,20,15,5,12,48,45,3,9,FEBRUARI
SULAWESI BARAT,POLEWALI MANDAR,MATANGNGA,RANGOAN,39,12,10,10,0,0,0,3,6,1,10,0,2,2,0,1,10,7,3,5,2,1,1,1,2,0,2,1,FEBRUARI
SULAWESI BARAT,POLEWALI MANDAR,MATANGNGA,TAPUA,78,18,1,1,0,0,0,0,0,0,1,0,15,8,7,0,13,5,8,0,12,9,3,2,7,0,7,6,FEBRUARI
SULAWESI BARAT,POLEWALI MANDAR,MATANGNGA,MAMBU TAPUA,97,18,8,2,1,1,1,5,0,2,4,0,10,8,2,1,18,12,6,8,0,0,0,0,7,6,1,2,FEBRUARI
SULAWESI BARAT,POLEWALI MANDAR,MATANGNGA,BA'BA TAPUA,66,43,43,33,5,2,1,12,14,14,10,9,4,0,4,0,35,10,25,1,29,2,27,2,5,2,3,4,FEBRUARI
SULAWESI BARAT,POLEWALI MANDAR,MATANGNGA,KATIMBANG,34,28,7,5,4,1,1,4,0,1,2,2,2,0,2,0,22,11,11,7,14,4,10,4,22,12,10,13,FEBRUARI
SULAWESI BARAT,POLEWALI MANDAR,POLEWALI,POLEWALI,77,71,18,15,0,0,0,8,10,0,14,4,8,5,3,3,49,43,6,27,41,29,12,3,0,0,0,0,FEBRUARI
SULAWESI BARAT,POLEWALI MANDAR,POLEWALI,WATTANG,87,74,20,15,7,5,5,14,0,1,5,2,5,2,3,1,50,33,17,11,35,9,26,0,10,3,7,0,FEBRUARI
SULAWESI BARAT,POLEWALI MANDAR,POLEWALI,SULEWATANG,48,60,38,25,10,9,4,29,0,5,5,8,0,0,0,0,48,40,8,12,30,16,14,12,72,29,43,46,FEBRUARI
SULAWESI BARAT,POLEWALI MANDAR,POLEWALI,LANTORA,79,79,7,1,0,0,0,1,6,0,6,1,13,3,10,3,10,7,3,0,5,5,0,5,12,12,0,2,FEBRUARI
SULAWESI BARAT,POLEWALI MANDAR,POLEWALI,TAKATIDUNG,67,51,1,1,0,0,0,1,0,0,1,0,10,5,5,0,24,22,2,7,17,8,9,0,8,6,2,7,FEBRUARI
SULAWESI BARAT,POLEWALI MANDAR,POLEWALI,PEKKABATA,83,41,16,11,9,6,1,12,3,0,4,0,1,1,0,0,28,17,11,1,16,5,11,4,37,13,24,36,FEBRUARI
SULAWESI BARAT,POLEWALI MANDAR,POLEWALI,MADATE,32,71,19,19,4,2,0,13,6,0,12,1,5,0,5,0,56,27,29,4,14,1,13,1,21,2,19,17,FEBRUARI
SULAWESI BARAT,POLEWALI MANDAR,POLEWALI,MANDING,86,63,20,2,2,0,0,7,4,5,18,2,15,5,10,0,21,11,10,11,3,0,3,0,4,2,2,2,FEBRUARI
SULAWESI BARAT,POLEWALI MANDAR,POLEWALI,DARMA,56,66,6,1,0,0,0,4,2,0,3,2,11,3,8,1,54,5,49,4,15,6,9,3,10,4,6,0,FEBRUARI
SULAWESI BARAT,POLEWALI MANDAR,TAPANGO,PELITAKAN,45,14,13,4,2,1,1,6,1,5,4,8,7,0,7,0,10,9,1,4,6,0,6,0,9,8,1,5,FEBRUARI
SULAWESI BARAT,POLEWALI MANDAR,TAPANGO,TAPANGO,38,53,14,13,13,6,5,1,6,1,0,7,6,0,6,0,21,21,0,10,0,0,0,0,30,20,10,12,FEBRUARI
SULAWESI BARAT,POLEWALI MANDAR,TAPANGO,RAPPANG,87,55,46,10,0,0,0,22,11,11,16,13,10,8,2,2,52,52,0,24,42,22,20,5,41,5,36,41,FEBRUARI
SULAWESI BARAT,POLEWALI MANDAR,TAPANGO,DAKKA,79,68,61,3,3,2,0,23,37,1,11,29,7,4,3,0,32,19,13,2,5,3,2,2,18,16,2,10,FEBRUARI
SULAWESI BARAT,POLEWALI MANDAR,TAPANGO,BATU,100,31,29,20,4,2,1,27,0,1,16,11,1,0,1,0,20,14,6,2,20,8,12,7,34,9,25,29,FEBRUARI
SULAWESI BARAT,POLEWALI MANDAR,TAPANGO,RISO,93,66,12,6,3,1,0,1,10,0,3,5,13,1,12,0,15,9,6,5,7,3,4,3,12,4,8,5,FEBRUARI
SULAWESI BARAT,POLEWALI MANDAR,TAPANGO,PALATTA,82,10,2,2,2,0,0,2,0,0,2,0,14,7,7,6,10,10,0,4,4,3,1,0,3,2,1,1,FEBRUARI
SULAWESI BARAT,POLEWALI MANDAR,TAPANGO,TAPANGO BARAT,30,29,17,5,3,2,2,4,9,1,12,3,0,0,0,0,19,17,2,5,9,5,4,5,7,7,0,0,FEBRUARI
SULAWESI BARAT,POLEWALI MANDAR,TAPANGO,KURRAK,51,30,28,6,6,5,3,4,5,7,8,8,10,2,8,0,26,22,4,15,25,10,15,0,34,7,27,23,FEBRUARI
SULAWESI BARAT,POLEWALI MANDAR,TAPANGO,BUSSU,47,55,23,6,4,3,1,19,2,1,21,0,0,0,0,0,51,12,39,10,4,2,2,1,12,5,7,3,FEBRUARI
SULAWESI BARAT,POLEWALI MANDAR,TAPANGO,TUTTULA,56,67,55,34,12,4,0,47,2,6,14,37,10,3,7,1,17,10,7,9,4,3,1,0,7,2,5,0,FEBRUARI
SULAWESI BARAT,POLEWALI MANDAR,TAPANGO,JAMBU MALEA,86,26,14,10,8,7,7,5,0,1,2,0,14,7,7,3,19,8,11,8,11,8,3,4,4,0,4,1,FEBRUARI
SULAWESI BARAT,POLEWALI MANDAR,TAPANGO,KALIMBUA,76,37,1,0,0,0,0,1,0,0,1,0,14,14,0,8,15,6,9,3,2,0,2,0,1,0,1,1,FEBRUARI
SULAWESI BARAT,POLEWALI MANDAR,TAPANGO,BANATO REJO,89,40,30,9,7,0,0,18,3,0,22,8,5,5,0,5,12,6,6,0,11,10,1,1,19,7,12,10,FEBRUARI
SULAWESI BARAT,POLEWALI MANDAR,TINAMBUNG,TINAMBUNG,39,55,12,5,2,0,0,5,7,0,11,1,5,0,5,0,23,5,18,5,12,6,6,0,16,13,3,11,FEBRUARI
SULAWESI BARAT,POLEWALI MANDAR,TINAMBUNG,KARAMA,36,18,4,2,1,1,0,0,3,1,0,2,0,0,0,0,11,6,5,2,9,0,9,0,8,5,3,2,FEBRUARI
SULAWESI BARAT,POLEWALI MANDAR,TINAMBUNG,TANGNGA TANGNGA,83,73,40,29,9,6,4,7,25,1,35,5,13,13,0,4,40,39,1,29,26,6,20,0,42,17,25,30,FEBRUARI
SULAWESI BARAT,POLEWALI MANDAR,TINAMBUNG,LEKOPADIS,47,73,63,21,19,14,0,52,10,1,27,16,5,3,2,1,36,21,15,2,9,2,7,1,57,7,50,9,FEBRUARI
SULAWESI BARAT,POLEWALI MANDAR,TINAMBUNG,GALUNG LOMBOK,56,64,4,4,0,0,0,4,0,0,0,1,6,0,6,0,44,7,37,5,33,28,5,3,63,15,48,47,FEBRUARI
SULAWESI BARAT,POLEWALI MANDAR,TINAMBUNG,TANDUNG,83,24,11,6,6,5,0,5,2,1,6,1,0,0,0,0,16,10,6,0,0,0,0,0,4,4,0,1,FEBRUARI
SULAWESI BARAT,POLEWALI MANDAR,TINAMBUNG,BATULAYA,67,60,33,33,13,8,5,25,1,0,22,3,12,3,9,2,38,10,28,3,25,15,10,1,14,5,9,6,FEBRUARI
SULAWESI BARAT,POLEWALI MANDAR,TINAMBUNG,SEPABATU,93,53,47,43,6,2,0,38,3,5,16,28,11,11,0,6,42,14,28,2,13,12,1,5,45,13,32,34,FEBRUARI
SULAWESI BARAT,POLEWALI MANDAR,TUTAR,TARAMANU,100,71,34,25,17,3,1,6,18,0,25,5,16,3,13,0,61,48,13,43,35,32,3,25,21,13,8,9,FEBRUARI
SULAWESI BARAT,POLEWALI MANDAR,TUTAR,AMBOPADANG,78,32,26,4,0,0,0,7,18,1,21,3,11,0,11,0,31,7,24,2,24,18,6,1,39,22,17,27,FEBRUARI
SULAWESI BARAT,POLEWALI MANDAR,TUTAR,TUBBI,79,45,9,6,1,0,0,6,3,0,6,0,3,2,1,2,33,11,22,2,31,21,10,21,3,2,1,3,FEBRUARI
SULAWESI BARAT,POLEWALI MANDAR,TUTAR,RATTE,42,64,32,4,4,2,0,13,14,3,26,2,1,1,0,1,17,7,10,4,6,3,3,3,31,23,8,16,FEBRUARI
SULAWESI BARAT,POLEWALI MANDAR,TUTAR,BESOANGIN,77,69,64,7,6,4,1,51,2,5,0,45,2,0,2,0,44,28,16,8,28,14,14,9,38,17,21,1,FEBRUARI
SULAWESI BARAT,POLEWALI MANDAR,TUTAR,PIRIANG TAPIKO,47,60,17,16,5,0,0,13,2,1,1,11,4,3,1,0,31,30,1,18,4,4,0,3,31,6,25,19,FEBRUARI
SULAWESI BARAT,POLEWALI MANDAR,TUTAR,PEBURRU,78,63,30,0,0,0,0,17,1,1,12,2,13,4,9,2,35,23,12,4,24,12,12,11,21,0,21,8,FEBRUARI
SULAWESI BARAT,POLEWALI MANDAR,TUTAR,TALOBA,45,43,15,14,1,0,0,11,1,0,8,1,0,0,0,0,13,10,3,2,7,1,6,0,31,19,12,10,FEBRUARI
SULAWESI BARAT,POLEWALI MANDAR,TUTAR,POLLEWANI,86,38,29,12,10,8,4,21,0,3,9,6,0,0,0,0,37,8,29,6,29,21,8,16,53,4,49,16,FEBRUARI
SULAWESI BARAT,POLEWALI MANDAR,TUTAR,ARABUA,51,21,16,14,13,7,2,9,1,1,11,0,8,1,7,1,20,17,3,0,12,10,2,3,18,1,17,9,FEBRUARI
SULAWESI BARAT,POLEWALI MANDAR,TUTAR,BESOANGIN UTARA,79,21,3,1,1,1,0,3,0,0,0,3,0,0,0,0,11,5,6,2,8,0,8,0,4,0,4,0,FEBRUARI
SULAWESI BARAT,POLEWALI MANDAR,TUTAR,PODA,82,62,11,0,0,0,0,5,0,6,1,1,2,1,1,0,16,13,3,4,5,3,2,0,26,6,20,16,FEBRUARI
SULAWESI BARAT,POLEWALI MANDAR,TUTAR,TARAMANU TUA,50,18,17,5,0,0,0,7,6,2,5,9,0,0,0,0,17,7,10,4,8,7,1,2,15,4,11,6,FEBRUARI
SULAWESI BARAT,POLEWALI MANDAR,WONOMULYO,SIDODADI,81,35,10,8,6,5,4,3,2,1,7,1,3,1,2,0,19,19,0,5,6,0,6,0,15,8,7,9,FEBRUARI
SULAWESI BARAT,POLEWALI MANDAR,WONOMULYO,SIDOREJO,76,24,17,1,1,1,1,6,5,3,7,4,0,0,0,0,20,5,15,3,16,16,0,12,19,17,2,4,FEBRUARI
SULAWESI BARAT,POLEWALI MANDAR,WONOMULYO,SUMBEREJO,97,69,25,6,0,0,0,11,1,1,10,15,4,2,2,0,28,21,7,10,5,4,1,1,7,0,7,1,FEBRUARI
SULAWESI BARAT,POLEWALI MANDAR,WONOMULYO,BUMIAYU,66,60,49,6,4,3,0,11,20,8,39,0,13,7,6,6,11,6,5,1,11,7,4,7,33,26,7,10,FEBRUARI
SULAWESI BARAT,POLEWALI MANDAR,WONOMULYO,KEBUNSARI,32,76,25,13,2,0,0,20,3,0,20,5,2,1,1,0,42,34,8,31,42,19,23,10,27,22,5,24,FEBRUARI
SULAWESI BARAT,POLEWALI MANDAR,WONOMULYO,BANUA BARU,75,70,53,30,8,5,2,14,11,25,51,2,11,11,0,7,51,51,0,33,5,0,5,0,44,20,24,24,FEBRUARI
SULAWESI BARAT,POLEWALI MANDAR,WONOMULYO,NEPO,54,63,26,7,4,1,0,6,17,3,21,2,4,1,3,1,59,37,22,24,2,2,0,2,24,1,23,19,FEBRUARI
SULAWESI BARAT,POLEWALI MANDAR,WONOMULYO,SUGIHWARAS,74,37,12,0,0,0,0,12,0,0,7,5,1,1,0,0,27,16,11,2,10,5,5,1,33,26,7,31,FEBRUARI
SULAWESI BARAT,POLEWALI MANDAR,WONOMULYO,CAMPURJO,99,23,15,2,0,0,0,6,0,2,11,4,1,0,1,0,13,8,5,0,1,0,1,0,16,10,6,4,FEBRUARI
SULAWESI BARAT,POLEWALI MANDAR,WONOMULYO,BUMIMULYO,83,17,15,0,0,0,0,13,1,0,11,2,6,2,4,2,15,9,6,3,9,7,2,1,10,2,8,7,FEBRUARI
SULAWESI BARAT,POLEWALI MANDAR,WONOMULYO,TUMPILING,62,16,0,0,0,0,0,0,0,0,0,0,12,8,4,2,13,12,1,6,3,3,0,1,1,1,0,1,FEBRUARI
SULAWESI BARAT,POLEWALI MANDAR,WONOMULYO,BAKKA-BAKKA,83,59,48,9,2,2,2,23,7,0,14,17,4,1,3,0,23,14,9,8,19,16,3,7,0,0,0,0,FEBRUARI
SULAWESI BARAT,POLEWALI MANDAR,WONOMULYO,ARJO SARI,81,49,27,4,1,0,0,0,12,10,27,0,10,4,6,2,42,29,13,15,33,24,9,12,7,4,3,7,FEBRUARI
SULAWESI BARAT,POLEWALI MANDAR,WONOMULYO,GALESON,91,71,22,20,2,1,1,9,8,4,12,4,8,2,6,0,18,16,2,15,5,0,5,0,16,8,8,9,FEBRUARI
SULAWESI BARAT,MAMUJU,MAMUJU,BINANGA,63,66,24,1,1,0,0,9,14,0,22,0,2,0,2,0,46,6,40,5,28,2,26,0,19,4,15,8,FEBRUARI
SULAWESI BARAT,MAMUJU,MAMUJU,MAMUNYU,90,56,53,14,6,3,1,31,7,12,33,16,15,4,11,4,56,24,32,0,32,30,2,20,25,14,11,13,FEBRUARI
SULAWESI BARAT,MAMUJU,MAMUJU,KAREMA,98,15,3,2,0,0,0,0,0,1,2,1,12,3,9,1,13,11,2,0,6,3,3,3,10,2,8,9,FEBRUARI
SULAWESI BARAT,MAMUJU,MAMUJU,RIMUKU,37,66,55,34,17,2,2,1,28,4,9,38,5,2,3,0,44,9,35,6,9,4,5,4,31,13,18,18,FEBRUARI
SULAWESI BARAT,MAMUJU,MAMUJU,BAMBU,83,38,35,26,8,3,3,21,9,2,27,1,7,5,2,2,10,6,4,3,1,1,0,1,3,0,3,0,FEBRUARI
SULAWESI BARAT,MAMUJU,MAMUJU,KARAMPUANG,44,52,23,13,12,1,1,13,0,0,6,2,8,6,2,6,38,31,7,24,31,8,23,0,15,13,2,1,FEBRUARI
SULAWESI BARAT,MAMUJU,MAMUJU,TADUI,40,26,20,1,0,0,0,20,0,0,4,14,4,1,3,1,16,14,2,13,14,10,4,10,16,8,8,3,FEBRUARI
SULAWESI BARAT,MAMUJU,MAMUJU,BATU PANNU,70,18,5,2,1,0,0,4,0,1,1,1,5,3,2,0,12,6,6,1,10,7,3,1,11,1,10,6,FEBRUARI
SULAWESI BARAT,MAMUJU,TAPALANG,GALUNG,64,80,45,33,24,1,0,40,5,0,7,22,10,10,0,6,11,6,5,6,11,8,3,6,52,18,34,40,FEBRUARI
SULAWESI BARAT,MAMUJU,TAPALANG,KASAMBANG,49,20,10,10,7,0,0,9,1,0,7,3,2,2,0,0,20,16,4,11,5,1,4,1,6,4,2,2,FEBRUARI
SULAWESI BARAT,MAMUJU,TAPALANG,DAYANGINNA,62,49,48,45,16,0,0,7,30,5,0,1,11,5,6,2,38,32,6,29,34,30,4,15,14,12,2,1,FEBRUARI
SULAWESI BARAT,MAMUJU,TAPALANG,OROBATU,89,74,21,11,6,5,1,18,2,0,14,2,2,2,0,1,52,9,43,5,25,15,10,0,44,18,26,23,FEBRUARI
SULAWESI BARAT,MAMUJU,TAPALANG,TAKANDEANG,49,69,45,43,31,0,0,5,33,7,25,8,2,1,1,1,20,11,9,3,3,1,2,1,41,31,10,6,FEBRUARI
SULAWESI BARAT,MAMUJU,TAPALANG,BELA,62,56,9,0,0,0,0,7,2,0,2,1,6,6,0,6,34,31,3,10,16,13,3,6,7,5,2,4,FEBRUARI
SULAWESI BARAT,MAMUJU,TAPALANG,TAAN,91,67,37,1,1,1,1,36,0,0,29,8,2,0,2,0,22,7,15,5,10,7,3,0,16,5,11,11,FEBRUARI
SULAWESI BARAT,MAMUJU,TAPALANG,TAMPALANG,72,26,1,0,0,0,0,1,0,0,1,0,13,9,4,9,21,21,0,17,3,3,0,3,7,6,1,4,FEBRUARI
SULAWESI BARAT,MAMUJU,TAPALANG,RANTEDODA,93,40,24,16,10,10,1,6,7,0,14,4,15,0,15,0,14,5,9,2,11,7,4,4,39,22,17,30,FEBRUARI
SULAWESI BARAT,MAMUJU,TAPALANG,KOPEANG,85,40,40,19,3,2,2,20,18,0,2,15,2,1,1,0,18,12,6,2,16,11,5,7,33,21,12,8,FEBRUARI
SULAWESI BARAT,MAMUJU,KALUKKU,SINYONYOI,80,39,27,6,0,0,0,14,5,2,7,5,13,5,8,0,24,8,16,7,14,12,2,9,19,16,3,11,FEBRUARI
SULAWESI BARAT,MAMUJU,KALUKKU,BEBANGA,47,47,30,5,4,1,1,14,1,14,11,13,9,4,5,1,34,10,24,10,32,19,13,17,27,14,13,1,FEBRUARI
SULAWESI BARAT,MAMUJU,KALUKKU,KALUKKU,47,55,30,11,6,2,0,17,4,9,29,0,8,2,6,1,16,10,6,1,14,1,13,0,50,26,24,36,FEBRUARI
SULAWESI BARAT,MAMUJU,KALUKKU,SINYONYOI SELATAN,38,71,12,10,3,2,0,1,7,4,3,4,2,1,1,0,60,19,41,11,2,0,2,0,7,7,0,6,FEBRUARI
SULAWESI BARAT,MAMUJU,KALUKKU,SONDOANG,97,60,48,10,2,2,1,39,1,3,30,9,0,0,0,0,15,9,6,6,3,2,1,0,14,12,2,4,FEBRUARI
SULAWESI BARAT,MAMUJU,KALUKKU,BERU-BERU,36,77,1,0,0,0,0,1,0,0,0,1,4,1,3,1,66,14,52,11,9,4,5,2,62,46,16,43,FEBRUARI
SULAWESI BARAT,MAMUJU,KALUKKU,BELANG BELANG,77,61,5,2,0,0,0,1,1,1,2,0,9,2,7,2,40,11,29,11,29,29,0,1,12,11,1,11,FEBRUARI
SULAWESI BARAT,MAMUJU,KALUKKU,KABULOANG,45,16,12,10,7,7,0,1,2,9,10,0,7,3,4,1,16,10,6,6,15,5,10,5,15,10,5,15,FEBRUARI
SULAWESI BARAT,MAMUJU,KALUKKU,KEANG,34,45,27,11,0,0,0,26,0,1,5,14,1,0,1,0,41,6,35,1,38,10,28,3,4,0,4,1,FEBRUARI
SULAWESI BARAT,MAMUJU,KALUKKU,POKKANG,89,13,12,3,0,0,0,9,3,0,12,0,9,2,7,2,13,7,6,7,13,5,8,3,6,1,5,1,FEBRUARI
SULAWESI BARAT,MAMUJU,KALUKKU,GULILING,37,53,32,10,3,1,0,15,14,1,30,0,4,0,4,0,41,8,33,4,26,25,1,22,54,28,26,14,FEBRUARI
SULAWESI BARAT,MAMUJU,KALUKKU,UHAIMATE,87,70,34,33,25,17,13,6,2,1,33,1,2,2,0,0,33,33,0,0,4,0,4,0,4,0,4,3,FEBRUARI
SULAWESI BARAT,MAMUJU,KALUKKU,KALUKKU BARAT,99,35,26,22,1,0,0,3,12,4,18,1,9,7,2,3,22,13,9,12,9,8,1,8,20,13,7,18,FEBRUARI
SULAWESI BARAT,MAMUJU,KALUKKU,PAMMULUKANG,56,47,23,13,10,8,1,6,2,12,7,5,7,1,6,1,40,27,13,16,0,0,0,0,14,7,7,10,FEBRUARI
SULAWESI BARAT,MAMUJU,KALUMPANG,KALUMPANG,34,55,41,14,9,5,5,6,1,20,28,4,3,3,0,1,27,21,6,21,11,11,0,2,45,22,23,30,FEBRUARI
SULAWESI BARAT,MAMUJU,KALUMPANG,KARATAUN,65,24,18,18,12,3,1,9,8,0,12,2,4,3,1,1,16,12,4,0,10,5,5,5,0,0,0,0,FEBRUARI
SULAWESI BARAT,MAMUJU,KALUMPANG,KARAMA,58,22,15,12,9,5,5,7,1,2,15,0,0,0,0,0,17,7,10,4,8,8,0,4,9,9,0,5,FEBRUARI
SULAWESI BARAT,MAMUJU,KALUMPANG,SIRAUN,74,37,13,2,0,0,0,3,9,1,8,0,0,0,0,0,25,14,11,9,22,3,19,2,19,9,10,19,FEBRUARI
SULAWESI BARAT,MAMUJU,KALUMPANG,TUMOGA,98,42,25,6,0,0,0,16,3,6,14,1,8,2,6,2,21,8,13,2,9,5,4,1,13,4,9,0,FEBRUARI
SULAWESI BARAT,MAMUJU,KALUMPANG,SALUMAKKI,50,57,45,3,2,1,1,29,8,3,9,9,3,3,0,2,32,30,2,27,32,14,18,9,53,50,3,2,FEBRUARI
SULAWESI BARAT,MAMUJU,KALUMPANG,POLIO,82,61,59,57,1,0,0,3,3,47,36,22,16,13,3,13,32,23,9,6,12,1,11,0,33,17,16,19,FEBRUARI
SULAWESI BARAT,MAMUJU,KALUMPANG,LIMBONG,60,61,32,1,1,0,0,25,3,3,30,2,7,4,3,4,41,12,29,10,32,32,0,14,1,0,1,0,FEBRUARI
SULAWESI BARAT,MAMUJU,KALUMPANG,SANDAPANG,39,46,44,0,0,0,0,41,0,3,25,14,4,0,4,0,22,11,11,1,20,2,18,2,28,12,16,0,FEBRUARI
SULAWESI BARAT,MAMUJU,KALUMPANG,KONDO BULO,31,35,28,25,11,1,0,3,7,16,16,10,1,1,0,0,28,22,6,9,13,12,1,6,32,2,30,15,FEBRUARI
SULAWESI BARAT,MAMUJU,KALUMPANG,MAKKALIKI,82,73,65,18,0,0,0,47,3,4,9,25,0,0,0,0,43,10,33,4,29,2,27,1,44,18,26,19,FEBRUARI
SULAWESI BARAT,MAMUJU,KALUMPANG,BATU MAKKADA,42,63,16,15,2,1,0,1,14,1,7,8,6,1,5,1,53,43,10,42,2,0,2,0,33,23,10,25,FEBRUARI
SULAWESI BARAT,MAMUJU,KALUMPANG,LASA',95,47,33,23,0,0,0,8,10,12,6,20,11,8,3,7,10,6,4,6,5,2,3,1,31,21,10,12,FEBRUARI
SULAWESI BARAT,MAMUJU,PAPALANG,TOABO,84,12,7,6,3,0,0,7,0,0,7,0,3,0,3,0,11,11,0,0,10,10,0,9,14,11,3,12,FEBRUARI
SULAWESI BARAT,MAMUJU,PAPALANG,PAPALANG,85,24,11,2,2,1,0,2,4,1,4,7,3,1,2,0,10,7,3,0,5,4,1,1,9,2,7,3,FEBRUARI
SULAWESI BARAT,MAMUJU,PAPALANG,BONDA,72,68,0,0,0,0,0,0,0,0,0,0,6,3,3,3,10,6,4,3,7,3,4,2,20,19,1,19,FEBRUARI
SULAWESI BARAT,MAMUJU,PAPALANG,TOPORE,88,42,23,20,17,12,0,8,4,10,19,3,4,0,4,0,14,14,0,0,8,2,6,1,10,5,5,10,FEBRUARI
SULAWESI BARAT,MAMUJU,PAPALANG,SALUKAYU,48,24,11,3,2,1,0,8,1,1,5,0,7,0,7,0,17,10,7,8,1,1,0,1,11,5,6,0,FEBRUARI
SULAWESI BARAT,MAMUJU,PAPALANG,SUKADAMAI,53,50,48,29,9,5,3,17,4,8,6,31,4,3,1,0,40,24,16,11,20,20,0,2,44,17,27,12,FEBRUARI
SULAWESI BARAT,MAMUJU,PAPALANG,BODA-BODA,42,69,68,30,13,2,0,15,8,14,55,3,5,4,1,1,60,58,2,55,10,3,7,1,0,0,0,0,FEBRUARI
SULAWESI BARAT,MAMUJU,PAPALANG,SISANGO,90,41,3,0,0,0,0,0,2,0,0,1,12,0,12,0,25,25,0,17,8,5,3,0,20,12,8,7,FEBRUARI
SULAWESI BARAT,MAMUJU,PAPALANG,BATU AMPA,63,39,39,5,1,1,1,22,8,5,30,7,7,0,7,0,17,17,0,16,7,6,1,4,11,5,6,9,FEBRUARI
SULAWESI BARAT,MAMUJU,SAMPAGA,BUNDE,75,78,72,70,30,17,0,33,30,9,19,33,8,0,8,0,15,11,4,11,14,10,4,8,21,7,14,18,FEBRUARI
SULAWESI BARAT,MAMUJU,SAMPAGA,KALONDING,53,64,28,24,22,5,5,5,10,1,1,6,7,3,4,3,62,14,48,8,18,17,1,12,21,9,12,14,FEBRUARI
SULAWESI BARAT,MAMUJU,SAMPAGA,TARAILU,57,25,17,16,14,6,2,10,3,2,15,2,5,4,1,1,16,16,0,4,0,0,0,0,12,12,0,12,FEBRUARI
SULAWESI BARAT,MAMUJU,SAMPAGA,SAMPAGA,97,52,3,0,0,0,0,0,2,1,0,1,6,4,2,3,20,5,15,3,5,5,0,5,16,16,0,4,FEBRUARI
SULAWESI BARAT,MAMUJU,SAMPAGA,TANAMBUAH,47,50,49,22,2,0,0,46,2,0,8,4,4,2,2,2,12,5,7,1,0,0,0,0,7,5,2,1,FEBRUARI
SULAWESI BARAT,MAMUJU,SAMPAGA,SALUBARANA,61,36,27,6,5,1,0,10,7,3,17,10,10,10,0,3,11,7,4,7,11,9,2,5,0,0,0,0,FEBRUARI
SULAWESI BARAT,MAMUJU,SAMPAGA,LOSSO,88,19,0,0,0,0,0,0,0,0,0,0,17,3,14,3,13,9,4,0,12,7,5,0,25,20,5,15,FEBRUARI
SULAWESI BARAT,MAMUJU,TOMMO,TOMMO,78,70,58,28,11,4,4,19,16,0,6,13,11,2,9,0,54,54,0,8,26,6,20,3,0,0,0,0,FEBRUARI
SULAWESI BARAT,MAMUJU,TOMMO,CAMPALOGA,54,62,9,6,3,2,2,4,1,0,2,7,10,1,9,1,62,44,18,44,31,4,27,1,1,1,0,1,FEBRUARI
SULAWESI BARAT,MAMUJU,TOMMO,BUANA SAKTI,49,25,17,12,1,0,0,6,8,0,14,2,5,4,1,0,16,16,0,2,3,2,1,1,5,4,1,2,FEBRUARI
SULAWESI BARAT,MAMUJU,TOMMO,TAMEMONGGA,60,39,25,23,22,19,15,6,2,2,16,7,7,7,0,3,13,11,2,0,7,2,5,2,2,0,2,1,FEBRUARI
SULAWESI BARAT,MAMUJU,TOMMO,TAMEJARRA,32,67,55,36,6,1,1,52,2,0,40,15,5,3,2,2,42,12,30,8,12,6,6,4,18,1,17,1,FEBRUARI
SULAWESI BARAT,MAMUJU,TOMMO,RANTEMARIO,37,69,17,4,3,1,0,6,3,7,14,3,2,0,2,0,60,35,25,1,0,0,0,0,39,27,12,23,FEBRUARI
SULAWESI BARAT,MAMUJU,TOMMO,MALINO,94,37,29,19,19,11,0,15,1,11,11,0,13,11,2,4,34,29,5,3,2,1,1,0,16,12,4,13,FEBRUARI
SULAWESI BARAT,MAMUJU,TOMMO,KAKULLASANG,53,64,57,53,9,8,4,38,0,3,27,3,5,4,1,3,61,26,35,23,9,2,7,0,45,14,31,16,FEBRUARI
SULAWESI BARAT,MAMUJU,TOMMO,LELING,94,48,23,23,23,2,0,4,1,6,9,2,15,12,3,3,43,11,32,7,39,13,26,2,0,0,0,0,FEBRUARI
SULAWESI BARAT,MAMUJU,TOMMO,KALEPU,71,30,18,9,4,1,0,3,2,0,16,1,0,0,0,0,30,17,13,4,14,14,0,12,4,4,0,4,FEBRUARI
SULAWESI BARAT,MAMUJU,TOMMO,SANDANA,98,28,25,8,3,2,2,9,0,4,2,6,15,14,1,13,18,18,0,13,5,1,4,0,21,13,8,5,FEBRUARI
SULAWESI BARAT,MAMUJU,TOMMO,LELING BARAT,97,44,18,4,4,2,1,7,1,0,3,7,11,10,1,4,25,22,3,22,4,4,0,2,25,17,8,11,FEBRUARI
SULAWESI BARAT,MAMUJU,TOMMO,LELING UTARA,60,45,1,0,0,0,0,1,0,0,1,0,6,4,2,4,21,15,6,2,12,5,7,3,39,1,38,27,FEBRUARI
SULAWESI BARAT,MAMUJU,TOMMO,SALUDENGEN,65,24,2,2,0,0,0,1,1,0,0,0,5,1,4,0,16,8,8,4,11,10,1,5,7,3,4,5,FEBRUARI
SULAWESI BARAT,MAMUJU,SIMBORO DAN KEPULAUAN,SIMBORO,78,41,37,27,25,4,1,21,1,12,17,1,4,4,0,0,35,19,16,18,0,0,0,0,16,6,10,11,FEBRUARI
SULAWESI BARAT,MAMUJU,SIMBORO DAN KEPULAUAN,RANGAS,36,37,27,26,12,11,8,11,4,2,18,5,1,0,1,0,28,18,10,5,7,6,1,5,2,1,1,0,FEBRUARI
SULAWESI BARAT,MAMUJU,SIMBORO DAN KEPULAUAN,BOTTENG,39,36,15,0,0,0,0,4,1,5,2,13,5,0,5,0,31,5,26,2,15,11,4,6,12,7,5,11,FEBRUARI
SULAWESI BARAT,MAMUJU,SIMBORO DAN KEPULAUAN,SALETTO,78,34,15,6,4,0,0,3,9,1,10,5,5,4,1,3,28,28,0,4,23,11,12,6,0,0,0,0,FEBRUARI
SULAWESI BARAT,MAMUJU,SIMBORO DAN KEPULAUAN,SUMARE,85,10,5,1,0,0,0,1,2,0,3,2,4,1,3,1,10,7,3,1,7,0,7,0,12,7,5,11,FEBRUARI
SULAWESI BARAT,MAMUJU,SIMBORO DAN KEPULAUAN,BOTTENG UTARA,38,43,6,1,0,0,0,2,2,2,2,0,0,0,0,0,11,5,6,4,4,1,3,0,16,1,15,1,FEBRUARI
SULAWESI BARAT,MAMUJU,SIMBORO DAN KEPULAUAN,TAPANDULLU,49,36,5,1,1,1,1,3,1,0,3,1,8,0,8,0,30,27,3,16,7,2,5,0,26,21,5,11,FEBRUARI
SULAWESI BARAT,MAMUJU,SIMBORO DAN KEPULAUAN,PATI'DI,59,12,4,4,0,0,0,3,0,1,3,1,6,3,3,1,12,9,3,1,12,11,1,9,18,2,16,2,FEBRUARI
SULAWESI BARAT,MAMUJU,TAPALANG BARAT,DUNGKAIT,62,69,39,33,12,7,5,9,23,2,17,1,6,6,0,3,66,14,52,14,28,21,7,10,4,4,0,1,FEBRUARI
SULAWESI BARAT,MAMUJU,TAPALANG BARAT,LEBANI,94,13,11,10,2,1,1,1,5,4,5,3,0,0,0,0,10,9,1,2,9,3,6,0,4,4,0,0,FEBRUARI
SULAWESI BARAT,MAMUJU,TAPALANG BARAT,LABUANG RANO,91,28,20,5,1,1,0,7,2,11,15,2,11,8,3,8,12,8,4,4,10,0,10,0,11,2,9,7,FEBRUARI
SULAWESI BARAT,MAMUJU,TAPALANG BARAT,PASABU,41,52,33,8,3,1,0,3,9,19,1,30,0,0,0,0,29,23,6,10,21,10,11,0,56,47,9,7,FEBRUARI
SULAWESI BARAT,MAMUJU,TAPALANG BARAT,TANETE PAO,46,32,11,4,4,1,0,4,7,0,6,5,6,0,6,0,30,30,0,4,7,2,5,2,12,0,12,4,FEBRUARI
SULAWESI BARAT,MAMUJU,TAPALANG BARAT,PANGASAAN,67,61,41,14,1,1,0,17,19,0,31,0,8,8,0,1,30,12,18,6,14,2,12,0,56,5,51,9,FEBRUARI
SULAWESI BARAT,MAMUJU,TAPALANG BARAT,AHU,96,55,39,11,2,1,0,24,12,3,28,5,18,16,2,8,25,20,5,2,16,6,10,4,52,52,0,23,FEBRUARI
SULAWESI BARAT,MAMUJU,BONEHAU,BONEHAU,59,61,1,0,0,0,0,1,0,0,1,0,6,2,4,2,42,21,21,8,3,3,0,2,16,5,11,9,FEBRUARI
SULAWESI BARAT,MAMUJU,BONEHAU,SALUTIWO,85,50,14,9,8,0,0,6,3,2,3,4,2,0,2,0,15,6,9,6,12,1,11,1,26,24,2,18,FEBRUARI
SULAWESI BARAT,MAMUJU,BONEHAU,BUTTUADA,35,21,6,4,0,0,0,2,1,2,5,0,7,1,6,0,13,5,8,5,11,2,9,1,15,11,4,15,FEBRUARI
SULAWESI BARAT,MAMUJU,BONEHAU,TAMALEA,86,56,5,1,1,1,1,0,1,3,2,0,0,0,0,0,30,25,5,15,20,20,0,14,4,3,1,1,FEBRUARI
SULAWESI BARAT,MAMUJU,BONEHAU,LUMIKA,69,15,12,4,0,0,0,10,0,0,12,0,1,1,0,0,10,9,1,9,8,0,8,0,7,7,0,5,FEBRUARI
SULAWESI BARAT,MAMUJU,BONEHAU,MAPPU,58,33,12,12,5,5,5,1,0,0,3,4,8,1,7,0,19,16,3,5,18,6,12,4,9,6,3,2,FEBRUARI
SULAWESI BARAT,MAMUJU,BONEHAU,BANUADA,57,69,9,3,3,0,0,9,0,0,0,9,0,0,0,0,30,8,22,5,13,10,3,2,13,1,12,3,FEBRUARI
SULAWESI BARAT,MAMUJU,BONEHAU,HINUA,57,71,63,44,9,2,2,22,12,17,22,30,6,3,3,1,33,27,6,10,0,0,0,0,34,33,1,16,FEBRUARI
SULAWESI BARAT,MAMUJU,BONEHAU,KINATANG,76,57,20,14,12,11,2,3,6,4,8,7,13,7,6,3,13,7,6,5,10,8,2,8,43,22,21,10,FEBRUARI
SULAWESI BARAT,MAMUJU,KEP. BALA BALAKANG,BALA BALAKANG,95,41,12,7,3,0,0,7,5,0,12,0,17,16,1,9,34,13,21,13,22,9,13,5,40,11,29,1,FEBRUARI
SULAWESI BARAT,MAMUJU,KEP. BALA BALAKANG,BALA-BALAKANG TIMUR,34,75,34,30,7,3,2,0,31,0,4,21,1,1,0,1,66,66,0,18,1,1,0,1,4,4,0,2,FEBRUARI
SULAWESI BARAT,MAMUJU TENGAH,TOBADAK,MAHAHE,41,17,6,2,0,0,0,3,0,0,5,0,3,2,1,2,12,6,6,5,12,7,5,1,18,15,3,6,MARET
SULAWESI BARAT,MAMUJU TENGAH,TOBADAK,SALOBAJA,65,48,13,4,2,1,1,4,7,1,3,6,9,3,6,1,26,19,7,0,9,6,3,2,15,9,6,3,MARET
SULAWESI BARAT,MAMUJU TENGAH,TOBADAK,TOBADAK,94,36,12,5,4,0,0,5,5,0,7,3,10,6,4,4,26,12,14,0,23,21,2,17,15,6,9,14,MARET
SULAWESI BARAT,MAMUJU TENGAH,TOBADAK,PALONGAAN,63,80,48,37,18,3,2,18,22,2,47,1,9,7,2,4,21,11,10,11,21,17,4,9,38,2,36,9,MARET
SULAWESI BARAT,MAMUJU TENGAH,TOBADAK,BATU PARIGI,44,40,14,10,4,3,2,10,1,1,3,0,2,1,1,1,11,11,0,4,4,1,3,1,19,10,9,18,MARET
SULAWESI BARAT,MAMUJU TENGAH,TOBADAK,BAMBADARU,58,72,19,19,2,0,0,4,12,3,15,3,6,3,3,1,62,43,19,20,58,16,42,5,27,4,23,15,MARET
SULAWESI BARAT,MAMUJU TENGAH,TOBADAK,SEJATI,75,52,47,35,32,27,19,3,17,3,19,6,0,0,0,0,25,20,5,1,7,1,6,0,18,6,12,3,MARET
SULAWESI BARAT,MAMUJU TENGAH,TOBADAK,SALOADAK,89,13,12,3,2,1,0,10,2,0,4,0,8,1,7,1,13,8,5,3,13,7,6,6,4,3,1,4,MARET
SULAWESI BARAT,MAMUJU TENGAH,PANGALE,POLO PANGALE,66,29,9,4,4,1,0,6,1,1,2,5,8,3,5,0,15,7,8,6,6,4,2,4,3,3,0,2,MARET
SULAWESI BARAT,MAMUJU TENGAH,PANGALE,PANGALE,89,26,21,10,8,3,0,10,1,7,3,15,16,14,2,14,16,14,2,7,9,9,0,0,16,0,16,5,MARET
SULAWESI BARAT,MAMUJU TENGAH,PANGALE,SARTANAMAJU,51,42,16,4,1,1,0,4,1,5,1,14,3,1,2,0,39,6,33,2,22,7,15,4,37,16,21,31,MARET
SULAWESI BARAT,MAMUJU TENGAH,PANGALE,POLO LERENG,87,58,47,26,16,14,10,36,0,0,6,9,4,0,4,0,15,9,6,7,1,0,1,0,20,4,16,0,MARET
SULAWESI BARAT,MAMUJU TENGAH,PANGALE,KUO,78,77,8,4,4,0,0,2,0,3,1,0,4,1,3,1,50,20,30,5,16,12,4,8,40,26,14,28,MARET
SULAWESI BARAT,MAMUJU TENGAH,PANGALE,POLO CAMBA,100,67,42,20,18,11,8,12,13,1,6,32,1,0,1,0,27,6,21,4,16,8,8,7,62,6,56,18,MARET
SULAWESI BARAT,MAMUJU TENGAH,PANGALE,LAMBA-LAMBA,72,77,43,17,5,0,0,25,8,2,28,0,7,1,6,0,48,48,0,38,36,6,30,3,81,16,65,69,MARET
SULAWESI BARAT,MAMUJU TENGAH,PANGALE,KOMBILING,41,44,13,4,2,2,2,10,1,0,5,3,1,0,1,0,35,31,4,19,16,0,16,0,32,18,14,11,MARET
SULAWESI BARAT,MAMUJU TENGAH,PANGALE,LEMO-LEMO,93,13,11,3,3,3,2,8,0,1,5,3,5,1,4,0,10,8,2,6,8,4,4,0,11,10,1,6,MARET
SULAWESI BARAT,MAMUJU TENGAH,BUDONG-BUDONG,BABANA,51,22,7,5,5,0,0,1,2,4,0,2,10,0,10,0,22,18,4,6,10,9,1,4,21,13,8,8,MARET
SULAWESI BARAT,MAMUJU TENGAH,BUDONG-BUDONG,LUMU,85,32,20,8,0,0,0,10,1,7,7,13,17,12,5,7,18,11,7,3,9,4,5,4,4,0,4,0,MARET
SULAWESI BARAT,MAMUJU TENGAH,BUDONG-BUDONG,PONTANAKAYANG,45,36,12,6,2,1,0,6,2,0,3,2,4,3,1,1,15,12,3,3,14,8,6,5,23,8,15,15,MARET
SULAWESI BARAT,MAMUJU TENGAH,BUDONG-BUDONG,SALOGATTA,36,43,43,38,5,2,2,7,27,0,37,3,1,1,0,0,23,7,16,6,4,3,1,2,20,11,9,11,MARET
SULAWESI BARAT,MAMUJU TENGAH,BUDONG-BUDONG,KIRE,72,18,2,2,1,1,1,0,1,0,2,0,8,4,4,1,12,9,3,2,6,3,3,3,7,1,6,7,MARET
SULAWESI BARAT,MAMUJU TENGAH,BUDONG-BUDONG,TINALI,100,60,14,7,3,3,2,10,1,1,14,0,19,11,8,2,28,18,10,3,8,3,5,3,11,5,6,4,MARET
SULAWESI BARAT,MAMUJU TENGAH,BUDONG-BUDONG,SALUMANURUNG,49,63,60,4,0,0,0,55,1,0,1,59,4,1,3,0,55,51,4,33,19,18,1,0,61,45,16,11,MARET
SULAWESI BARAT,MAMUJU TENGAH,BUDONG-BUDONG,PASAPA,68,72,47,36,22,21,16,21,5,0,1,37,5,1,4,1,49,32,17,15,21,11,10,7,1,1,0,0,MARET
SULAWESI BARAT,MAMUJU TENGAH,BUDONG-BUDONG,BOJO,64,24,15,4,1,1,0,3,1,11,8,4,2,2,0,0,17,8,9,6,1,0,1,0,0,0,0,0,MARET
SULAWESI BARAT,MAMUJU TENGAH,BUDONG-BUDONG,BARAKKANG,56,18,13,0,0,0,0,2,6,2,5,6,4,0,4,0,11,8,3,2,0,0,0,0,6,0,6,4,MARET
SULAWESI BARAT,MAMUJU TENGAH,BUDONG-BUDONG,LEMBAH HADA,33,74,22,10,10,4,4,3,14,1,7,15,3,0,3,0,70,22,48,17,26,11,15,5,22,15,7,10,MARET
SULAWESI BARAT,MAMUJU TENGAH,TOPOYO,BUDONG-BUDONG,42,64,33,7,3,1,0,22,4,7,13,20,3,0,3,0,15,14,1,9,0,0,0,0,26,13,13,16,MARET
SULAWESI BARAT,MAMUJU TENGAH,TOPOYO,TOPOYO,81,69,57,11,0,0,0,18,2,27,32,5,9,0,9,0,29,26,3,5,16,4,12,2,30,9,21,0,MARET
SULAWESI BARAT,MAMUJU TENGAH,TOPOYO,TUMBU,78,33,0,0,0,0,0,0,0,0,0,0,2,1,1,0,11,9,2,2,5,3,2,0,21,3,18,2,MARET
SULAWESI BARAT,MAMUJU TENGAH,TOPOYO,KABUBU,70,76,31,3,3,2,0,12,12,7,14,6,4,1,3,0,44,29,15,24,0,0,0,0,24,19,5,1,MARET
SULAWESI BARAT,MAMUJU TENGAH,TOPOYO,WAEPUTEH,62,12,1,1,1,1,0,0,1,0,1,0,5,3,2,1,12,12,0,10,7,4,3,1,8,4,4,2,MARET
SULAWESI BARAT,MAMUJU TENGAH,TOPOYO,TANGKOU,51,13,13,8,7,3,3,5,3,1,7,5,4,4,0,0,10,7,3,5,5,3,2,1,7,4,3,7,MARET
SULAWESI BARAT,MAMUJU TENGAH,TOPOYO,TABOLANG,55,31,24,18,14,11,7,3,11,0,10,1,3,0,3,0,26,5,21,5,2,0,2,0,20,13,7,7,MARET
SULAWESI BARAT,MAMUJU TENGAH,TOPOYO,PARAILI,99,25,18,10,9,5,0,5,5,8,12,6,8,1,7,0,17,17,0,11,16,5,11,0,18,17,1,17,MARET
SULAWESI BARAT,MAMUJU TENGAH,TOPOYO,SALUPANGKANG,98,10,6,0,0,0,0,6,0,0,2,0,6,2,4,1,10,8,2,2,2,0,2,0,6,3,3,4,MARET
SULAWESI BARAT,MAMUJU TENGAH,TOPOYO,SALUPANGKANG IV,68,17,13,1,0,0,0,8,0,1,13,0,10,10,0,6,15,9,6,2,8,8,0,1,7,1,6,2,MARET
SULAWESI BARAT,MAMUJU TENGAH,TOPOYO,TAPPILINA,47,64,21,3,1,0,0,4,10,1,14,6,3,1,2,1,61,30,31,7,20,11,9,6,14,14,0,13,MARET
SULAWESI BARAT,MAMUJU TENGAH,TOPOYO,BAMBAMANURUNG,97,53,12,11,4,2,1,3,5,1,10,1,8,4,4,1,31,25,6,6,31,18,13,2,50,12,38,39,MARET
SULAWESI BARAT,MAMUJU TENGAH,TOPOYO,SALULEKBO,68,54,8,6,6,2,2,6,0,0,6,0,1,1,0,1,36,14,22,9,26,24,2,8,2,1,1,1,MARET
SULAWESI BARAT,MAMUJU TENGAH,TOPOYO,PANGALLOANG,50,73,13,12,3,3,1,8,1,1,12,0,6,4,2,4,20,11,9,4,3,0,3,0,39,10,29,35,MARET
SULAWESI BARAT,MAMUJU TENGAH,TOPOYO,SINABATTA,33,27,1,1,0,0,0,1,0,0,1,0,6,1,5,1,16,7,9,6,1,0,1,0,7,4,3,6,MARET
SULAWESI BARAT,MAMUJU TENGAH,KAROSSA,KAROSSA,36,37,37,26,3,2,2,17,18,0,28,9,3,0,3,0,23,16,7,10,15,13,2,1,17,9,8,11,MARET
SULAWESI BARAT,MAMUJU TENGAH,KAROSSA,TASOKKO,57,20,1,1,1,1,0,0,1,0,0,1,9,6,3,6,19,7,12,0,14,14,0,13,17,3,14,14,MARET
SULAWESI BARAT,MAMUJU TENGAH,KAROSSA,LARA,79,77,0,0,0,0,0,0,0,0,0,0,5,1,4,1,15,12,3,3,7,1,6,0,3,1,2,3,MARET
SULAWESI BARAT,MAMUJU TENGAH,KAROSSA,KADAILA,66,39,34,33,15,6,5,8,10,2,17,1,2,2,0,2,10,5,5,5,6,3,3,0,32,19,13,21,MARET
SULAWESI BARAT,MAMUJU TENGAH,KAROSSA,KAYU CALLA,33,35,9,3,0,0,0,9,0,0,6,0,2,2,0,1,18,18,0,3,13,1,12,0,37,23,14,26,MARET
SULAWESI BARAT,MAMUJU TENGAH,KAROSSA,LEMBAH HOPO,84,63,48,42,11,5,2,27,0,14,13,8,12,12,0,6,58,20,38,19,42,24,18,3,25,19,6,4,MARET
SULAWESI BARAT,MAMUJU TENGAH,KAROSSA,BENGGAULU,86,51,51,47,40,6,5,20,24,0,27,10,6,6,0,3,38,35,3,13,38,38,0,18,33,27,6,10,MARET
SULAWESI BARAT,MAMUJU TENGAH,KAROSSA,SUKA MAJU,63,41,23,10,8,7,1,9,0,13,12,3,10,0,10,0,31,16,15,14,12,4,8,3,29,8,21,2,MARET
SULAWESI BARAT,MAMUJU TENGAH,KAROSSA,KAMBUNONG,39,74,17,1,1,1,0,13,1,3,17,0,1,0,1,0,33,7,26,4,9,5,4,5,32,19,13,9,MARET
SULAWESI BARAT,MAMUJU TENGAH,KAROSSA,SALUBIRO,55,64,51,26,12,7,6,7,37,0,34,8,9,5,4,0,29,13,16,6,24,22,2,12,20,10,10,6,MARET
SULAWESI BARAT,MAMUJU TENGAH,KAROSSA,SANJANGO,99,20,12,9,2,0,0,8,4,0,6,1,4,4,0,2,15,13,2,0,1,0,1,0,8,1,7,7,MARET
SULAWESI BARAT,PASANGKAYU,BAMBAIRA,TAMPAURE,30,67,46,33,7,4,4,41,0,0,23,4,1,0,1,0,41,36,5,2,29,14,15,6,50,34,16,10,MARET
SULAWESI BARAT,PASANGKAYU,BAMBAIRA,BAMBAIRA,97,29,0,0,0,0,0,0,0,0,0,0,12,1,11,1,21,6,15,3,21,13,8,12,38,22,16,33,MARET
SULAWESI BARAT,PASANGKAYU,BAMBAIRA,KASOLOANG,59,68,59,36,16,13,2,29,18,2,27,20,7,0,7,0,11,5,6,3,2,1,1,0,28,19,9,10,MARET
SULAWESI BARAT,PASANGKAYU,BAMBAIRA,KALUKU NANGKA,58,22,12,5,4,1,0,0,11,1,1,2,6,6,0,6,22,15,7,0,20,9,11,0,25,20,5,2,MARET
SULAWESI BARAT,PASANGKAYU,BAMBALAMOTU,RANDOMAYANG,75,42,15,12,1,1,0,0,4,7,15,0,12,12,0,2,23,22,1,14,6,1,5,0,8,8,0,5,MARET
SULAWESI BARAT,PASANGKAYU,BAMBALAMOTU,BAMBALAMOTU,94,19,7,0,0,0,0,4,3,0,0,4,3,3,0,0,18,6,12,5,18,7,11,3,31,10,21,19,MARET
SULAWESI BARAT,PASANGKAYU,BAMBALAMOTU,POLEWALI,51,56,11,4,2,1,0,6,1,0,5,0,9,7,2,2,41,33,8,22,16,8,8,6,5,3,2,1,MARET
SULAWESI BARAT,PASANGKAYU,BAMBALAMOTU,PANGIANG,90,36,36,17,11,4,1,10,17,0,21,0,6,0,6,0,32,8,24,0,32,25,7,0,53,18,35,43,MARET
SULAWESI BARAT,PASANGKAYU,BAMBALAMOTU,KALOLA,71,59,21,9,8,8,0,6,6,0,11,9,7,5,2,0,43,24,19,10,11,9,2,6,29,4,25,1,MARET
SULAWESI BARAT,PASANGKAYU,BAMBALAMOTU,WULAI,49,47,45,10,4,3,0,31,3,6,17,23,5,1,4,0,16,7,9,5,11,8,3,4,2,2,0,0,MARET
SULAWESI BARAT,PASANGKAYU,BARAS,BARAS,40,51,32,22,15,8,6,16,0,5,19,0,6,2,4,1,18,11,7,4,12,11,1,9,30,11,19,18,MARET
SULAWESI BARAT,PASANGKAYU,BARAS,BULU PARIGI,43,59,59,1,0,0,0,52,0,6,36,1,0,0,0,0,52,26,26,4,10,8,2,1,4,1,3,2,MARET
SULAWESI BARAT,PASANGKAYU,BARAS,BALANTI,61,73,6,3,0,0,0,2,2,0,4,0,9,4,5,3,30,22,8,14,30,30,0,28,29,8,21,24,MARET
SULAWESI BARAT,PASANGKAYU,BARAS,MOTU,71,72,2,0,0,0,0,0,2,0,0,1,0,0,0,0,49,31,18,15,29,8,21,7,74,74,0,42,MARET
SULAWESI BARAT,PASANGKAYU,BARAS,TOWONI,80,80,13,12,0,0,0,3,3,5,13,0,7,2,5,1,76,45,31,12,41,27,14,12,82,19,63,53,MARET
SULAWESI BARAT,PASANGKAYU,BARAS,KASANO,45,37,5,3,0,0,0,0,3,1,2,1,5,0,5,0,14,6,8,0,4,1,3,0,10,2,8,1,MARET
SULAWESI BARAT,PASANGKAYU,BULU TABA,SUMBER SARI,89,71,22,20,17,11,11,1,9,0,18,0,3,1,2,0,37,13,24,7,5,4,1,2,18,13,5,7,MARET
SULAWESI BARAT,PASANGKAYU,BULU TABA,LELEJAE,82,32,21,10,9,3,2,17,2,0,4,17,8,2,6,2,26,21,5,14,11,10,1,0,13,0,13,6,MARET
SULAWESI BARAT,PASANGKAYU,BULU TABA,BUKIT HARAPAN,73,12,12,11,8,1,1,7,1,3,12,0,11,10,1,2,11,11,0,5,2,0,2,0,6,3,3,2,MARET
SULAWESI BARAT,PASANGKAYU,BULU TABA,LILIMORI,90,28,25,21,1,1,0,20,4,0,21,1,12,1,11,0,24,11,13,1,11,3,8,1,16,11,5,11,MARET
SULAWESI BARAT,PASANGKAYU,BULU TABA,KARAVE,48,41,32,4,4,2,1,26,0,5,32,0,5,5,0,2,22,18,4,12,0,0,0,0,22,15,7,5,MARET
SULAWESI BARAT,PASANGKAYU,BULU TABA,KASTABUANA,55,80,33,5,0,0,0,29,4,0,33,0,11,1,10,0,15,11,4,5,2,0,2,0,39,27,12,1,MARET
SULAWESI BARAT,PASANGKAYU,BULU TABA,OMPI,81,21,11,11,5,3,2,3,6,0,5,1,4,1,3,1,12,8,4,3,2,1,1,0,1,1,0,0,MARET
SULAWESI BARAT,PASANGKAYU,DAPURANG,DAPURANG,30,59,21,18,8,6,2,4,12,3,14,7,5,0,5,0,23,5,18,5,20,16,4,2,37,33,4,9,MARET
SULAWESI BARAT,PASANGKAYU,DAPURANG,BENGGAULU,30,58,41,36,10,7,2,10,19,9,30,4,4,0,4,0,42,13,29,12,7,6,1,2,21,9,12,14,MARET
SULAWESI BARAT,PASANGKAYU,DAPURANG,TIRTABUANA,73,72,22,10,10,1,0,16,4,0,19,0,2,2,0,2,40,33,7,21,21,3,18,2,68,14,54,67,MARET
SULAWESI BARAT,PASANGKAYU,DAPURANG,BULU BONGGU,30,65,35,28,13,7,7,5,9,9,23,11,6,1,5,0,20,5,15,0,1,0,1,0,0,0,0,0,MARET
SULAWESI BARAT,PASANGKAYU,DAPURANG,SARASA,93,11,8,7,1,0,0,6,1,1,2,5,0,0,0,0,10,10,0,1,5,1,4,1,6,0,6,6,MARET
SULAWESI BARAT,PASANGKAYU,DURIPOKU,TAMMARUNANG,83,28,5,3,0,0,0,5,0,0,5,0,15,0,15,0,13,11,2,1,7,1,6,0,19,11,8,17,MARET
SULAWESI BARAT,PASANGKAYU,DURIPOKU,SAPTANAJAYA,85,32,23,17,11,5,4,3,0,7,20,3,3,1,2,1,32,30,2,6,4,2,2,1,26,4,22,20,MARET
SULAWESI BARAT,PASANGKAYU,DURIPOKU,TARANGGI,37,22,18,0,0,0,0,4,3,7,16,1,1,0,1,0,14,8,6,1,0,0,0,0,13,12,1,9,MARET
SULAWESI BARAT,PASANGKAYU,DURIPOKU,SIPAKAINGA,43,18,13,6,2,0,0,4,8,0,13,0,2,2,0,2,12,9,3,2,12,12,0,6,14,11,3,8,MARET
SULAWESI BARAT,PASANGKAYU,LARIANG,KULU,75,25,1,0,0,0,0,0,0,0,1,0,1,0,1,0,22,19,3,17,16,12,4,4,14,12,2,6,MARET
SULAWESI BARAT,PASANGKAYU,LARIANG,PARABU,65,19,8,4,2,1,0,0,2,3,4,4,12,9,3,8,19,19,0,13,14,14,0,0,13,0,13,12,MARET
SULAWESI BARAT,PASANGKAYU,LARIANG,KENANGAN,82,70,57,34,11,3,2,10,21,24,57,0,6,4,2,2,55,27,28,19,10,1,9,1,24,5,19,2,MARET
SULAWESI BARAT,PASANGKAYU,LARIANG,BAJAWALI,36,36,34,6,0,0,0,1,15,8,1,13,6,5,1,0,22,19,3,13,10,9,1,4,5,5,0,5,MARET
SULAWESI BARAT,PASANGKAYU,LARIANG,SINGGANI,75,62,19,9,1,1,1,0,16,2,2,7,1,1,0,0,39,17,22,3,29,29,0,0,43,13,30,24,MARET
SULAWESI BARAT,PASANGKAYU,LARIANG,BATU MATORU,76,21,16,7,3,0,0,0,16,0,8,0,14,2,12,2,13,9,4,9,2,1,1,1,2,0,2,1,MARET
SULAWESI BARAT,PASANGKAYU,LARIANG,BAMBAKORO,38,54,25,8,5,0,0,14,2,2,8,15,4,2,2,2,10,9,1,4,2,1,1,0,17,9,8,15,MARET
SULAWESI BARAT,PASANGKAYU,PASANGKAYU,KARYA BERSAMA,65,14,3,2,2,1,0,1,2,0,3,0,2,1,1,0,13,13,0,10,9,3,6,0,14,6,8,2,MARET
SULAWESI BARAT,PASANGKAYU,PASANGKAYU,AKO,48,39,25,11,1,1,0,21,3,0,8,5,0,0,0,0,35,26,9,20,23,5,18,1,20,6,14,8,MARET
SULAWESI BARAT,PASANGKAYU,PASANGKAYU,PASANGKAYU,74,44,8,3,2,0,0,8,0,0,2,1,2,1,1,0,25,25,0,8,2,2,0,0,19,12,7,5,MARET
SULAWESI BARAT,PASANGKAYU,PASANGKAYU,MARTAJAYA,97,11,4,3,1,1,0,2,2,0,0,3,12,7,5,7,10,5,5,2,7,2,5,1,12,7,5,2,MARET
SULAWESI BARAT,PASANGKAYU,PASANGKAYU,PAKAVA,47,57,31,30,4,3,2,29,0,0,21,2,5,4,1,0,51,6,45,6,43,29,14,26,48,29,19,28,MARET
SULAWESI BARAT,PASANGKAYU,PASANGKAYU,GUNUNG SARI,59,23,8,7,3,0,0,0,7,0,1,3,3,0,3,0,19,6,13,6,3,3,0,1,0,0,0,0,MARET
SULAWESI BARAT,PASANGKAYU,PEDONGGA,MALEI,47,32,7,1,0,0,0,3,3,0,5,1,0,0,0,0,24,7,17,6,13,4,9,4,7,0,7,1,MARET
SULAWESI BARAT,PASANGKAYU,PEDONGGA,PEDANDA,92,38,7,7,2,1,1,5,0,0,1,4,3,2,1,0,27,22,5,12,22,16,6,10,46,13,33,34,MARET
SULAWESI BARAT,PASANGKAYU,PEDONGGA,BATU OGE,36,40,20,18,13,0,0,3,11,4,19,0,5,3,2,3,28,8,20,7,16,7,9,0,11,11,0,7,MARET
SULAWESI BARAT,PASANGKAYU,PEDONGGA,MARTASARI,68,59,51,8,4,1,0,28,13,1,16,0,9,1,8,1,44,10,34,2,13,7,6,4,4,4,0,2,MARET
SULAWESI BARAT,PASANGKAYU,SARJO,SARJO,57,52,6,2,0,0,0,1,2,0,1,1,4,2,2,2,34,25,9,20,3,2,1,1,30,19,11,14,MARET
SULAWESI BARAT,PASANGKAYU,SARJO,MAPONU,89,73,28,28,1,1,1,5,10,7,27,0,0,0,0,0,28,26,2,15,12,3,9,0,59,7,52,38,MARET
SULAWESI BARAT,PASANGKAYU,SARJO,LETAWA,89,21,8,3,0,0,0,7,1,0,2,1,3,3,0,1,21,21,0,10,3,0,3,0,4,0,4,1,MARET
SULAWESI BARAT,PASANGKAYU,SARJO,SARUDE,32,74,58,8,7,4,1,28,4,11,41,12,4,0,4,0,20,11,9,2,19,10,9,0,46,10,36,8,MARET
SULAWESI BARAT,PASANGKAYU,SARUDU,DODA,62,36,0,0,0,0,0,0,0,0,0,0,10,6,4,2,19,17,2,16,12,9,3,4,20,19,1,5,MARET
SULAWESI BARAT,PASANGKAYU,SARUDU,SARUDU,75,53,45,38,10,2,2,37,6,0,26,9,11,2,9,1,31,29,2,3,23,13,10,7,54,34,20,14,MARET
SULAWESI BARAT,PASANGKAYU,SARUDU,BULU MARIO,68,58,16,4,4,3,0,2,5,8,13,1,0,0,0,0,36,28,8,4,4,2,2,2,1,1,0,0,MARET
SULAWESI BARAT,PASANGKAYU,SARUDU,KUMASARI,99,11,4,0,0,0,0,1,1,0,3,0,16,0,16,0,10,9,1,9,4,0,4,0,9,0,9,2,MARET
SULAWESI BARAT,PASANGKAYU,SARUDU,PATIKA,87,25,25,23,20,10,4,13,6,2,19,5,4,1,3,0,11,5,6,5,4,0,4,0,10,9,1,2,MARET
SULAWESI BARAT,PASANGKAYU,TIKKE RAYA,MAKMUR JAYA,83,48,28,19,1,1,0,12,3,4,17,4,11,8,3,8,19,17,2,13,19,1,18,0,48,39,9,39,MARET
SULAWESI BARAT,PASANGKAYU,TIKKE RAYA,LARIANG,97,79,19,11,2,2,0,15,1,0,18,0,2,1,1,0,36,29,7,7,31,4,27,2,17,6,11,13,MARET
SULAWESI BARAT,PASANGKAYU,TIKKE RAYA,TIKKE,46,70,69,37,13,9,5,6,52,2,66,1,7,2,5,1,10,8,2,6,5,2,3,1,25,1,24,13,MARET
SULAWESI BARAT,PASANGKAYU,TIKKE RAYA,PAJALELE,90,54,15,6,6,3,2,8,4,1,4,10,16,11,5,5,23,5,18,4,4,4,0,3,29,7,22,14,MARET
SULAWESI BARAT,PASANGKAYU,TIKKE RAYA,JENGENG RAYA,73,59,27,25,0,0,0,0,12,3,6,8,3,1,2,0,59,44,15,15,12,12,0,3,46,31,15,13,MARET
SULAWESI BARAT,MAJENE,BANGGAE,BANGGAE,48,24,5,2,0,0,0,4,0,0,3,0,8,3,5,1,14,9,5,6,2,2,0,2,18,10,8,17,MARET
SULAWESI BARAT,MAJENE,BANGGAE,BARU,32,25,25,9,6,2,2,22,0,1,17,5,1,0,1,0,10,6,4,2,5,5,0,5,1,0,1,1,MARET
SULAWESI BARAT,MAJENE,BANGGAE,PANGALI ALI,53,36,30,6,1,1,1,3,20,3,4,2,6,2,4,1,27,9,18,6,25,20,5,19,45,38,7,0,MARET
SULAWESI BARAT,MAJENE,BANGGAE,TOTOLI,74,42,39,19,11,11,6,8,6,17,0,6,9,2,7,1,26,9,17,1,21,5,16,3,39,15,24,32,MARET
SULAWESI BARAT,MAJENE,BANGGAE,RANGAS,86,38,31,27,12,10,4,0,8,6,0,6,6,5,1,1,23,13,10,0,23,13,10,0,35,21,14,26,MARET
SULAWESI BARAT,MAJENE,BANGGAE,GALUNG,36,66,51,23,9,9,8,8,4,4,46,4,3,1,2,0,52,51,1,51,38,35,3,24,47,25,22,42,MARET
SULAWESI BARAT,MAJENE,BANGGAE,PALIPI SOREANG,99,11,10,0,0,0,0,3,0,2,5,4,2,2,0,1,10,9,1,1,1,0,1,0,6,0,6,2,MARET
SULAWESI BARAT,MAJENE,BANGGAE,PAMBOBORANG,78,24,6,1,0,0,0,0,6,0,3,2,2,1,1,0,23,11,12,11,23,6,17,1,9,9,0,1,MARET
SULAWESI BARAT,MAJENE,BANGGAE TIMUR,BAURUNG,38,21,21,19,7,5,3,0,2,10,13,4,4,1,3,0,10,5,5,2,6,3,3,0,13,4,9,3,MARET
SULAWESI BARAT,MAJENE,BANGGAE TIMUR,BARUGA,36,12,8,2,2,1,0,0,3,4,7,0,4,4,0,1,11,5,6,2,3,2,1,1,7,6,1,6,MARET
SULAWESI BARAT,MAJENE,BANGGAE TIMUR,BARUGA DHUA,98,51,11,11,2,2,1,3,0,2,3,6,15,12,3,9,49,40,9,10,27,4,23,4,10,9,1,8,MARET
SULAWESI BARAT,MAJENE,BANGGAE TIMUR,LABUANG,58,80,26,7,5,0,0,23,0,2,3,23,6,3,3,1,66,63,3,53,43,43,0,9,45,29,16,27,MARET
SULAWESI BARAT,MAJENE,BANGGAE TIMUR,TANDE,69,59,6,1,1,0,0,0,5,0,3,3,3,2,1,1,40,29,11,5,7,4,3,1,12,12,0,9,MARET
SULAWESI BARAT,MAJENE,BANGGAE TIMUR,LEMBANG,89,53,45,44,18,0,0,0,23,18,3,38,2,0,2,0,35,30,5,21,4,0,4,0,23,1,22,2,MARET
SULAWESI BARAT,MAJENE,BANGGAE TIMUR,LABUANG UTARA,54,69,6,6,3,2,0,2,0,0,5,0,7,4,3,3,55,12,43,6,34,20,14,6,15,0,15,9,MARET
SULAWESI BARAT,MAJENE,BANGGAE TIMUR,TANDE TIMUR,95,19,8,1,1,0,0,5,3,0,0,8,15,15,0,15,13,13,0,3,11,5,6,4,4,1,3,3,MARET
SULAWESI BARAT,MAJENE,BANGGAE TIMUR,BUTTU BARUGA,78,39,6,5,4,2,1,2,2,1,5,0,0,0,0,0,23,5,18,2,8,6,2,3,13,11,2,4,MARET
SULAWESI BARAT,MAJENE,MALUNDA,MALUNDA,88,39,12,7,1,1,1,4,0,4,5,4,2,2,0,1,25,21,4,0,10,3,7,1,2,1,1,2,MARET
SULAWESI BARAT,MAJENE,MALUNDA,LAMUNGANG BATU,81,73,23,11,0,0,0,1,21,1,20,0,1,1,0,0,11,9,2,0,6,5,1,1,16,10,6,6,MARET
SULAWESI BARAT,MAJENE,MALUNDA,BAMBANGAN,36,45,42,8,3,3,3,5,22,2,30,8,6,3,3,0,45,39,6,35,0,0,0,0,5,3,2,5,MARET
SULAWESI BARAT,MAJENE,MALUNDA,LOMBANG,64,34,19,12,9,3,2,1,11,5,12,0,9,8,1,2,27,9,18,1,10,2,8,2,9,1,8,4,MARET
SULAWESI BARAT,MAJENE,MALUNDA,LOMBONG,100,29,16,6,1,0,0,0,0,11,4,9,15,7,8,0,21,7,14,3,15,9,6,4,34,32,2,11,MARET
SULAWESI BARAT,MAJENE,MALUNDA,MEKKATTA,79,79,1,0,0,0,0,1,0,0,0,1,12,8,4,8,48,46,2,4,33,33,0,15,4,1,3,3,MARET
SULAWESI BARAT,MAJENE,MALUNDA,MALIAYA,74,59,28,23,18,2,0,22,3,3,8,6,12,5,7,5,31,14,17,13,15,3,12,2,54,10,44,21,MARET
SULAWESI BARAT,MAJENE,MALUNDA,LOMBANG TIMUR,80,27,21,21,12,3,3,10,1,4,10,7,15,1,14,1,13,12,1,11,10,8,2,5,25,0,25,2,MARET
SULAWESI BARAT,MAJENE,MALUNDA,SALUTAHONGAN,92,66,52,34,33,33,33,16,1,2,16,1,9,2,7,0,61,21,40,15,26,4,22,4,9,3,6,5,MARET
SULAWESI BARAT,MAJENE,MALUNDA,LOMBONG TIMUR,91,62,40,31,2,0,0,39,1,0,23,0,16,4,12,4,42,29,13,0,33,28,5,24,53,2,51,48,MARET
SULAWESI BARAT,MAJENE,MALUNDA,MEKKATTA SELATAN,32,10,1,0,0,0,0,1,0,0,1,0,6,2,4,1,10,8,2,8,6,0,6,0,7,5,2,1,MARET
SULAWESI BARAT,MAJENE,MALUNDA,KAYUANGIN,58,27,20,15,10,3,0,5,2,2,0,0,0,0,0,0,25,15,10,5,8,3,5,1,3,1,2,0,MARET
SULAWESI BARAT,MAJENE,PAMBOANG,LALAMPANUA,64,43,1,0,0,0,0,1,0,0,1,0,1,1,0,0,22,19,3,6,1,1,0,1,10,6,4,10,MARET
SULAWESI BARAT,MAJENE,PAMBOANG,SIRINDU,92,34,14,7,5,1,0,9,4,1,6,7,7,4,3,1,30,23,7,18,3,2,1,2,21,6,15,6,MARET
SULAWESI BARAT,MAJENE,PAMBOANG,ADOLANG,78,67,2,0,0,0,0,0,1,1,0,1,12,10,2,0,15,10,5,6,0,0,0,0,19,13,6,1,MARET
SULAWESI BARAT,MAJENE,PAMBOANG,BABABULO,68,78,12,6,0,0,0,1,0,8,8,1,11,6,5,3,28,5,23,1,9,2,7,0,27,26,1,9,MARET
SULAWESI BARAT,MAJENE,PAMBOANG,BONDE,84,44,18,0,0,0,0,6,9,0,15,1,8,6,2,5,20,5,15,3,8,2,6,1,6,4,2,6,MARET
SULAWESI BARAT,MAJENE,PAMBOANG,BETTENG,68,13,0,0,0,0,0,0,0,0,0,0,1,1,0,0,10,8,2,6,3,0,3,0,10,7,3,9,MARET
SULAWESI BARAT,MAJENE,PAMBOANG,SIMBANG,49,21,6,4,3,0,0,5,0,0,5,1,3,2,1,1,19,7,12,0,3,2,1,2,5,4,1,1,MARET
SULAWESI BARAT,MAJENE,PAMBOANG,BONDE UTARA,100,42,18,7,0,0,0,8,8,0,5,8,16,0,16,0,38,11,27,2,14,3,11,2,25,25,0,0,MARET
SULAWESI BARAT,MAJENE,PAMBOANG,BABABULO UTARA,52,13,4,1,1,1,1,1,0,2,1,2,1,0,1,0,12,6,6,0,6,4,2,0,14,8,6,12,MARET
SULAWESI BARAT,MAJENE,PAMBOANG,BUTTU PAMBOANG,40,32,6,2,0,0,0,5,0,1,6,0,1,1,0,0,13,7,6,3,13,9,4,9,26,8,18,13,MARET
SULAWESI BARAT,MAJENE,PAMBOANG,BANUA ADOLANG,37,58,37,19,1,1,0,13,16,2,35,0,0,0,0,0,44,30,14,19,32,5,27,2,64,34,30,57,MARET
SULAWESI BARAT,MAJENE,PAMBOANG,ADOLANG DHUA,63,43,9,1,1,1,0,9,0,0,8,1,11,3,8,3,33,7,26,5,30,22,8,3,17,3,14,6,MARET
SULAWESI BARAT,MAJENE,PAMBOANG,TINAMBUNG,67,42,14,12,11,6,6,5,1,1,2,4,1,0,1,0,29,8,21,0,15,13,2,9,23,13,10,16,MARET
SULAWESI BARAT,MAJENE,PAMBOANG,PESULOANG,68,23,9,0,0,0,0,9,0,0,1,7,6,5,1,3,19,16,3,13,10,7,3,2,5,0,5,2,MARET
SULAWESI BARAT,MAJENE,PAMBOANG,BALOMBONG,35,46,1,1,0,0,0,0,1,0,1,0,2,1,1,1,45,31,14,14,15,15,0,1,47,2,45,19,MARET
SULAWESI BARAT,MAJENE,SENDANA,MOSSO,77,37,21,2,0,0,0,1,14,2,13,6,6,1,5,1,35,13,22,4,25,5,20,1,22,21,1,7,MARET
SULAWESI BARAT,MAJENE,SENDANA,MOSSO DHUA,83,67,10,0,0,0,0,9,0,0,8,2,16,12,4,5,21,20,1,15,6,5,1,2,17,12,5,12,MARET
SULAWESI BARAT,MAJENE,SENDANA,TOTOLISI SENDANA,82,50,1,1,0,0,0,0,0,0,0,1,0,0,0,0,49,28,21,26,24,10,14,7,52,3,49,2,MARET
SULAWESI BARAT,MAJENE,SENDANA,TALLUBANUA,40,47,37,14,9,2,2,19,13,1,8,22,5,0,5,0,38,38,0,17,30,0,30,0,7,1,6,0,MARET
SULAWESI BARAT,MAJENE,SENDANA,LALATEDZONG,70,56,16,8,1,0,0,6,2,2,10,2,3,1,2,0,49,10,39,5,30,8,22,3,7,3,4,7,MARET
SULAWESI BARAT,MAJENE,SENDANA,BINANGA,70,10,8,7,4,3,2,6,0,0,5,3,9,0,9,0,10,8,2,4,1,0,1,0,0,0,0,0,MARET
SULAWESI BARAT,MAJENE,SENDANA,PUTTADA,68,47,14,4,3,2,2,12,0,0,2,4,10,7,3,5,15,13,2,11,7,6,1,2,4,4,0,3,MARET
SULAWESI BARAT,MAJENE,SENDANA,PAMINGGALAN,54,55,48,44,17,14,1,18,23,0,15,22,9,2,7,0,11,5,6,5,8,3,5,0,30,23,7,8,MARET
SULAWESI BARAT,MAJENE,SENDANA,LEPPANGANG,88,58,3,3,1,0,0,0,3,0,2,0,13,12,1,6,22,11,11,2,13,9,4,9,17,0,17,4,MARET
SULAWESI BARAT,MAJENE,SENDANA,PUNDAU,50,78,23,16,14,0,0,12,10,1,3,1,0,0,0,0,32,5,27,2,31,6,25,1,27,13,14,22,MARET
SULAWESI BARAT,MAJENE,SENDANA,SENDANA,49,55,16,13,11,2,0,15,0,0,0,6,0,0,0,0,43,12,31,6,20,0,20,0,35,20,15,9,MARET
SULAWESI BARAT,MAJENE,SENDANA,BANUA SENDANA,64,75,29,21,4,2,1,0,19,8,24,3,1,1,0,0,37,30,7,26,16,2,14,1,46,12,34,46,MARET
SULAWESI BARAT,MAJENE,SENDANA,TALLUBANUA UTARA,44,10,7,7,7,7,4,0,1,2,1,2,3,3,0,0,10,9,1,4,9,6,3,0,2,2,0,1,MARET
SULAWESI BARAT,MAJENE,SENDANA,LIMBORO RAMBU-RAMBU,69,26,20,5,3,2,1,15,4,0,2,4,12,6,6,2,17,16,1,7,17,15,2,14,31,30,1,3,MARET
SULAWESI BARAT,MAJENE,SENDANA,LIMBUA,91,56,20,8,3,1,1,15,3,1,10,6,4,3,1,0,30,23,7,10,24,5,19,1,48,48,0,22,MARET
SULAWESI BARAT,MAJENE,SENDANA,BUKIT SAMANG,100,54,13,9,0,0,0,7,5,1,3,0,20,14,6,4,18,12,6,6,5,5,0,1,40,25,15,13,MARET
SULAWESI BARAT,MAJENE,TAMMERODO SENDANA,SEPPONG,87,75,46,24,4,3,0,21,1,1,26,0,11,11,0,6,50,12,38,5,19,2,17,0,37,13,24,24,MARET
SULAWESI BARAT,MAJENE,TAMMERODO SENDANA,TAMMERODO,90,71,62,52,44,13,6,41,0,11,2,59,15,10,5,1,25,20,5,4,11,11,0,1,21,21,0,17,MARET
SULAWESI BARAT,MAJENE,TAMMERODO SENDANA,ULIDANG,97,11,7,4,0,0,0,6,1,0,4,3,17,4,13,4,11,5,6,3,4,1,3,1,2,2,0,1,MARET
SULAWESI BARAT,MAJENE,TAMMERODO SENDANA,TALLAMBALAO,47,49,18,7,4,2,0,11,5,0,16,0,8,3,5,3,33,8,25,2,26,6,20,4,7,0,7,4,MARET
SULAWESI BARAT,MAJENE,TAMMERODO SENDANA,TAMMERODO UTARA,58,64,58,57,38,19,2,22,11,19,36,9,9,7,2,4,40,31,9,30,14,14,0,9,9,0,9,0,MARET
SULAWESI BARAT,MAJENE,TAMMERODO SENDANA,MANYAMBA,70,22,16,1,1,0,0,7,5,0,14,2,2,2,0,1,17,8,9,8,8,1,7,1,21,14,7,19,MARET
SULAWESI BARAT,MAJENE,TAMMERODO SENDANA,AWO,84,65,28,19,9,1,1,4,19,2,0,9,6,6,0,0,63,28,35,2,17,15,2,13,36,0,36,4,MARET
SULAWESI BARAT,MAJENE,TUBO SENDANA,ONANG,89,61,9,8,4,4,3,6,0,0,7,2,2,0,2,0,47,23,24,17,33,1,32,0,59,39,20,7,MARET
SULAWESI BARAT,MAJENE,TUBO SENDANA,TUBO,81,22,7,6,2,0,0,2,0,1,6,0,15,14,1,7,10,5,5,2,4,3,1,0,12,11,1,8,MARET
SULAWESI BARAT,MAJENE,TUBO SENDANA,ONANG UTARA,88,30,1,0,0,0,0,0,1,0,0,1,5,0,5,0,10,8,2,4,1,0,1,0,7,3,4,0,MARET
SULAWESI BARAT,MAJENE,TUBO SENDANA,TUBO SELATAN,95,49,0,0,0,0,0,0,0,0,0,0,11,8,3,5,17,15,2,4,17,11,6,8,33,23,10,11,MARET
SULAWESI BARAT,MAJENE,TUBO SENDANA,BONDE BONDE,91,47,42,28,7,1,1,37,3,0,5,7,2,0,2,0,13,5,8,0,1,0,1,0,4,3,1,0,MARET
SULAWESI BARAT,MAJENE,TUBO SENDANA,TUBO TENGAH,85,53,34,19,12,5,5,14,2,11,32,0,3,1,2,1,32,29,3,28,26,1,25,0,23,0,23,0,MARET
SULAWESI BARAT,MAJENE,TUBO SENDANA,TUBO POANG,74,25,3,0,0,0,0,1,2,0,1,0,14,0,14,0,18,6,12,6,9,5,4,0,19,15,4,7,MARET
SULAWESI BARAT,MAJENE,ULUMANDA,KABIRAAN,82,53,47,27,4,3,3,20,11,1,38,4,5,2,3,1,50,39,11,15,10,2,8,0,21,7,14,10,MARET
SULAWESI BARAT,MAJENE,ULUMANDA,SAMBABO,64,43,22,20,18,4,3,11,2,2,13,7,5,3,2,0,27,11,16,6,12,2,10,2,18,12,6,2,MARET
SULAWESI BARAT,MAJENE,ULUMANDA,TANDEALLO,44,72,10,1,1,1,0,10,0,0,8,2,7,3,4,0,48,26,22,3,46,26,20,24,17,8,9,11,MARET
SULAWESI BARAT,MAJENE,ULUMANDA,ULUMANDA,32,49,39,23,7,7,7,28,4,0,39,0,5,3,2,1,23,18,5,7,12,5,7,1,43,43,0,17,MARET
SULAWESI BARAT,MAJENE,ULUMANDA,SALUTAMBUNG,45,57,44,40,40,3,2,34,3,2,15,1,7,3,4,0,27,18,9,13,6,5,1,1,26,24,2,1,MARET
SULAWESI BARAT,MAJENE,ULUMANDA,POPENGA,30,77,41,40,16,14,0,4,36,1,18,18,5,2,3,2,58,46,12,34,29,11,18,11,65,42,23,38,MARET
SULAWESI BARAT,MAJENE,ULUMANDA,SULAI,76,61,51,18,0,0,0,47,2,1,49,2,1,1,0,0,50,26,24,12,5,1,4,1,37,34,3,1,MARET
SULAWESI BARAT,MAJENE,ULUMANDA,PANGGALO,53,73,46,17,12,0,0,40,5,0,6,13,1,1,0,0,30,10,20,2,17,13,4,8,59,59,0,3,MARET
SULAWESI BARAT,MAMASA,ARALLE,ARALLE,41,67,58,4,1,0,0,51,6,1,50,1,0,0,0,0,66,53,13,21,55,39,16,5,18,4,14,8,MARET
SULAWESI BARAT,MAMASA,ARALLE,RALLE ANAK,49,43,15,0,0,0,0,12,0,1,6,2,4,2,2,2,19,12,7,7,9,3,6,1,4,2,2,1,MARET
SULAWESI BARAT,MAMASA,ARALLE,PANETEAN,72,50,6,5,0,0,0,5,1,0,5,0,0,0,0,0,10,5,5,1,0,0,0,0,28,5,23,13,MARET
SULAWESI BARAT,MAMASA,ARALLE,UHAILANU,86,49,38,24,0,0,0,23,12,2,18,14,17,1,16,1,43,38,5,16,40,7,33,3,60,60,0,9,MARET
SULAWESI BARAT,MAMASA,ARALLE,ARALLE UTARA,94,46,40,20,11,10,4,1,9,6,34,5,0,0,0,0,36,9,27,3,16,14,2,1,43,13,30,20,MARET
SULAWESI BARAT,MAMASA,ARALLE,UHAIDAHO,49,16,12,9,9,0,0,10,0,2,4,6,2,0,2,0,15,5,10,0,8,0,8,0,4,1,3,2,MARET
SULAWESI BARAT,MAMASA,ARALLE,BARURU,68,59,12,9,9,2,0,6,6,0,10,2,11,3,8,2,12,8,4,8,2,2,0,0,17,7,10,5,MARET
SULAWESI BARAT,MAMASA,ARALLE,RALLEANAK UTARA,58,36,12,0,0,0,0,6,6,0,8,3,8,5,3,2,15,12,3,8,13,9,4,0,27,15,12,0,MARET
SULAWESI BARAT,MAMASA,ARALLE,PAMOSEANG PANGGA,73,78,52,10,9,4,4,16,9,3,32,6,11,7,4,7,18,7,11,0,10,0,10,0,30,29,1,8,MARET
SULAWESI BARAT,MAMASA,ARALLE,KALABE,47,42,18,10,7,7,7,5,3,0,0,7,1,0,1,0,41,10,31,4,1,0,1,0,23,3,20,20,MARET
SULAWESI BARAT,MAMASA,ARALLE,ARALLE SELATAN,39,54,23,17,13,0,0,18,0,1,4,13,1,1,0,1,20,14,6,10,18,1,17,1,10,5,5,7,MARET
SULAWESI BARAT,MAMASA,ARALLE,HAHANGAN,60,77,46,17,0,0,0,11,10,11,11,33,9,1,8,1,31,9,22,2,27,16,11,16,41,3,38,31,MARET
SULAWESI BARAT,MAMASA,BALLA,BALLA,80,13,11,4,1,1,1,6,0,2,3,6,14,4,10,4,13,9,4,1,12,6,6,0,10,7,3,4,MARET
SULAWESI BARAT,MAMASA,BALLA,BALLA BARAT,40,75,68,3,3,1,1,9,15,22,18,11,3,1,2,0,53,43,10,32,46,36,10,12,25,12,13,17,MARET
SULAWESI BARAT,MAMASA,BALLA,BALLA SATANETEAN,43,41,30,16,16,0,0,14,6,7,21,7,1,1,0,1,24,8,16,1,1,0,1,0,20,5,15,4,MARET
SULAWESI BARAT,MAMASA,BALLA,BALLA TUMUKA,46,26,21,20,19,5,1,8,6,4,7,2,2,2,0,0,15,12,3,7,11,5,6,0,17,15,2,2,MARET
SULAWESI BARAT,MAMASA,BALLA,SEPAKUAN,63,39,1,1,1,0,0,1,0,0,0,0,8,5,3,4,25,20,5,15,0,0,0,0,5,0,5,0,MARET
SULAWESI BARAT,MAMASA,BALLA,PIDARA,83,58,35,21,3,3,2,22,9,0,11,17,12,12,0,10,25,19,6,2,19,7,12,1,4,1,3,1,MARET
SULAWESI BARAT,MAMASA,BALLA,BAMBAPUANG,47,57,37,12,10,3,2,11,4,9,0,21,0,0,0,0,15,8,7,1,2,2,0,1,8,4,4,5,MARET
SULAWESI BARAT,MAMASA,BALLA,BALLA TIMUR,42,44,38,16,5,3,2,24,3,4,5,13,3,0,3,0,42,17,25,1,9,4,5,3,30,18,12,28,MARET
SULAWESI BARAT,MAMASA,BAMBANG,MOKALLANG,33,70,1,1,0,0,0,1,0,0,1,0,6,0,6,0,53,22,31,20,22,11,11,1,0,0,0,0,MARET
SULAWESI BARAT,MAMASA,BAMBANG,MASOSO,62,79,66,51,44,16,16,8,36,6,12,0,4,0,4,0,52,48,4,27,14,14,0,14,17,7,10,6,MARET
SULAWESI BARAT,MAMASA,BAMBANG,SALUASSING,95,41,3,1,1,1,1,0,2,0,2,0,14,3,11,2,33,22,11,13,17,6,11,6,4,2,2,4,MARET
SULAWESI BARAT,MAMASA,BAMBANG,SALUBULO,78,20,7,6,0,0,0,7,0,0,2,3,3,3,0,1,16,5,11,2,4,2,2,1,12,3,9,9,MARET
SULAWESI BARAT,MAMASA,BAMBANG,SALUKADI,71,49,49,19,0,0,0,22,9,15,48,0,11,8,3,8,39,27,12,18,4,4,0,0,22,7,15,18,MARET
SULAWESI BARAT,MAMASA,BAMBANG,SALUKEPOPOK,34,44,10,2,2,1,0,0,1,1,3,1,5,5,0,5,31,20,11,0,8,0,8,0,11,7,4,1,MARET
SULAWESI BARAT,MAMASA,BAMBANG,ULUMAMBI BARAT,92,55,32,8,6,2,1,8,21,2,27,0,16,6,10,1,11,5,6,1,3,0,3,0,40,39,1,27,MARET
SULAWESI BARAT,MAMASA,BAMBANG,LIMBADEBATA,34,17,13,5,2,1,1,3,3,5,9,4,0,0,0,0,10,6,4,1,7,6,1,2,13,3,10,13,MARET
SULAWESI BARAT,MAMASA,BAMBANG,TANETE TOMBA,39,66,32,1,0,0,0,21,11,0,15,7,5,0,5,0,21,7,14,4,4,1,3,0,11,9,2,3,MARET
SULAWESI BARAT,MAMASA,BAMBANG,BAMBANG,70,70,6,6,6,3,3,1,2,0,2,1,10,2,8,0,21,8,13,4,20,17,3,3,5,0,5,2,MARET
SULAWESI BARAT,MAMASA,BAMBANG,RANTELEMO,88,58,33,2,1,0,0,17,2,4,13,14,9,9,0,4,55,6,49,4,49,31,18,25,88,32,56,10,MARET
SULAWESI BARAT,MAMASA,BAMBANG,SALUDENGEN,93,70,34,25,11,9,6,25,2,1,3,31,3,2,1,1,46,37,9,11,37,18,19,17,10,9,1,1,MARET
SULAWESI BARAT,MAMASA,BAMBANG,ULUMAMBI,47,37,31,23,9,2,0,5,18,0,20,11,2,1,1,0,13,13,0,1,10,5,5,2,12,3,9,1,MARET
SULAWESI BARAT,MAMASA,BAMBANG,BAMBANG TIMUR,41,50,32,22,10,8,3,20,8,0,4,20,2,1,1,0,42,28,14,26,39,7,32,3,21,19,2,11,MARET
SULAWESI BARAT,MAMASA,BAMBANG,MINANGA,65,57,34,19,0,0,0,25,9,0,4,25,7,6,1,3,21,21,0,11,2,2,0,2,17,9,8,17,MARET
SULAWESI BARAT,MAMASA,BAMBANG,SIKAMASE,63,28,6,6,2,2,2,1,1,2,4,2,12,5,7,4,13,7,6,7,0,0,0,0,18,18,0,3,MARET
SULAWESI BARAT,MAMASA,BAMBANG,RANTETARIMA,95,33,25,14,12,9,4,13,3,1,16,6,5,4,1,3,29,28,1,26,24,1,23,0,10,1,9,8,MARET
SULAWESI BARAT,MAMASA,BAMBANG,SALURURU,79,55,53,16,16,6,1,39,3,3,8,20,13,0,13,0,20,20,0,18,19,6,13,3,21,8,13,16,MARET
SULAWESI BARAT,MAMASA,BAMBANG,SALUTABANG,35,24,0,0,0,0,0,0,0,0,0,0,2,2,0,0,21,12,9,0,3,0,3,0,7,1,6,2,MARET
SULAWESI BARAT,MAMASA,BAMBANG,BALATANA,75,28,20,16,9,0,0,6,1,10,13,0,15,3,12,3,28,13,15,0,10,9,1,6,12,0,12,6,MARET
SULAWESI BARAT,MAMASA,BUNTUMALANGKA,BUNTUMALANGKA,84,51,50,0,0,0,0,23,1,20,20,1,14,11,3,6,16,9,7,7,6,2,4,0,21,18,3,2,MARET
SULAWESI BARAT,MAMASA,BUNTUMALANGKA,RANTEBERAN,73,56,56,54,35,16,7,22,22,4,22,2,14,7,7,2,35,22,13,8,4,1,3,1,27,14,13,27,MARET
SULAWESI BARAT,MAMASA,BUNTUMALANGKA,KEBANGA,53,10,5,0,0,0,0,4,0,0,2,2,2,2,0,2,10,7,3,4,2,0,2,0,0,0,0,0,MARET
SULAWESI BARAT,MAMASA,BUNTUMALANGKA,SALURINDU,52,55,6,4,0,0,0,6,0,0,2,3,5,3,2,1,35,8,27,2,21,11,10,7,48,21,27,23,MARET
SULAWESI BARAT,MAMASA,BUNTUMALANGKA,TAORA,77,66,16,15,12,0,0,13,0,0,2,2,0,0,0,0,25,11,14,6,3,2,1,1,29,9,20,5,MARET
SULAWESI BARAT,MAMASA,BUNTUMALANGKA,KABAE,50,35,34,10,3,2,1,19,11,0,28,4,0,0,0,0,17,6,11,6,0,0,0,0,13,5,8,8,MARET
SULAWESI BARAT,MAMASA,BUNTUMALANGKA,SALUTAMBUN BARAT,63,21,10,2,2,2,1,3,0,2,10,0,4,3,1,0,20,17,3,15,2,2,0,2,8,6,2,6,MARET
SULAWESI BARAT,MAMASA,BUNTUMALANGKA,PENATANGAN,79,66,47,42,25,6,1,27,2,4,19,11,12,12,0,5,45,40,5,19,2,1,1,1,37,24,13,18,MARET
SULAWESI BARAT,MAMASA,BUNTUMALANGKA,SALUTAMBUN TIMUR,46,13,3,2,2,2,2,1,0,0,0,1,0,0,0,0,10,9,1,6,6,3,3,3,15,15,0,11,MARET
SULAWESI BARAT,MAMASA,BUNTUMALANGKA,SALUTAMBUN,42,14,6,0,0,0,0,1,3,0,4,2,4,2,2,1,11,11,0,9,9,2,7,0,3,3,0,1,MARET
SULAWESI BARAT,MAMASA,BUNTUMALANGKA,ARALLE TIMUR,92,68,65,61,21,4,1,31,11,1,51,7,1,0,1,0,19,11,8,1,14,10,4,7,35,5,30,21,MARET
SULAWESI BARAT,MAMASA,MAMASA,MAMASA,97,13,2,2,0,0,0,1,1,0,1,1,13,2,11,0,13,12,1,9,0,0,0,0,0,0,0,0,MARET
SULAWESI BARAT,MAMASA,MAMASA,RAMBUSARATU,76,63,30,16,16,9,1,6,1,1,17,13,12,2,10,1,38,8,30,0,9,2,7,0,8,1,7,2,MARET
SULAWESI BARAT,MAMASA,MAMASA,OSANGO,55,11,5,1,0,0,0,3,0,0,4,0,6,4,2,2,11,7,4,4,7,5,2,0,6,0,6,6,MARET
SULAWESI BARAT,MAMASA,MAMASA,LAMBANAN,97,64,51,39,27,25,19,9,18,0,30,3,7,7,0,2,56,44,12,5,35,21,14,21,60,46,14,48,MARET
SULAWESI BARAT,MAMASA,MAMASA,LEMBANA SALULO,48,20,2,1,0,0,0,0,2,0,1,0,0,0,0,0,16,15,1,15,10,8,2,7,12,12,0,5,MARET
SULAWESI BARAT,MAMASA,MAMASA,TAUPE,58,79,25,13,2,0,0,16,5,3,23,0,8,6,2,5,75,42,33,10,24,1,23,1,66,10,56,4,MARET
SULAWESI BARAT,MAMASA,MAMASA,BUNTU BUDA,65,72,26,17,1,0,0,7,13,6,0,25,3,3,0,0,17,7,10,3,9,6,3,4,12,10,2,12,MARET
SULAWESI BARAT,MAMASA,MAMASA,TONDOK BAKARU,73,57,34,29,1,1,1,25,4,4,20,4,8,5,3,2,15,12,3,11,0,0,0,0,32,6,26,3,MARET
SULAWESI BARAT,MAMASA,MAMASA,PEBASSIAN,67,51,24,5,4,3,2,9,6,4,19,3,11,11,0,7,50,31,19,31,23,5,18,3,43,41,2,35,MARET
SULAWESI BARAT,MAMASA,MAMASA,MAMBULILING,48,66,63,17,8,7,0,58,1,2,63,0,6,5,1,1,21,6,15,6,7,4,3,3,6,6,0,6,MARET
SULAWESI BARAT,MAMASA,MAMASA,BOMBONG LAMBE,40,73,61,10,4,2,2,7,12,20,15,32,2,2,0,2,22,11,11,4,17,6,11,5,28,4,24,9,MARET
SULAWESI BARAT,MAMASA,MAMASA,BUBUN BATU,79,52,24,15,11,2,2,4,3,0,7,16,8,4,4,1,42,7,35,2,37,8,29,0,68,12,56,2,MARET
SULAWESI BARAT,MAMASA,MAMBI,MAMBI,31,20,4,2,0,0,0,0,1,2,4,0,2,2,0,0,13,6,7,4,8,1,7,1,10,3,7,1,MARET
SULAWESI BARAT,MAMASA,MAMBI,TALIPUKKI,83,69,56,26,1,0,0,44,11,0,3,27,4,3,1,2,65,12,53,9,56,36,20,29,6,2,4,6,MARET
SULAWESI BARAT,MAMASA,MAMBI,RANTEBULAHAN,99,37,24,19,11,9,1,7,8,3,4,14,15,9,6,9,13,9,4,8,11,6,5,3,23,0,23,10,MARET
SULAWESI BARAT,MAMASA,MAMBI,SONDONGLAYU,82,62,4,2,2,1,1,1,0,1,1,2,7,7,0,6,47,31,16,12,11,5,6,0,3,3,0,1,MARET
SULAWESI BARAT,MAMASA,MAMBI,SALUBANUA,40,68,50,2,1,0,0,27,14,3,43,4,8,5,3,0,29,28,1,2,22,12,10,12,60,37,23,58,MARET
SULAWESI BARAT,MAMASA,MAMBI,TAPALINA,51,10,2,2,0,0,0,2,0,0,0,1,6,2,4,0,10,6,4,5,8,6,2,4,12,1,11,2,MARET
SULAWESI BARAT,MAMASA,MAMBI,SENDANA,65,16,13,8,3,0,0,0,9,4,6,5,3,2,1,2,10,10,0,4,6,4,2,4,5,0,5,0,MARET
SULAWESI BARAT,MAMASA,MAMBI,PAMOSEAN,36,79,23,21,19,11,2,8,13,0,9,10,6,6,0,5,52,34,18,20,39,29,10,14,62,1,61,6,MARET
SULAWESI BARAT,MAMASA,MAMBI,SELUMAKA,97,42,27,14,5,0,0,12,13,1,23,1,7,0,7,0,26,13,13,5,18,9,9,1,40,10,30,32,MARET
SULAWESI BARAT,MAMASA,MAMBI,BUJUNG MANURUNG,39,63,1,0,0,0,0,1,0,0,0,1,0,0,0,0,14,14,0,0,7,7,0,3,37,23,14,17,MARET
SULAWESI BARAT,MAMASA,MAMBI,SALU ALO,31,13,0,0,0,0,0,0,0,0,0,0,2,2,0,0,11,6,5,3,2,0,2,0,6,4,2,2,MARET
SULAWESI BARAT,MAMASA,MAMBI,INDOBANUA,42,42,1,0,0,0,0,0,0,0,0,0,4,1,3,0,21,18,3,2,5,5,0,4,28,28,0,26,MARET
SULAWESI BARAT,MAMASA,MAMBI,SALUDURIAN,37,79,61,56,41,13,2,11,27,18,44,7,7,5,2,1,16,12,4,11,8,6,2,6,63,55,8,53,MARET
SULAWESI BARAT,MAMASA,MEHALAAN,MEHALAAN,77,66,62,8,0,0,0,62,0,0,8,9,14,0,14,0,24,9,15,1,4,2,2,2,26,18,8,18,MARET
SULAWESI BARAT,MAMASA,MEHALAAN,BOTTENG,95,51,11,9,9,3,0,11,0,0,11,0,6,5,1,2,17,8,9,8,11,3,8,1,23,7,16,9,MARET
SULAWESI BARAT,MAMASA,MEHALAAN,SALUKONTA,66,49,31,31,30,10,4,4,9,0,29,0,5,4,1,3,20,5,15,3,8,7,1,6,10,1,9,8,MARET
SULAWESI BARAT,MAMASA,MEHALAAN,MESAKADA,71,18,3,3,2,1,1,0,2,0,2,1,11,0,11,0,16,10,6,4,12,0,12,0,10,9,1,6,MARET
SULAWESI BARAT,MAMASA,MEHALAAN,MEHALAAN BARAT,66,25,7,0,0,0,0,1,1,4,3,3,0,0,0,0,19,13,6,6,13,8,5,7,18,4,14,17,MARET
SULAWESI BARAT,MAMASA,MEHALAAN,SALUAHOK,83,34,16,6,5,3,3,6,2,2,4,9,6,4,2,0,11,11,0,4,5,5,0,5,23,14,9,22,MARET
SULAWESI BARAT,MAMASA,MEHALAAN,SALUBALO,38,71,63,12,12,6,4,32,13,7,38,24,3,3,0,1,56,8,48,8,54,11,43,5,29,16,13,6,MARET
SULAWESI BARAT,MAMASA,MEHALAAN,PASSEMBUK,42,31,25,0,0,0,0,7,2,9,20,0,0,0,0,0,29,25,4,4,24,2,22,2,44,18,26,6,MARET
SULAWESI BARAT,MAMASA,MEHALAAN,KONDO,47,37,37,20,3,0,0,1,12,3,3,25,9,6,3,1,22,11,11,0,3,2,1,2,10,7,3,10,MARET
SULAWESI BARAT,MAMASA,MEHALAAN,LEKO SUKAMAJU,36,39,29,8,8,5,3,19,6,1,11,6,4,4,0,1,19,18,1,8,5,4,1,0,8,3,5,1,MARET
SULAWESI BARAT,MAMASA,MEHALAAN,ULUMEA,98,30,13,11,2,0,0,1,4,1,10,1,3,1,2,1,24,14,10,0,15,3,12,0,25,9,16,19,MARET
SULAWESI BARAT,MAMASA,MESSAWA,MESSAWA,57,34,14,13,10,6,1,5,6,1,5,7,5,2,3,2,27,20,7,16,10,5,5,5,31,21,10,15,MARET
SULAWESI BARAT,MAMASA,MESSAWA,RIPPUNG,95,17,12,7,2,0,0,5,0,5,1,0,12,12,0,3,14,6,8,3,8,7,1,4,1,0,1,0,MARET
SULAWESI BARAT,MAMASA,MESSAWA,MAKUANG,46,11,2,1,0,0,0,2,0,0,0,1,6,2,4,2,10,6,4,4,4,4,0,3,7,3,4,4,MARET
SULAWESI BARAT,MAMASA,MESSAWA,SEPANG,30,65,36,27,3,1,0,0,19,2,12,2,1,0,1,0,53,7,46,2,14,11,3,0,32,22,10,28,MARET
SULAWESI BARAT,MAMASA,MESSAWA,MALIMBONG,75,66,12,0,0,0,0,8,0,0,8,0,11,3,8,3,50,24,26,11,42,41,1,32,10,10,0,2,MARET
SULAWESI BARAT,MAMASA,MESSAWA,MATANDE,97,55,8,8,2,0,0,3,1,3,6,0,17,14,3,2,24,22,2,8,10,10,0,0,33,26,7,18,MARET
SULAWESI BARAT,MAMASA,MESSAWA,SIPAI,52,40,11,0,0,0,0,7,2,1,11,0,3,0,3,0,34,9,25,6,23,4,19,4,30,14,16,25,MARET
SULAWESI BARAT,MAMASA,MESSAWA,PASMA MAMBU,87,30,8,1,0,0,0,8,0,0,1,0,17,15,2,7,27,23,4,1,21,9,12,4,8,1,7,4,MARET
SULAWESI BARAT,MAMASA,MESSAWA,TANETE BATU,69,10,3,2,1,1,1,2,0,0,1,0,0,0,0,0,10,10,0,0,9,1,8,1,8,7,1,7,MARET
SULAWESI BARAT,MAMASA,NOSU,NOSU,55,47,4,3,3,0,0,3,1,0,2,1,3,0,3,0,14,6,8,0,12,7,5,2,4,4,0,3,MARET
SULAWESI BARAT,MAMASA,NOSU,MINANGA,85,63,52,39,23,10,7,35,2,1,38,12,4,0,4,0,23,9,14,8,2,0,2,0,20,7,13,4,MARET
SULAWESI BARAT,MAMASA,NOSU,BATUPAPAN,83,72,43,41,26,21,0,34,0,1,14,25,4,0,4,0,65,5,60,0,44,15,29,14,83,60,23,72,MARET
SULAWESI BARAT,MAMASA,NOSU,MASEWWE,58,44,29,1,1,0,0,15,10,0,10,3,4,3,1,2,13,13,0,4,4,0,4,0,34,27,7,9,MARET
SULAWESI BARAT,MAMASA,NOSU,SIWI,49,27,20,2,0,0,0,8,0,1,2,6,1,0,1,0,25,5,20,2,12,1,11,1,15,15,0,3,MARET
SULAWESI BARAT,MAMASA,NOSU,MINANGA TIMUR,53,68,63,36,2,0,0,52,8,2,13,13,4,2,2,0,44,38,6,29,42,21,21,12,83,8,75,50,MARET
SULAWESI BARAT,MAMASA,NOSU,PARINDING,43,49,7,7,2,2,0,6,1,0,0,6,1,1,0,0,45,40,5,37,20,9,11,3,47,47,0,25,MARET
SULAWESI BARAT,MAMASA,PANA,PANA,55,61,19,10,9,2,2,0,15,2,2,0,11,2,9,0,36,15,21,12,32,11,21,3,68,60,8,61,MARET
SULAWESI BARAT,MAMASA,PANA,MANIPI,54,61,36,10,7,7,7,7,11,4,34,1,1,0,1,0,56,15,41,1,4,3,1,1,34,25,9,20,MARET
SULAWESI BARAT,MAMASA,PANA,MAMULLU,77,21,10,4,4,0,0,7,2,0,9,1,8,6,2,2,12,12,0,11,5,3,2,0,0,0,0,0,MARET
SULAWESI BARAT,MAMASA,PANA,SAPAN,50,19,11,4,1,1,1,3,5,0,11,0,8,3,5,1,18,9,9,3,13,9,4,4,22,10,12,19,MARET
SULAWESI BARAT,MAMASA,PANA,DATUBARINGAN,77,48,8,4,3,2,0,0,5,0,5,2,13,6,7,2,47,27,20,17,39,17,22,13,22,13,9,13,MARET
SULAWESI BARAT,MAMASA,PANA,PANURA,77,44,7,5,3,2,0,3,1,2,6,1,3,2,1,0,24,12,12,4,18,0,18,0,24,7,17,3,MARET
SULAWESI BARAT,MAMASA,PANA,TALLANG BULAWAN,47,63,43,0,0,0,0,5,25,8,10,23,4,4,0,3,22,16,6,11,10,10,0,1,0,0,0,0,MARET
SULAWESI BARAT,MAMASA,PANA,KARAKA,96,23,11,5,2,1,0,11,0,0,7,1,1,0,1,0,16,11,5,11,7,7,0,0,23,4,19,9,MARET
SULAWESI BARAT,MAMASA,PANA,ULUSALU,84,47,44,5,0,0,0,19,24,0,33,0,8,0,8,0,33,6,27,4,6,1,5,0,14,7,7,8,MARET
SULAWESI BARAT,MAMASA,PANA,WERI,68,34,30,7,2,0,0,28,1,0,9,21,11,4,7,1,24,5,19,0,18,0,18,0,36,9,27,32,MARET
SULAWESI BARAT,MAMASA,PANA,SALUTAMBUN,69,58,47,42,22,7,0,30,3,12,17,24,8,7,1,7,28,22,6,12,7,7,0,2,45,20,25,27,MARET
SULAWESI BARAT,MAMASA,PANA,SALOAN,33,19,9,0,0,0,0,2,6,0,4,1,5,4,1,4,10,8,2,6,7,3,4,1,19,15,4,4,MARET
SULAWESI BARAT,MAMASA,PANA,ULUSALU INDAH,88,13,1,1,1,0,0,0,0,0,1,0,13,4,9,4,11,11,0,3,5,4,1,0,13,8,5,7,MARET
SULAWESI BARAT,MAMASA,RANTEBULAHAN TIMUR,SALUMOKANAN,76,69,40,35,4,3,1,12,16,9,1,13,11,0,11,0,12,9,3,5,2,2,0,0,5,5,0,5,MARET
SULAWESI BARAT,MAMASA,RANTEBULAHAN TIMUR,SALUMOKANAN BARAT,75,23,17,8,2,1,1,4,7,1,5,0,13,9,4,5,11,5,6,5,11,1,10,0,14,3,11,11,MARET
SULAWESI BARAT,MAMASA,RANTEBULAHAN TIMUR,BUANGIN,32,68,1,0,0,0,0,0,0,1,1,0,1,0,1,0,58,15,43,0,45,26,19,22,33,25,8,27,MARET
SULAWESI BARAT,MAMASA,RANTEBULAHAN TIMUR,BAMBANG BUDA,33,36,8,8,7,4,0,5,1,0,4,3,1,0,1,0,30,29,1,16,30,12,18,7,44,30,14,24,MARET
SULAWESI BARAT,MAMASA,RANTEBULAHAN TIMUR,LEKO,57,59,32,17,9,0,0,0,16,13,17,12,10,1,9,1,48,8,40,3,35,35,0,27,73,34,39,53,MARET
SULAWESI BARAT,MAMASA,RANTEBULAHAN TIMUR,KIRAK,54,68,5,5,2,2,2,2,1,0,0,2,10,6,4,3,40,19,21,4,35,35,0,3,52,0,52,35,MARET
SULAWESI BARAT,MAMASA,RANTEBULAHAN TIMUR,SALUMOKANAN UTARA,33,29,12,6,2,2,2,10,0,0,12,0,6,2,4,0,27,25,2,20,22,1,21,0,16,13,3,5,MARET
SULAWESI BARAT,MAMASA,RANTEBULAHAN TIMUR,SAMPALE,61,26,4,2,2,0,0,3,1,0,2,0,4,4,0,4,26,8,18,2,6,3,3,0,6,4,2,2,MARET
SULAWESI BARAT,MAMASA,SESENAPADANG,OROBUA,66,51,0,0,0,0,0,0,0,0,0,0,5,4,1,3,43,34,9,14,39,35,4,23,48,43,5,0,MARET
SULAWESI BARAT,MAMASA,SESENAPADANG,PALADAN,37,22,11,5,3,3,1,6,0,1,5,3,5,5,0,4,20,20,0,5,3,0,3,0,17,10,7,4,MARET
SULAWESI BARAT,MAMASA,SESENAPADANG,OROBUA TIMUR,93,39,16,4,4,2,0,14,1,0,7,3,9,9,0,8,21,9,12,0,3,1,2,1,22,3,19,0,MARET
SULAWESI BARAT,MAMASA,SESENAPADANG,RANTE PUANG,75,21,10,7,3,1,1,1,2,1,8,0,3,3,0,0,14,8,6,1,3,0,3,0,16,5,11,8,MARET
SULAWESI BARAT,MAMASA,SESENAPADANG,SATENETEAN,92,58,51,20,19,2,1,26,12,5,42,2,6,6,0,0,16,11,5,11,6,4,2,0,27,12,15,6,MARET
SULAWESI BARAT,MAMASA,SESENAPADANG,LISUAN ADA,49,65,12,2,1,0,0,2,7,3,7,1,2,2,0,2,46,41,5,6,4,2,2,1,4,3,1,3,MARET
SULAWESI BARAT,MAMASA,SESENAPADANG,OROBUA SELATAN,42,77,17,10,3,0,0,12,1,0,15,0,5,3,2,0,44,8,36,8,13,3,10,2,45,23,22,9,MARET
SULAWESI BARAT,MAMASA,SESENAPADANG,MALANGKENA PADANG,87,37,15,13,3,3,2,6,7,0,10,3,1,0,1,0,35,28,7,6,8,1,7,0,21,20,1,6,MARET
SULAWESI BARAT,MAMASA,SESENAPADANG,MALIMBONG,93,56,1,1,0,0,0,0,1,0,1,0,7,7,0,1,55,12,43,12,46,32,14,4,68,15,53,68,MARET
SULAWESI BARAT,MAMASA,SESENAPADANG,MARAMPAN OROBUA,80,19,12,3,3,0,0,0,10,0,1,1,8,1,7,1,12,11,1,0,3,1,2,1,4,4,0,1,MARET
SULAWESI BARAT,MAMASA,SUMARORONG,SUMARORONG,100,38,10,9,8,4,0,2,5,2,2,4,9,2,7,1,18,6,12,1,18,5,13,5,27,23,4,13,MARET
SULAWESI BARAT,MAMASA,SUMARORONG,TABONE,47,79,0,0,0,0,0,0,0,0,0,0,6,4,2,2,66,53,13,26,6,2,4,0,6,2,4,4,MARET
SULAWESI BARAT,MAMASA,SUMARORONG,BATANG URU,77,57,27,4,1,1,1,4,13,0,1,24,12,1,11,0,19,7,12,5,1,1,0,0,35,8,27,12,MARET
SULAWESI BARAT,MAMASA,SUMARORONG,SASAKAN,65,30,21,14,8,5,0,18,2,0,14,1,6,1,5,0,13,12,1,0,10,5,5,3,2,1,1,2,MARET
SULAWESI BARAT,MAMASA,SUMARORONG,TADISI,61,23,8,6,4,1,1,0,4,0,2,5,5,1,4,0,18,15,3,2,12,4,8,0,9,2,7,4,MARET
SULAWESI BARAT,MAMASA,SUMARORONG,SIBANAWA,42,11,3,0,0,0,0,2,0,1,1,1,4,0,4,0,10,7,3,5,3,2,1,2,5,4,1,4,MARET
SULAWESI BARAT,MAMASA,SUMARORONG,BATANGNGURU TIMUR,82,69,55,30,17,9,9,2,33,3,55,0,5,5,0,0,66,10,56,6,30,0,30,0,70,24,46,14,MARET
SULAWESI BARAT,MAMASA,SUMARORONG,SALUBALO,47,57,24,19,13,11,0,22,2,0,16,1,3,2,1,2,11,10,1,6,2,0,2,0,40,13,27,21,MARET
SULAWESI BARAT,MAMASA,SUMARORONG,BANEA,81,18,9,4,3,0,0,9,0,0,9,0,4,2,2,1,10,10,0,5,2,0,2,0,10,8,2,1,MARET
SULAWESI BARAT,MAMASA,SUMARORONG,RANTE KAMASE,50,58,28,22,13,8,8,15,3,2,14,6,2,0,2,0,55,17,38,10,51,27,24,13,6,6,0,2,MARET
SULAWESI BARAT,MAMASA,TABANG,TABANG,61,50,36,20,15,14,4,23,1,3,29,4,7,4,3,4,14,6,8,1,8,4,4,3,7,2,5,7,MARET
SULAWESI BARAT,MAMASA,TABANG,TADOKALUA,59,40,25,12,4,0,0,7,0,17,21,3,8,4,4,0,27,15,12,14,9,8,1,1,27,5,22,10,MARET
SULAWESI BARAT,MAMASA,TABANG,TABANG BARAT,98,21,8,1,1,1,1,6,1,0,8,0,3,2,1,2,17,6,11,4,4,2,2,2,3,1,2,2,MARET
SULAWESI BARAT,MAMASA,TABANG,MASUPU,75,53,19,12,0,0,0,5,6,3,13,2,4,1,3,0,16,13,3,7,6,2,4,2,31,27,4,21,MARET
SULAWESI BARAT,MAMASA,TABANG,KALAMA,61,67,48,11,5,5,3,12,30,0,16,6,0,0,0,0,65,47,18,13,65,24,41,9,77,75,2,40,MARET
SULAWESI BARAT,MAMASA,TABANG,BAKADISURA,40,21,19,4,2,1,1,1,15,0,1,17,8,7,1,5,13,7,6,4,7,7,0,0,8,7,1,6,MARET
SULAWESI BARAT,MAMASA,TABANG,SALUKONA,68,66,13,1,1,1,1,4,8,0,2,3,7,6,1,6,34,15,19,8,2,0,2,0,38,7,31,28,MARET
SULAWESI BARAT,MAMASA,TABULAHAN,LAKAHANG,95,80,19,3,2,1,1,12,6,0,19,0,0,0,0,0,30,24,6,11,1,1,0,1,9,9,0,2,MARET
SULAWESI BARAT,MAMASA,TABULAHAN,PERIANGAN,38,53,35,12,2,2,2,20,2,0,16,5,1,1,0,0,45,10,35,3,37,37,0,36,28,19,9,12,MARET
SULAWESI BARAT,MAMASA,TABULAHAN,MALATIRO,69,53,5,1,1,0,0,3,2,0,0,2,1,1,0,0,37,32,5,25,15,4,11,2,29,2,27,15,MARET
SULAWESI BARAT,MAMASA,TABULAHAN,TABULAHAN,97,64,62,8,2,1,0,11,22,17,33,2,16,8,8,7,52,36,16,8,24,6,18,5,47,8,39,26,MARET
SULAWESI BARAT,MAMASA,TABULAHAN,SALULEANG,64,28,16,5,5,5,1,5,8,1,7,2,9,7,2,3,22,7,15,2,5,3,2,3,17,0,17,0,MARET
SULAWESI BARAT,MAMASA,TABULAHAN,TAMPAK KURRA,93,56,23,18,5,4,1,12,3,6,6,12,8,6,2,2,13,11,2,7,9,5,4,2,24,2,22,9,MARET
SULAWESI BARAT,MAMASA,TABULAHAN,GANDANG DEWATA,62,24,19,9,6,5,0,5,12,1,3,14,9,1,8,0,10,9,1,0,6,5,1,5,15,6,9,5,MARET
SULAWESI BARAT,MAMASA,TABULAHAN,BURANA,65,59,59,39,13,2,2,51,4,2,26,28,2,2,0,1,40,21,19,5,33,5,28,3,71,31,40,70,MARET
SULAWESI BARAT,MAMASA,TABULAHAN,SALUBAKKA,49,69,42,31,1,1,1,26,14,1,40,1,0,0,0,0,15,13,2,8,6,6,0,1,49,24,25,30,MARET
SULAWESI BARAT,MAMASA,TABULAHAN,PANGANDARAN,39,63,38,9,7,5,0,15,1,7,25,12,2,0,2,0,55,10,45,2,7,3,4,2,18,5,13,4,MARET
SULAWESI BARAT,MAMASA,TABULAHAN,TALOPAK,82,80,48,34,34,11,1,43,4,0,35,12,9,8,1,7,33,7,26,6,24,3,21,2,50,36,14,6,MARET
SULAWESI BARAT,MAMASA,TABULAHAN,PEU',39,27,4,1,0,0,0,3,1,0,1,0,5,2,3,1,24,14,10,12,12,2,10,1,15,9,6,10,MARET
SULAWESI BARAT,MAMASA,TABULAHAN,TIMORO,52,16,8,7,1,1,0,0,4,1,7,1,10,6,4,2,13,6,7,4,6,1,5,0,17,6,11,1,MARET
SULAWESI BARAT,MAMASA,TABULAHAN,LAKAHANG UTAMA,36,80,45,19,11,7,0,33,1,8,12,9,5,1,4,1,20,14,6,2,17,0,17,0,73,15,58,15,MARET
SULAWESI BARAT,MAMASA,TANDUK KALUA,MINAKE,52,40,28,15,8,1,0,21,2,1,25,0,5,0,5,0,11,5,6,5,7,2,5,1,8,4,4,8,MARET
SULAWESI BARAT,MAMASA,TANDUK KALUA,MALABO,30,12,12,10,1,1,1,10,0,1,4,3,5,3,2,3,10,9,1,1,8,6,2,5,8,7,1,7,MARET
SULAWESI BARAT,MAMASA,TANDUK KALUA,SINDAGAMANIK,85,48,23,14,14,13,10,6,3,3,11,10,14,9,5,0,20,19,1,8,16,4,12,4,6,5,1,2,MARET
SULAWESI BARAT,MAMASA,TANDUK KALUA,PARONDOBULAWAN,39,68,56,45,12,9,7,49,0,0,51,0,1,1,0,0,42,25,17,10,38,5,33,1,6,0,6,0,MARET
SULAWESI BARAT,MAMASA,TANDUK KALUA,TAMALANTIK,88,80,63,4,0,0,0,51,4,1,28,34,17,0,17,0,62,58,4,35,0,0,0,0,30,6,24,19,MARET
SULAWESI BARAT,MAMASA,TANDUK KALUA,MANNABABA,40,27,7,6,4,0,0,7,0,0,4,3,5,5,0,3,15,10,5,3,9,3,6,0,24,16,8,14,MARET
SULAWESI BARAT,MAMASA,TANDUK KALUA,MESAKADA,49,18,11,2,0,0,0,8,3,0,7,2,5,2,3,2,14,8,6,7,7,7,0,6,6,4,2,4,MARET
SULAWESI BARAT,MAMASA,TANDUK KALUA,BALLABATU,57,52,43,38,23,7,6,19,7,1,15,27,6,0,6,0,43,24,19,20,15,2,13,1,7,0,7,4,MARET
SULAWESI BARAT,MAMASA,TANDUK KALUA,PAMBE,83,41,5,1,0,0,0,3,1,0,3,2,2,2,0,0,32,24,8,12,3,3,0,3,10,3,7,4,MARET
SULAWESI BARAT,MAMASA,TANDUK KALUA,SALURANO,62,68,20,6,3,1,1,11,8,0,19,1,0,0,0,0,19,17,2,8,1,0,1,0,22,22,0,14,MARET
SULAWESI BARAT,MAMASA,TANDUK KALUA,TALIMBUNG,70,20,20,0,0,0,0,13,1,2,20,0,1,0,1,0,15,12,3,9,10,2,8,0,12,8,4,12,MARET
SULAWESI BARAT,MAMASA,TANDUK KALUA,KANAN,82,52,48,42,30,21,21,3,19,5,35,1,15,13,2,7,37,24,13,11,36,12,24,11,26,25,1,0,MARET
SULAWESI BARAT,MAMASA,TAWALIAN,TAWALIAN,52,70,10,9,2,0,0,8,1,1,1,5,1,1,0,1,58,23,35,19,22,4,18,3,54,12,42,0,MARET
SULAWESI BARAT,MAMASA,TAWALIAN,TAWALIAN TIMUR,43,77,46,11,0,0,0,28,8,6,45,0,5,1,4,0,72,39,33,31,67,21,46,21,113,36,77,0,MARET
SULAWESI BARAT,MAMASA,TAWALIAN,KARIANGO,45,79,28,22,19,17,12,5,2,8,21,4,2,1,1,1,25,21,4,4,9,2,7,1,7,6,1,2,MARET
SULAWESI BARAT,MAMASA,TAWALIAN,RANTETANGNGA,59,41,37,7,1,1,1,18,10,3,13,9,0,0,0,0,27,25,2,23,27,10,17,5,54,26,28,54,MARET
SULAWESI BARAT,POLEWALI MANDAR,ALLU,PETOOSANG,82,79,54,45,17,12,7,3,0,26,37,5,5,1,4,0,33,20,13,7,29,20,9,3,61,8,53,7,MARET
SULAWESI BARAT,POLEWALI MANDAR,ALLU,MOMBI,78,72,59,55,22,5,0,0,48,4,35,11,8,7,1,4,36,24,12,11,24,2,22,0,14,5,9,1,MARET
SULAWESI BARAT,POLEWALI MANDAR,ALLU,KALUMAMMANG,50,77,44,5,5,4,4,17,1,19,41,3,2,0,2,0,21,13,8,3,12,11,1,11,37,19,18,3,MARET
SULAWESI BARAT,POLEWALI MANDAR,ALLU,PAO-PAO,43,50,43,31,24,1,1,11,3,17,11,15,0,0,0,0,41,15,26,5,32,22,10,11,21,5,16,1,MARET
SULAWESI BARAT,POLEWALI MANDAR,ALLU,PUPPU URING,66,16,11,7,3,2,1,10,0,0,2,6,10,10,0,1,13,10,3,7,10,5,5,4,2,2,0,0,MARET
SULAWESI BARAT,POLEWALI MANDAR,ALLU,SARAGIAN,62,32,6,4,0,0,0,0,2,1,2,3,12,0,12,0,19,8,11,2,7,0,7,0,2,2,0,1,MARET
SULAWESI BARAT,POLEWALI MANDAR,ALLU,SAYOANG,79,58,16,5,4,1,0,2,3,3,4,12,6,0,6,0,21,19,2,15,11,4,7,2,43,0,43,33,MARET
SULAWESI BARAT,POLEWALI MANDAR,ALLU,ALU,63,34,16,5,2,2,1,11,3,1,3,2,1,1,0,1,15,7,8,1,5,2,3,2,28,7,21,12,MARET
SULAWESI BARAT,POLEWALI MANDAR,ANREAPI,ANREAPI,97,18,9,4,4,2,2,2,2,2,9,0,9,7,2,0,18,11,7,9,4,0,4,0,10,2,8,1,MARET
SULAWESI BARAT,POLEWALI MANDAR,ANREAPI,DUAMPANUA,87,40,8,2,0,0,0,0,3,1,4,0,1,0,1,0,39,34,5,7,18,16,2,5,15,6,9,3,MARET
SULAWESI BARAT,POLEWALI MANDAR,ANREAPI,KELAPA DUA,39,72,57,37,1,0,0,34,22,1,50,3,0,0,0,0,19,16,3,16,13,0,13,0,38,35,3,12,MARET
SULAWESI BARAT,POLEWALI MANDAR,ANREAPI,PAPPANDANGAN,99,13,9,6,0,0,0,5,2,1,5,4,2,1,1,0,12,7,5,2,0,0,0,0,3,0,3,1,MARET
SULAWESI BARAT,POLEWALI MANDAR,ANREAPI,KUNYI,35,53,19,11,5,1,0,4,14,0,3,1,3,0,3,0,42,19,23,12,9,7,2,6,24,13,11,21,MARET
SULAWESI BARAT,POLEWALI MANDAR,BALANIPA,BALANIPA,78,37,35,11,5,4,0,16,18,1,18,14,8,7,1,7,27,20,7,16,13,8,5,1,21,3,18,9,MARET
SULAWESI BARAT,POLEWALI MANDAR,BALANIPA,TAMMAJARRA,30,34,26,24,15,0,0,3,1,13,1,25,4,1,3,0,30,11,19,5,13,2,11,2,16,16,0,14,MARET
SULAWESI BARAT,POLEWALI MANDAR,BALANIPA,TAMANGGALLE,86,51,39,25,9,5,2,6,10,0,18,7,11,9,2,5,21,10,11,8,1,1,0,1,21,18,3,20,MARET
SULAWESI BARAT,POLEWALI MANDAR,BALANIPA,MOSSO,68,64,49,9,1,0,0,42,2,5,16,4,12,9,3,5,55,17,38,4,30,4,26,2,31,17,14,7,MARET
SULAWESI BARAT,POLEWALI MANDAR,BALANIPA,GALUNG TULUK,88,31,0,0,0,0,0,0,0,0,0,0,9,5,4,1,23,8,15,5,23,15,8,6,17,15,2,10,MARET
SULAWESI BARAT,POLEWALI MANDAR,BALANIPA,SABANG SUBIK,64,50,12,9,0,0,0,12,0,0,12,0,11,4,7,4,17,5,12,1,8,0,8,0,33,1,32,12,MARET
SULAWESI BARAT,POLEWALI MANDAR,BALANIPA,PAMBUSUANG,92,74,34,21,10,9,0,21,10,2,25,7,2,2,0,1,25,16,9,2,21,4,17,4,36,31,5,29,MARET
SULAWESI BARAT,POLEWALI MANDAR,BALANIPA,BALA,51,61,42,19,6,0,0,31,4,5,36,5,7,7,0,5,58,43,15,10,35,33,2,24,49,30,19,11,MARET
SULAWESI BARAT,POLEWALI MANDAR,BALANIPA,LAMBANAN,63,20,17,3,3,0,0,6,11,0,10,6,9,5,4,3,17,8,9,7,2,1,1,1,15,12,3,14,MARET
SULAWESI BARAT,POLEWALI MANDAR,BALANIPA,LEGO,78,55,55,37,10,7,0,47,1,2,39,3,15,6,9,5,40,33,7,1,0,0,0,0,31,29,2,28,MARET
SULAWESI BARAT,POLEWALI MANDAR,BALANIPA,PALLIS,98,43,15,7,1,1,0,5,5,1,0,14,9,4,5,2,16,14,2,0,11,9,2,6,2,1,1,2,MARET
SULAWESI BARAT,POLEWALI MANDAR,BINUANG,AMASSANGAN,86,31,12,5,4,3,3,5,0,2,7,3,0,0,0,0,27,22,5,12,22,1,21,1,20,5,15,9,MARET
SULAWESI BARAT,POLEWALI MANDAR,BINUANG,TONYAMAN,80,37,14,5,2,0,0,12,2,0,5,3,16,11,5,9,17,6,11,0,17,14,3,10,3,0,3,2,MARET
SULAWESI BARAT,POLEWALI MANDAR,BINUANG,KUAJANG,84,21,16,6,6,0,0,12,4,0,3,11,2,1,1,0,17,12,5,8,13,5,8,0,11,1,10,9,MARET
SULAWESI BARAT,POLEWALI MANDAR,BINUANG,PAKU,98,80,0,0,0,0,0,0,0,0,0,0,16,11,5,6,43,11,32,3,31,28,3,5,86,3,83,82,MARET
SULAWESI BARAT,POLEWALI MANDAR,BINUANG,MIRRING,45,14,10,10,2,1,1,9,0,0,0,4,2,0,2,0,12,6,6,4,12,8,4,0,9,6,3,9,MARET
SULAWESI BARAT,POLEWALI MANDAR,BINUANG,BATETANGNGA,45,50,18,7,2,0,0,6,11,1,0,4,5,3,2,3,33,27,6,9,1,0,1,0,33,19,14,18,MARET
SULAWESI BARAT,POLEWALI MANDAR,BINUANG,MAMMI,54,26,9,4,2,2,0,1,4,2,0,1,6,2,4,2,24,6,18,3,8,1,7,0,15,9,6,6,MARET
SULAWESI BARAT,POLEWALI MANDAR,BINUANG,KALEOK,66,45,13,0,0,0,0,5,1,4,13,0,9,1,8,1,33,21,12,9,10,7,3,2,22,14,8,10,MARET
SULAWESI BARAT,POLEWALI MANDAR,BINUANG,AMOLA,80,15,7,7,7,0,0,2,3,1,6,0,12,8,4,0,11,9,2,7,11,10,1,9,11,7,4,11,MARET
SULAWESI BARAT,POLEWALI MANDAR,BINUANG,REA,46,79,57,22,14,8,7,26,23,0,4,15,5,5,0,4,25,9,16,2,7,0,7,0,57,15,42,42,MARET
SULAWESI BARAT,POLEWALI MANDAR,BULO,BULO,55,12,10,1,1,0,0,6,4,0,3,1,4,4,0,3,12,8,4,2,1,0,1,0,5,4,1,0,MARET
SULAWESI BARAT,POLEWALI MANDAR,BULO,PULLIWA,62,23,5,2,2,2,2,2,0,0,5,0,0,0,0,0,18,16,2,15,14,4,10,4,19,9,10,8,MARET
SULAWESI BARAT,POLEWALI MANDAR,BULO,PATAMBANUA,57,56,42,37,3,2,1,34,6,1,26,8,6,5,1,2,25,12,13,5,20,9,11,5,12,0,12,2,MARET
SULAWESI BARAT,POLEWALI MANDAR,BULO,KAROMBANG,45,67,2,0,0,0,0,0,1,1,1,1,9,6,3,4,62,52,10,7,57,36,21,27,74,24,50,54,MARET
SULAWESI BARAT,POLEWALI MANDAR,BULO,DAALA TIMUR,65,40,9,0,0,0,0,6,3,0,1,1,1,1,0,1,36,35,1,14,2,0,2,0,12,6,6,6,MARET
SULAWESI BARAT,POLEWALI MANDAR,BULO,LENGGO,51,46,5,3,0,0,0,2,3,0,2,0,8,1,7,1,46,26,20,19,27,18,9,3,3,3,0,1,MARET
SULAWESI BARAT,POLEWALI MANDAR,BULO,SABURA,82,45,13,7,5,4,0,5,4,3,12,1,13,5,8,5,30,11,19,1,4,3,1,0,35,4,31,13,MARET
SULAWESI BARAT,POLEWALI MANDAR,BULO,SEPPORRAKI,84,30,29,28,18,7,3,10,1,13,12,5,14,5,9,1,29,28,1,19,15,3,12,0,36,33,3,34,MARET
SULAWESI BARAT,POLEWALI MANDAR,BULO,IHING,68,21,13,3,0,0,0,4,6,0,9,4,0,0,0,0,12,7,5,3,8,7,1,4,22,5,17,5,MARET
SULAWESI BARAT,POLEWALI MANDAR,CAMPALAGIAN,PAPPANG,72,47,21,2,2,1,1,6,12,1,6,6,1,0,1,0,27,10,17,9,25,9,16,4,33,4,29,28,MARET
SULAWESI BARAT,POLEWALI MANDAR,CAMPALAGIAN,LALIKO,47,28,0,0,0,0,0,0,0,0,0,0,0,0,0,0,17,13,4,1,2,2,0,0,16,3,13,7,MARET
SULAWESI BARAT,POLEWALI MANDAR,CAMPALAGIAN,BONDE,76,48,48,29,5,4,0,20,27,1,37,4,4,3,1,3,22,8,14,6,21,5,16,2,11,2,9,6,MARET
SULAWESI BARAT,POLEWALI MANDAR,CAMPALAGIAN,KATUMBANGAN LEMO,98,26,25,6,5,0,0,21,2,2,23,1,6,2,4,2,21,14,7,9,17,11,6,9,4,4,0,4,MARET
SULAWESI BARAT,POLEWALI MANDAR,CAMPALAGIAN,PANYAMPA,60,23,7,0,0,0,0,1,3,0,6,0,12,9,3,9,22,11,11,3,6,0,6,0,0,0,0,0,MARET
SULAWESI BARAT,POLEWALI MANDAR,CAMPALAGIAN,SURUANG,44,56,36,10,5,1,1,18,5,12,21,13,0,0,0,0,31,30,1,23,28,19,9,0,33,33,0,19,MARET
SULAWESI BARAT,POLEWALI MANDAR,CAMPALAGIAN,LAMPOKO,63,80,44,36,29,18,16,24,2,1,35,2,9,6,3,3,64,21,43,2,47,20,27,9,88,15,73,39,MARET
SULAWESI BARAT,POLEWALI MANDAR,CAMPALAGIAN,KATUMBANGAN,34,68,21,8,3,3,2,4,8,7,1,12,3,0,3,0,34,23,11,6,20,18,2,3,4,0,4,0,MARET
SULAWESI BARAT,POLEWALI MANDAR,CAMPALAGIAN,LAPEO,84,64,52,12,4,2,2,33,14,1,50,1,2,1,1,1,15,6,9,2,1,1,0,1,41,41,0,0,MARET
SULAWESI BARAT,POLEWALI MANDAR,CAMPALAGIAN,PARAPPE,33,62,13,9,3,2,2,6,4,1,4,8,6,1,5,1,38,38,0,15,24,2,22,0,6,4,2,1,MARET
SULAWESI BARAT,POLEWALI MANDAR,CAMPALAGIAN,ONGKO,32,76,50,15,3,1,1,30,10,0,3,45,6,4,2,0,44,36,8,9,44,29,15,7,91,56,35,6,MARET
SULAWESI BARAT,POLEWALI MANDAR,CAMPALAGIAN,KENJE,92,76,25,6,6,0,0,22,3,0,11,9,18,12,6,10,18,17,1,3,12,2,10,0,19,1,18,6,MARET
SULAWESI BARAT,POLEWALI MANDAR,CAMPALAGIAN,SUMARRANG,67,65,51,27,7,4,3,29,5,12,14,36,0,0,0,0,20,13,7,3,0,0,0,0,14,14,0,14,MARET
SULAWESI BARAT,POLEWALI MANDAR,CAMPALAGIAN,BOTTO,44,54,40,24,17,6,4,28,6,0,13,2,6,0,6,0,39,36,3,12,15,9,6,8,29,5,24,0,MARET
SULAWESI BARAT,POLEWALI MANDAR,CAMPALAGIAN,GATTUNGAN,89,68,29,26,4,2,2,22,3,0,8,9,9,3,6,3,42,10,32,8,4,1,3,1,35,24,11,30,MARET
SULAWESI BARAT,POLEWALI MANDAR,CAMPALAGIAN,PADANG TIMUR,63,54,22,22,11,0,0,2,17,1,13,3,11,2,9,1,12,9,3,9,12,2,10,2,41,11,30,14,MARET
SULAWESI BARAT,POLEWALI MANDAR,CAMPALAGIAN,PADANG,69,56,35,11,3,2,2,4,3,6,30,1,10,10,0,7,14,6,8,5,10,6,4,4,33,1,32,12,MARET
SULAWESI BARAT,POLEWALI MANDAR,CAMPALAGIAN,LAGI-AGI,97,35,11,9,0,0,0,2,0,9,2,4,2,2,0,1,22,12,10,12,1,0,1,0,15,14,1,8,MARET
SULAWESI BARAT,POLEWALI MANDAR,LIMBORO,LIMBORO,40,73,13,9,3,3,3,8,0,2,13,0,6,1,5,0,68,34,34,17,1,0,1,0,16,16,0,0,MARET
SULAWESI BARAT,POLEWALI MANDAR,LIMBORO,LEMBANG LEMBANG,64,25,5,5,2,1,1,1,2,0,3,0,6,5,1,1,13,10,3,10,7,2,5,2,11,11,0,7,MARET
SULAWESI BARAT,POLEWALI MANDAR,LIMBORO,TANDASURA,87,60,48,9,3,3,0,8,13,15,19,28,12,1,11,0,26,5,21,5,5,3,2,3,44,11,33,29,MARET
SULAWESI BARAT,POLEWALI MANDAR,LIMBORO,SAMASUNDU,95,27,14,3,0,0,0,4,7,0,13,0,10,9,1,8,10,7,3,1,7,0,7,0,22,12,10,14,MARET
SULAWESI BARAT,POLEWALI MANDAR,LIMBORO,NAPO,75,43,31,3,3,3,0,8,16,3,1,9,7,6,1,4,42,23,19,22,12,5,7,1,20,1,19,9,MARET
SULAWESI BARAT,POLEWALI MANDAR,LIMBORO,TODANG TODANG,74,38,16,15,11,5,3,6,2,2,1,2,6,2,4,2,26,24,2,13,4,0,4,0,18,0,18,4,MARET
SULAWESI BARAT,POLEWALI MANDAR,LIMBORO,PENDULANGAN,83,32,15,12,7,1,1,5,8,0,7,2,2,2,0,1,14,8,6,3,11,5,6,5,16,13,3,11,MARET
SULAWESI BARAT,POLEWALI MANDAR,LIMBORO,RENGGEANG,75,80,68,62,50,3,0,17,7,12,35,0,7,1,6,0,45,44,1,6,11,4,7,4,3,1,2,1,MARET
SULAWESI BARAT,POLEWALI MANDAR,LIMBORO,SALARRI,60,47,14,11,0,0,0,14,0,0,14,0,8,8,0,4,29,14,15,9,13,0,13,0,34,2,32,17,MARET
SULAWESI BARAT,POLEWALI MANDAR,LIMBORO,TANGAN BARU,44,54,42,42,40,32,32,6,0,4,15,8,5,2,3,2,39,34,5,21,18,10,8,8,35,17,18,15,MARET
SULAWESI BARAT,POLEWALI MANDAR,LIMBORO,PALECE,60,52,38,22,18,12,11,4,16,4,0,15,11,11,0,5,26,25,1,0,25,8,17,1,3,2,1,0,MARET
SULAWESI BARAT,POLEWALI MANDAR,LUYO,BATUPANGA,81,55,23,12,8,4,4,11,8,0,1,17,5,3,2,0,45,16,29,5,16,1,15,0,35,26,9,14,MARET
SULAWESI BARAT,POLEWALI MANDAR,LUYO,MAMBU,57,31,20,14,13,12,9,0,2,1,15,1,1,0,1,0,18,7,11,5,5,2,3,1,19,10,9,8,MARET
SULAWESI BARAT,POLEWALI MANDAR,LUYO,TENGGELANG,88,26,25,22,8,2,1,5,2,12,21,1,17,8,9,2,18,12,6,8,5,2,3,2,0,0,0,0,MARET
SULAWESI BARAT,POLEWALI MANDAR,LUYO,BARU,33,75,25,15,8,7,5,0,10,4,19,4,4,1,3,0,72,69,3,26,26,15,11,13,78,21,57,39,MARET
SULAWESI BARAT,POLEWALI MANDAR,LUYO,PUSSUI,87,60,25,9,4,2,1,4,5,15,20,1,4,4,0,4,26,20,6,12,10,4,6,2,1,1,0,0,MARET
SULAWESI BARAT,POLEWALI MANDAR,LUYO,MAPILI BARAT,66,69,19,3,2,0,0,7,5,1,6,0,6,5,1,2,37,11,26,9,22,9,13,2,34,0,34,13,MARET
SULAWESI BARAT,POLEWALI MANDAR,LUYO,SAMBALI WALI,68,38,13,12,4,1,0,11,0,2,6,1,9,7,2,5,12,5,7,2,8,0,8,0,16,10,6,10,MARET
SULAWESI BARAT,POLEWALI MANDAR,LUYO,BATUPANGA DAALA,72,76,59,13,13,12,0,29,7,15,25,2,10,3,7,0,30,27,3,7,18,15,3,6,44,24,20,3,MARET
SULAWESI BARAT,POLEWALI MANDAR,LUYO,LUYO,71,80,10,5,4,0,0,4,5,1,0,9,3,3,0,3,27,12,15,9,26,13,13,6,43,36,7,8,MARET
SULAWESI BARAT,POLEWALI MANDAR,LUYO,PUSSUI BARAT,34,56,15,0,0,0,0,1,9,5,7,3,2,2,0,1,16,6,10,6,8,1,7,0,47,9,38,32,MARET
SULAWESI BARAT,POLEWALI MANDAR,LUYO,PUCCADI,67,49,4,3,0,0,0,3,1,0,2,2,3,2,1,1,44,15,29,13,24,19,5,2,44,4,40,41,MARET
SULAWESI BARAT,POLEWALI MANDAR,MAPILLI,MAPILI,46,35,27,0,0,0,0,22,2,3,11,5,2,2,0,1,33,10,23,1,29,25,4,12,30,17,13,11,MARET
SULAWESI BARAT,POLEWALI MANDAR,MAPILLI,UGIBARU,40,30,13,8,8,3,0,7,0,6,6,3,8,5,3,2,10,10,0,0,8,4,4,1,24,11,13,7,MARET
SULAWESI BARAT,POLEWALI MANDAR,MAPILLI,RUMPA,58,17,14,8,2,2,0,9,4,1,12,1,6,1,5,0,16,8,8,8,12,1,11,1,8,0,8,2,MARET
SULAWESI BARAT,POLEWALI MANDAR,MAPILLI,KURMA,41,39,23,6,1,1,1,0,9,11,13,4,8,8,0,6,12,8,4,2,3,2,1,1,13,5,8,9,MARET
SULAWESI BARAT,POLEWALI MANDAR,MAPILLI,BUKU,84,25,2,0,0,0,0,1,0,0,2,0,11,5,6,1,18,18,0,10,8,0,8,0,4,2,2,0,MARET
SULAWESI BARAT,POLEWALI MANDAR,MAPILLI,BONNE BONNE,57,31,13,1,1,1,0,7,3,1,1,4,2,0,2,0,31,12,19,6,28,13,15,11,18,0,18,5,MARET
SULAWESI BARAT,POLEWALI MANDAR,MAPILLI,BEROANGIN,96,65,58,39,29,20,18,11,21,2,50,6,16,14,2,0,59,39,20,10,29,10,19,0,22,18,4,4,MARET
SULAWESI BARAT,POLEWALI MANDAR,MAPILLI,SEGERANG,74,41,39,12,11,0,0,12,27,0,32,5,6,6,0,2,38,20,18,3,19,18,1,0,33,4,29,2,MARET
SULAWESI BARAT,POLEWALI MANDAR,MAPILLI,BONRA,39,44,12,5,0,0,0,9,1,0,2,0,5,4,1,2,28,11,17,1,14,3,11,1,36,34,2,25,MARET
SULAWESI BARAT,POLEWALI MANDAR,MAPILLI,SATTOKO,67,51,13,13,4,3,2,10,1,0,0,10,0,0,0,0,44,37,7,23,38,2,36,1,38,18,20,22,MARET
SULAWESI BARAT,POLEWALI MANDAR,MAPILLI,RAPPANG BARAT,46,60,20,13,8,8,5,12,1,0,6,11,4,4,0,1,34,7,27,7,25,19,6,2,58,16,42,36,MARET
SULAWESI BARAT,POLEWALI MANDAR,MAPILLI,LANDI KANUSUANG,81,48,36,35,1,1,1,1,28,3,4,16,7,7,0,3,23,8,15,0,16,14,2,2,17,7,10,15,MARET
SULAWESI BARAT,POLEWALI MANDAR,MATAKALI,MATAKALI,95,39,3,3,0,0,0,0,3,0,3,0,17,6,11,6,31,20,11,5,19,10,9,7,13,9,4,10,MARET
SULAWESI BARAT,POLEWALI MANDAR,MATAKALI,PETAMPANUA,59,17,6,1,1,0,0,3,3,0,6,0,0,0,0,0,14,12,2,12,2,0,2,0,0,0,0,0,MARET
SULAWESI BARAT,POLEWALI MANDAR,MATAKALI,BARUMBUNG,46,56,56,40,40,9,2,19,5,26,36,16,0,0,0,0,23,17,6,1,9,6,3,4,3,2,1,3,MARET
SULAWESI BARAT,POLEWALI MANDAR,MATAKALI,PASIANG,80,27,0,0,0,0,0,0,0,0,0,0,13,4,9,4,15,9,6,3,2,0,2,0,16,6,10,10,MARET
SULAWESI BARAT,POLEWALI MANDAR,MATAKALI,TONROLIMA,56,44,21,6,6,4,3,8,3,1,8,2,6,3,3,2,14,11,3,9,4,4,0,3,20,16,4,4,MARET
SULAWESI BARAT,POLEWALI MANDAR,MATAKALI,INDOMAKKOMBONG,37,66,53,31,22,8,1,15,0,32,32,5,3,0,3,0,51,50,1,32,1,1,0,1,11,1,10,4,MARET
SULAWESI BARAT,POLEWALI MANDAR,MATAKALI,BUNGA-BUNGA,91,13,11,8,6,6,1,6,3,0,7,3,2,2,0,0,11,11,0,9,9,2,7,1,6,6,0,6,MARET
SULAWESI BARAT,POLEWALI MANDAR,MATANGNGA,MATANGNGA,74,62,21,8,8,8,0,11,1,6,19,2,14,14,0,12,53,19,34,9,33,25,8,25,9,2,7,4,MARET
SULAWESI BARAT,POLEWALI MANDAR,MATANGNGA,LILLI,69,16,5,4,2,2,1,2,1,0,1,2,0,0,0,0,12,11,1,9,6,6,0,6,17,5,12,6,MARET
SULAWESI BARAT,POLEWALI MANDAR,MATANGNGA,RANGOAN,39,40,21,2,1,0,0,12,2,1,17,0,4,3,1,2,22,8,14,3,8,0,8,0,13,1,12,6,MARET
SULAWESI BARAT,POLEWALI MANDAR,MATANGNGA,TAPUA,53,24,7,6,3,2,0,3,3,1,3,2,9,7,2,1,10,6,4,6,3,1,2,1,3,3,0,0,MARET
SULAWESI BARAT,POLEWALI MANDAR,MATANGNGA,MAMBU TAPUA,87,24,13,0,0,0,0,8,4,0,13,0,9,8,1,0,19,5,14,2,12,10,2,2,26,15,11,7,MARET
SULAWESI BARAT,POLEWALI MANDAR,MATANGNGA,BA'BA TAPUA,31,16,3,0,0,0,0,2,1,0,1,2,3,0,3,0,16,9,7,7,13,10,3,6,21,15,6,7,MARET
SULAWESI BARAT,POLEWALI MANDAR,MATANGNGA,KATIMBANG,91,16,16,16,3,0,0,10,1,1,3,9,8,7,1,3,10,6,4,2,6,0,6,0,7,2,5,1,MARET
SULAWESI BARAT,POLEWALI MANDAR,POLEWALI,POLEWALI,84,12,6,4,1,0,0,4,1,1,6,0,0,0,0,0,12,8,4,8,5,1,4,0,8,1,7,0,MARET
SULAWESI BARAT,POLEWALI MANDAR,POLEWALI,WATTANG,85,56,51,30,26,9,5,10,31,2,0,31,13,4,9,2,48,39,9,28,14,7,7,4,20,6,14,14,MARET
SULAWESI BARAT,POLEWALI MANDAR,POLEWALI,SULEWATANG,33,53,21,18,17,17,7,1,3,2,8,13,4,1,3,0,53,48,5,47,28,13,15,10,49,9,40,37,MARET
SULAWESI BARAT,POLEWALI MANDAR,POLEWALI,LANTORA,82,37,35,8,7,5,3,23,7,0,21,8,6,0,6,0,15,7,8,1,7,6,1,5,23,22,1,21,MARET
SULAWESI BARAT,POLEWALI MANDAR,POLEWALI,TAKATIDUNG,84,61,36,9,4,2,0,8,4,20,23,13,7,1,6,0,30,22,8,13,20,18,2,9,30,16,14,24,MARET
SULAWESI BARAT,POLEWALI MANDAR,POLEWALI,PEKKABATA,68,66,34,30,17,3,0,4,14,7,32,0,2,1,1,1,17,9,8,0,3,0,3,0,42,29,13,6,MARET
SULAWESI BARAT,POLEWALI MANDAR,POLEWALI,MADATE,57,65,60,53,6,4,3,26,10,15,42,17,5,4,1,3,18,12,6,8,14,14,0,11,27,27,0,10,MARET
SULAWESI BARAT,POLEWALI MANDAR,POLEWALI,MANDING,45,13,4,0,0,0,0,2,1,1,2,0,6,2,4,0,12,6,6,6,4,0,4,0,10,0,10,8,MARET
SULAWESI BARAT,POLEWALI MANDAR,POLEWALI,DARMA,70,18,13,7,1,0,0,9,0,0,11,2,3,1,2,0,15,5,10,2,6,5,1,4,2,2,0,0,MARET
SULAWESI BARAT,POLEWALI MANDAR,TAPANGO,PELITAKAN,90,46,9,5,0,0,0,1,6,2,9,0,15,9,6,9,23,7,16,4,1,1,0,1,15,14,1,11,MARET
SULAWESI BARAT,POLEWALI MANDAR,TAPANGO,TAPANGO,56,78,39,19,3,3,0,3,13,8,28,0,4,2,2,0,53,22,31,8,14,7,7,1,35,6,29,33,MARET
SULAWESI BARAT,POLEWALI MANDAR,TAPANGO,RAPPANG,63,31,27,13,7,7,3,3,21,0,2,20,9,8,1,3,20,9,11,4,15,1,14,0,14,12,2,10,MARET
SULAWESI BARAT,POLEWALI MANDAR,TAPANGO,DAKKA,99,38,19,3,3,0,0,9,10,0,3,9,15,12,3,1,14,10,4,1,1,1,0,1,17,5,12,16,MARET
SULAWESI BARAT,POLEWALI MANDAR,TAPANGO,BATU,74,10,2,1,0,0,0,0,1,0,2,0,4,0,4,0,10,9,1,7,9,4,5,4,15,2,13,3,MARET
SULAWESI BARAT,POLEWALI MANDAR,TAPANGO,RISO,84,41,17,0,0,0,0,6,11,0,11,6,1,0,1,0,18,9,9,5,16,2,14,0,21,10,11,13,MARET
SULAWESI BARAT,POLEWALI MANDAR,TAPANGO,PALATTA,75,76,0,0,0,0,0,0,0,0,0,0,3,2,1,0,59,30,29,30,36,7,29,6,0,0,0,0,MARET
SULAWESI BARAT,POLEWALI MANDAR,TAPANGO,TAPANGO BARAT,82,79,30,28,15,15,3,19,7,0,11,12,1,0,1,0,54,31,23,20,17,5,12,3,0,0,0,0,MARET
SULAWESI BARAT,POLEWALI MANDAR,TAPANGO,KURRAK,79,59,19,13,4,3,2,1,10,1,18,0,2,2,0,2,28,25,3,14,25,14,11,14,50,2,48,40,MARET
SULAWESI BARAT,POLEWALI MANDAR,TAPANGO,BUSSU,66,41,9,6,2,2,0,3,2,2,4,2,7,2,5,0,15,9,6,8,1,0,1,0,2,2,0,2,MARET
SULAWESI BARAT,POLEWALI MANDAR,TAPANGO,TUTTULA,55,18,8,1,0,0,0,8,0,0,4,4,0,0,0,0,18,13,5,3,12,8,4,2,15,7,8,0,MARET
SULAWESI BARAT,POLEWALI MANDAR,TAPANGO,JAMBU MALEA,84,37,18,9,3,3,0,4,12,0,9,9,3,1,2,0,27,5,22,0,6,0,6,0,6,6,0,2,MARET
SULAWESI BARAT,POLEWALI MANDAR,TAPANGO,KALIMBUA,46,49,22,9,4,4,4,11,2,5,9,1,4,0,4,0,23,17,6,0,8,6,2,6,23,10,13,6,MARET
SULAWESI BARAT,POLEWALI MANDAR,TAPANGO,BANATO REJO,90,65,15,4,0,0,0,6,4,2,7,4,0,0,0,0,23,9,14,0,9,8,1,4,9,7,2,2,MARET
SULAWESI BARAT,POLEWALI MANDAR,TINAMBUNG,TINAMBUNG,46,71,7,3,3,0,0,5,0,0,0,7,2,2,0,2,41,29,12,26,4,0,4,0,17,8,9,16,MARET
SULAWESI BARAT,POLEWALI MANDAR,TINAMBUNG,KARAMA,100,34,1,0,0,0,0,1,0,0,0,1,17,11,6,6,22,15,7,5,7,0,7,0,13,8,5,4,MARET
SULAWESI BARAT,POLEWALI MANDAR,TINAMBUNG,TANGNGA TANGNGA,98,23,12,5,1,1,0,8,0,3,4,4,10,4,6,1,11,7,4,3,8,7,1,0,16,8,8,5,MARET
SULAWESI BARAT,POLEWALI MANDAR,TINAMBUNG,LEKOPADIS,94,23,15,1,0,0,0,7,5,0,2,1,0,0,0,0,11,7,4,3,4,2,2,2,2,2,0,2,MARET
SULAWESI BARAT,POLEWALI MANDAR,TINAMBUNG,GALUNG LOMBOK,33,54,23,6,6,5,4,18,0,1,20,2,6,6,0,1,23,17,6,6,3,2,1,2,20,4,16,16,MARET
SULAWESI BARAT,POLEWALI MANDAR,TINAMBUNG,TANDUNG,88,71,1,1,1,1,0,1,0,0,1,0,15,5,10,2,64,63,1,11,2,2,0,1,20,12,8,14,MARET
SULAWESI BARAT,POLEWALI MANDAR,TINAMBUNG,BATULAYA,73,76,28,17,6,5,1,7,1,17,1,26,1,1,0,1,46,29,17,2,19,8,11,7,55,33,22,17,MARET
SULAWESI BARAT,POLEWALI MANDAR,TINAMBUNG,SEPABATU,97,52,6,4,3,0,0,6,0,0,2,4,10,9,1,8,30,14,16,5,20,10,10,0,19,13,6,14,MARET
SULAWESI BARAT,POLEWALI MANDAR,TUTAR,TARAMANU,36,22,8,0,0,0,0,0,4,2,5,2,4,1,3,0,19,9,10,4,16,6,10,1,4,1,3,0,MARET
SULAWESI BARAT,POLEWALI MANDAR,TUTAR,AMBOPADANG,50,40,4,4,1,1,0,0,2,2,3,0,1,0,1,0,31,31,0,21,29,1,28,1,52,5,47,35,MARET
SULAWESI BARAT,POLEWALI MANDAR,TUTAR,TUBBI,32,66,31,3,0,0,0,17,7,0,18,12,0,0,0,0,17,13,4,2,10,2,8,0,24,7,17,11,MARET
SULAWESI BARAT,POLEWALI MANDAR,TUTAR,RATTE,88,18,3,2,1,1,1,0,2,0,2,1,9,1,8,0,10,10,0,1,7,0,7,0,6,4,2,6,MARET
SULAWESI BARAT,POLEWALI MANDAR,TUTAR,BESOANGIN,97,58,55,7,2,0,0,29,20,2,16,10,2,2,0,0,12,9,3,2,7,1,6,1,15,2,13,10,MARET
SULAWESI BARAT,POLEWALI MANDAR,TUTAR,PIRIANG TAPIKO,94,66,50,48,25,5,3,13,24,7,49,0,4,3,1,0,57,28,29,13,41,3,38,0,72,49,23,35,MARET
SULAWESI BARAT,POLEWALI MANDAR,TUTAR,PEBURRU,32,67,37,14,7,4,0,34,3,0,7,18,5,4,1,4,66,36,30,32,32,21,11,21,46,33,13,30,MARET
SULAWESI BARAT,POLEWALI MANDAR,TUTAR,TALOBA,57,67,10,3,1,1,0,6,2,1,9,0,9,8,1,5,37,25,12,0,10,2,8,0,26,3,23,5,MARET
SULAWESI BARAT,POLEWALI MANDAR,TUTAR,POLLEWANI,64,63,35,33,27,21,12,16,3,3,23,4,8,4,4,2,12,8,4,6,12,12,0,4,53,38,15,50,MARET
SULAWESI BARAT,POLEWALI MANDAR,TUTAR,ARABUA,88,13,5,0,0,0,0,3,2,0,1,3,0,0,0,0,10,8,2,3,1,1,0,0,4,4,0,0,MARET
SULAWESI BARAT,POLEWALI MANDAR,TUTAR,BESOANGIN UTARA,88,65,42,36,3,0,0,18,12,10,38,0,1,1,0,1,25,9,16,1,6,0,6,0,41,32,9,40,MARET
SULAWESI BARAT,POLEWALI MANDAR,TUTAR,PODA,60,78,40,6,6,3,3,3,8,8,14,0,2,1,1,0,45,27,18,6,27,10,17,1,11,9,2,8,MARET
SULAWESI BARAT,POLEWALI MANDAR,TUTAR,TARAMANU TUA,71,47,3,2,1,0,0,3,0,0,2,0,9,7,2,2,20,9,11,5,14,4,10,3,41,28,13,25,MARET
SULAWESI BARAT,POLEWALI MANDAR,WONOMULYO,SIDODADI,58,43,20,0,0,0,0,7,8,3,2,1,11,7,4,3,12,5,7,2,12,12,0,0,4,1,3,3,MARET
SULAWESI BARAT,POLEWALI MANDAR,WONOMULYO,SIDOREJO,87,80,75,24,1,0,0,37,6,25,58,7,5,4,1,3,58,53,5,16,42,39,3,22,46,26,20,17,MARET
SULAWESI BARAT,POLEWALI MANDAR,WONOMULYO,SUMBEREJO,85,59,45,1,0,0,0,4,27,8,35,5,7,2,5,2,50,32,18,11,46,37,9,36,45,39,6,27,MARET
SULAWESI BARAT,POLEWALI MANDAR,WONOMULYO,BUMIAYU,53,75,38,10,10,5,2,17,8,1,4,34,2,0,2,0,50,48,2,38,7,2,5,2,51,4,47,30,MARET
SULAWESI BARAT,POLEWALI MANDAR,WONOMULYO,KEBUNSARI,42,38,5,4,1,0,0,4,1,0,5,0,3,3,0,2,10,8,2,7,10,2,8,2,15,14,1,7,MARET
SULAWESI BARAT,POLEWALI MANDAR,WONOMULYO,BANUA BARU,32,45,41,35,32,1,1,3,31,3,25,0,0,0,0,0,26,24,2,20,1,1,0,1,30,24,6,9,MARET
SULAWESI BARAT,POLEWALI MANDAR,WONOMULYO,NEPO,41,27,7,3,2,1,0,4,1,1,4,2,2,0,2,0,26,6,20,1,21,19,2,5,9,3,6,5,MARET
SULAWESI BARAT,POLEWALI MANDAR,WONOMULYO,SUGIHWARAS,39,57,51,18,5,4,1,29,4,10,27,5,2,1,1,0,27,12,15,5,0,0,0,0,16,16,0,16,MARET
SULAWESI BARAT,POLEWALI MANDAR,WONOMULYO,CAMPURJO,44,19,16,14,4,1,0,6,10,0,0,10,0,0,0,0,14,8,6,3,12,7,5,0,12,7,5,9,MARET
SULAWESI BARAT,POLEWALI MANDAR,WONOMULYO,BUMIMULYO,36,28,20,2,0,0,0,8,1,7,7,0,3,1,2,0,10,8,2,0,0,0,0,0,14,7,7,10,MARET
SULAWESI BARAT,POLEWALI MANDAR,WONOMULYO,TUMPILING,92,68,62,14,12,1,1,42,9,7,21,19,14,3,11,0,46,26,20,6,45,31,14,6,70,52,18,53,MARET
SULAWESI BARAT,POLEWALI MANDAR,WONOMULYO,BAKKA-BAKKA,82,34,15,2,0,0,0,9,4,2,4,0,9,3,6,2,16,15,1,0,10,1,9,0,15,14,1,5,MARET
SULAWESI BARAT,POLEWALI MANDAR,WONOMULYO,ARJO SARI,60,21,9,1,0,0,0,0,1,4,4,5,0,0,0,0,12,5,7,4,2,2,0,0,6,0,6,0,MARET
SULAWESI BARAT,POLEWALI MANDAR,WONOMULYO,GALESON,99,80,12,1,0,0,0,12,0,0,7,1,16,2,14,1,54,37,17,19,17,8,9,8,33,7,26,5,MARET
SULAWESI BARAT,MAMUJU,MAMUJU,BINANGA,60,62,52,9,9,7,1,7,9,19,28,13,11,11,0,5,36,35,1,17,25,12,13,8,7,0,7,2,MARET
SULAWESI BARAT,MAMUJU,MAMUJU,MAMUNYU,69,26,8,7,5,2,1,7,0,0,1,5,10,3,7,2,16,13,3,3,9,3,6,1,27,8,19,2,MARET
SULAWESI BARAT,MAMUJU,MAMUJU,KAREMA,75,16,5,0,0,0,0,4,1,0,0,1,8,4,4,1,14,13,1,7,8,5,3,4,7,7,0,0,MARET
SULAWESI BARAT,MAMUJU,MAMUJU,RIMUKU,77,40,38,3,1,0,0,2,27,3,18,19,14,14,0,1,19,14,5,2,11,8,3,5,15,10,5,13,MARET
SULAWESI BARAT,MAMUJU,MAMUJU,BAMBU,47,53,17,11,7,6,1,7,8,1,4,9,2,1,1,0,39,10,29,9,6,3,3,1,4,1,3,0,MARET
SULAWESI BARAT,MAMUJU,MAMUJU,KARAMPUANG,42,11,1,0,0,0,0,1,0,0,1,0,1,0,1,0,11,11,0,1,5,3,2,2,6,4,2,0,MARET
SULAWESI BARAT,MAMUJU,MAMUJU,TADUI,45,17,0,0,0,0,0,0,0,0,0,0,8,8,0,0,16,5,11,2,8,4,4,2,16,13,3,15,MARET
SULAWESI BARAT,MAMUJU,MAMUJU,BATU PANNU,33,52,16,14,0,0,0,0,5,10,7,0,0,0,0,0,26,12,14,8,1,1,0,0,12,4,8,0,MARET
SULAWESI BARAT,MAMUJU,TAPALANG,GALUNG,85,32,8,8,4,3,0,7,0,0,0,6,8,3,5,2,24,9,15,9,3,0,3,0,9,7,2,5,MARET
SULAWESI BARAT,MAMUJU,TAPALANG,KASAMBANG,70,55,32,27,2,2,0,28,3,1,0,25,9,9,0,7,14,8,6,6,3,0,3,0,40,5,35,15,MARET
SULAWESI BARAT,MAMUJU,TAPALANG,DAYANGINNA,56,27,6,0,0,0,0,4,1,1,4,1,1,0,1,0,12,8,4,0,2,1,1,1,17,1,16,16,MARET
SULAWESI BARAT,MAMUJU,TAPALANG,OROBATU,100,62,50,6,3,1,0,2,24,24,3,44,7,6,1,6,10,8,2,6,1,0,1,0,26,15,11,8,MARET
SULAWESI BARAT,MAMUJU,TAPALANG,TAKANDEANG,32,45,13,9,7,1,1,7,2,0,2,11,5,2,3,2,43,33,10,31,0,0,0,0,2,2,0,1,MARET
SULAWESI BARAT,MAMUJU,TAPALANG,BELA,86,20,14,8,6,4,2,0,3,9,13,0,16,13,3,11,17,5,12,4,2,1,1,0,16,1,15,15,MARET
SULAWESI BARAT,MAMUJU,TAPALANG,TAAN,86,59,31,19,5,0,0,3,24,3,28,1,14,2,12,2,20,5,15,3,12,7,5,1,30,2,28,29,MARET
SULAWESI BARAT,MAMUJU,TAPALANG,TAMPALANG,48,26,7,7,0,0,0,1,4,2,0,7,1,0,1,0,22,10,12,1,13,3,10,1,25,7,18,20,MARET
SULAWESI BARAT,MAMUJU,TAPALANG,RANTEDODA,49,46,40,8,6,1,0,28,5,0,8,30,7,4,3,2,17,12,5,7,9,8,1,4,8,8,0,3,MARET
SULAWESI BARAT,MAMUJU,TAPALANG,KOPEANG,64,66,35,15,15,14,1,34,0,0,27,0,0,0,0,0,11,11,0,10,0,0,0,0,28,4,24,22,MARET
SULAWESI BARAT,MAMUJU,KALUKKU,SINYONYOI,79,72,37,5,3,0,0,24,8,3,19,15,9,8,1,0,11,10,1,3,10,4,6,3,19,15,4,17,MARET
SULAWESI BARAT,MAMUJU,KALUKKU,BEBANGA,34,36,8,2,1,1,0,2,2,4,2,1,0,0,0,0,34,32,2,21,7,6,1,2,0,0,0,0,MARET
SULAWESI BARAT,MAMUJU,KALUKKU,KALUKKU,71,19,15,0,0,0,0,7,7,0,11,1,5,3,2,1,10,7,3,7,1,0,1,0,0,0,0,0,MARET
SULAWESI BARAT,MAMUJU,KALUKKU,SINYONYOI SELATAN,33,53,28,7,5,1,0,21,1,6,14,6,2,2,0,1,47,17,30,0,11,0,11,0,25,19,6,5,MARET
SULAWESI BARAT,MAMUJU,KALUKKU,SONDOANG,67,28,22,12,3,3,2,15,0,3,18,3,7,0,7,0,28,10,18,8,26,8,18,8,35,29,6,21,MARET
SULAWESI BARAT,MAMUJU,KALUKKU,BERU-BERU,87,68,65,29,24,18,0,52,8,0,36,20,7,4,3,3,17,13,4,3,9,6,3,6,56,19,37,41,MARET
SULAWESI BARAT,MAMUJU,KALUKKU,BELANG BELANG,58,31,9,1,1,1,1,7,0,1,7,2,11,8,3,7,27,11,16,7,27,13,14,11,25,21,4,3,MARET
SULAWESI BARAT,MAMUJU,KALUKKU,KABULOANG,85,41,28,22,14,12,5,0,22,1,10,8,5,2,3,2,37,27,10,23,36,23,13,23,58,57,1,11,MARET
SULAWESI BARAT,MAMUJU,KALUKKU,KEANG,86,20,4,1,1,0,0,1,3,0,2,2,8,7,1,2,12,7,5,4,5,2,3,0,17,4,13,11,MARET
SULAWESI BARAT,MAMUJU,KALUKKU,POKKANG,95,46,11,2,0,0,0,3,6,1,11,0,8,8,0,2,38,35,3,7,38,0,38,0,56,19,37,27,MARET
SULAWESI BARAT,MAMUJU,KALUKKU,GULILING,70,14,3,3,3,0,0,0,3,0,3,0,2,1,1,0,13,5,8,0,1,1,0,0,5,0,5,0,MARET
SULAWESI BARAT,MAMUJU,KALUKKU,UHAIMATE,50,35,14,8,2,0,0,5,7,2,10,3,7,7,0,2,10,9,1,5,2,0,2,0,14,14,0,0,MARET
SULAWESI BARAT,MAMUJU,KALUKKU,KALUKKU BARAT,74,53,43,19,19,19,14,13,1,4,29,2,10,1,9,1,18,10,8,2,12,4,8,1,6,4,2,4,MARET
SULAWESI BARAT,MAMUJU,KALUKKU,PAMMULUKANG,51,69,56,55,21,16,3,28,12,11,51,3,1,0,1,0,16,13,3,12,13,7,6,2,36,36,0,36,MARET
SULAWESI BARAT,MAMUJU,KALUMPANG,KALUMPANG,35,40,6,1,1,0,0,5,1,0,6,0,0,0,0,0,14,5,9,0,12,5,7,1,34,16,18,19,MARET
SULAWESI BARAT,MAMUJU,KALUMPANG,KARATAUN,87,31,4,2,1,0,0,2,0,2,1,2,0,0,0,0,24,18,6,8,7,7,0,3,8,1,7,5,MARET
SULAWESI BARAT,MAMUJU,KALUMPANG,KARAMA,67,58,19,11,11,8,6,6,4,2,1,0,4,4,0,1,18,6,12,6,15,15,0,4,5,5,0,2,MARET
SULAWESI BARAT,MAMUJU,KALUMPANG,SIRAUN,33,42,32,19,6,3,1,16,15,0,28,2,6,0,6,0,11,6,5,0,8,5,3,4,15,1,14,2,MARET
SULAWESI BARAT,MAMUJU,KALUMPANG,TUMOGA,91,76,16,3,0,0,0,10,1,5,13,0,14,1,13,0,36,29,7,29,0,0,0,0,32,19,13,3,MARET
SULAWESI BARAT,MAMUJU,KALUMPANG,SALUMAKKI,55,67,63,36,6,6,1,44,9,8,45,8,4,3,1,3,58,48,10,47,19,2,17,0,17,6,11,14,MARET
SULAWESI BARAT,MAMUJU,KALUMPANG,POLIO,92,28,7,3,0,0,0,5,1,0,3,1,16,12,4,11,20,19,1,2,6,5,1,0,12,11,1,10,MARET
SULAWESI BARAT,MAMUJU,KALUMPANG,LIMBONG,100,25,21,3,2,1,1,5,8,6,16,4,20,6,14,3,22,15,7,15,7,1,6,0,17,15,2,10,MARET
SULAWESI BARAT,MAMUJU,KALUMPANG,SANDAPANG,47,74,33,12,3,0,0,27,4,2,9,21,5,4,1,1,64,34,30,20,63,12,51,6,14,1,13,12,MARET
SULAWESI BARAT,MAMUJU,KALUMPANG,KONDO BULO,99,13,8,0,0,0,0,6,0,2,8,0,0,0,0,0,11,5,6,4,7,2,5,0,15,14,1,14,MARET
SULAWESI BARAT,MAMUJU,KALUMPANG,MAKKALIKI,49,12,4,4,3,3,1,1,2,0,4,0,7,2,5,1,12,9,3,7,3,0,3,0,5,2,3,5,MARET
SULAWESI BARAT,MAMUJU,KALUMPANG,BATU MAKKADA,74,58,23,22,10,10,9,5,6,2,8,7,8,7,1,6,31,5,26,3,3,0,3,0,10,2,8,4,MARET
SULAWESI BARAT,MAMUJU,KALUMPANG,LASA',74,18,2,2,2,2,2,0,0,0,1,0,11,6,5,2,16,10,6,3,8,8,0,6,4,0,4,1,MARET
SULAWESI BARAT,MAMUJU,PAPALANG,TOABO,43,18,11,5,1,1,1,4,1,3,7,1,4,3,1,2,16,8,8,8,5,3,2,3,8,4,4,2,MARET
SULAWESI BARAT,MAMUJU,PAPALANG,PAPALANG,83,61,6,1,0,0,0,5,0,0,2,3,12,1,11,1,22,15,7,2,15,7,8,6,57,39,18,16,MARET
SULAWESI BARAT,MAMUJU,PAPALANG,BONDA,77,11,3,2,1,0,0,2,0,0,3,0,11,7,4,5,11,6,5,6,8,6,2,4,14,2,12,11,MARET
SULAWESI BARAT,MAMUJU,PAPALANG,TOPORE,61,17,0,0,0,0,0,0,0,0,0,0,5,3,2,0,15,7,8,7,5,2,3,1,16,12,4,8,MARET
SULAWESI BARAT,MAMUJU,PAPALANG,SALUKAYU,55,31,3,2,1,1,0,2,0,1,3,0,8,7,1,6,14,6,8,1,12,1,11,0,15,10,5,4,MARET
SULAWESI BARAT,MAMUJU,PAPALANG,SUKADAMAI,65,19,9,2,2,0,0,1,3,3,7,2,11,3,8,3,15,7,8,6,13,7,6,2,14,4,10,2,MARET
SULAWESI BARAT,MAMUJU,PAPALANG,BODA-BODA,83,61,15,12,8,0,0,7,2,4,2,1,15,0,15,0,31,23,8,3,6,2,4,2,25,19,6,1,MARET
SULAWESI BARAT,MAMUJU,PAPALANG,SISANGO,93,16,7,5,0,0,0,2,4,1,1,3,0,0,0,0,11,11,0,9,10,9,1,8,1,1,0,0,MARET
SULAWESI BARAT,MAMUJU,PAPALANG,BATU AMPA,89,16,6,2,0,0,0,3,2,1,3,1,15,7,8,3,12,7,5,7,5,0,5,0,0,0,0,0,MARET
SULAWESI BARAT,MAMUJU,SAMPAGA,BUNDE,30,38,7,6,6,6,5,2,0,0,7,0,4,1,3,1,27,12,15,9,9,8,1,3,23,20,3,20,MARET
SULAWESI BARAT,MAMUJU,SAMPAGA,KALONDING,63,42,3,2,2,2,1,2,0,0,0,0,7,0,7,0,13,8,5,6,12,9,3,0,13,8,5,11,MARET
SULAWESI BARAT,MAMUJU,SAMPAGA,TARAILU,37,57,31,3,1,0,0,24,0,4,6,22,6,6,0,3,53,34,19,6,31,15,16,9,65,54,11,10,MARET
SULAWESI BARAT,MAMUJU,SAMPAGA,SAMPAGA,73,16,15,4,4,0,0,2,2,3,7,3,1,1,0,0,15,7,8,1,9,5,4,2,12,1,11,10,MARET
SULAWESI BARAT,MAMUJU,SAMPAGA,TANAMBUAH,47,74,67,20,2,2,0,40,21,5,61,6,5,4,1,2,56,25,31,8,26,0,26,0,3,3,0,3,MARET
SULAWESI BARAT,MAMUJU,SAMPAGA,SALUBARANA,89,35,17,1,1,1,0,2,6,5,17,0,0,0,0,0,33,13,20,13,15,12,3,2,20,2,18,2,MARET
SULAWESI BARAT,MAMUJU,SAMPAGA,LOSSO,96,34,2,0,0,0,0,2,0,0,2,0,19,13,6,4,14,5,9,4,2,0,2,0,14,3,11,5,MARET
SULAWESI BARAT,MAMUJU,TOMMO,TOMMO,76,60,28,2,1,0,0,0,6,18,10,16,7,7,0,6,34,30,4,23,19,8,11,4,12,1,11,5,MARET
SULAWESI BARAT,MAMUJU,TOMMO,CAMPALOGA,86,14,1,0,0,0,0,1,0,0,0,0,3,1,2,1,12,6,6,2,0,0,0,0,3,1,2,1,MARET
SULAWESI BARAT,MAMUJU,TOMMO,BUANA SAKTI,35,29,15,8,8,1,1,7,2,4,9,1,7,7,0,5,25,19,6,8,25,23,2,0,30,5,25,20,MARET
SULAWESI BARAT,MAMUJU,TOMMO,TAMEMONGGA,68,30,30,8,1,0,0,21,5,0,19,6,1,1,0,0,23,19,4,14,20,11,9,9,41,22,19,20,MARET
SULAWESI BARAT,MAMUJU,TOMMO,TAMEJARRA,68,63,20,20,6,5,3,3,9,3,8,12,8,3,5,1,34,32,2,5,25,22,3,7,68,56,12,34,MARET
SULAWESI BARAT,MAMUJU,TOMMO,RANTEMARIO,83,56,27,20,1,0,0,7,2,9,12,1,13,7,6,4,16,8,8,7,2,0,2,0,33,4,29,13,MARET
SULAWESI BARAT,MAMUJU,TOMMO,MALINO,97,46,17,5,4,2,2,13,1,1,11,4,1,0,1,0,22,6,16,2,22,12,10,6,31,4,27,29,MARET
SULAWESI BARAT,MAMUJU,TOMMO,KAKULLASANG,40,38,38,31,30,17,5,23,8,2,5,20,3,0,3,0,32,11,21,9,17,8,9,1,5,3,2,3,MARET
SULAWESI BARAT,MAMUJU,TOMMO,LELING,57,77,57,10,7,2,0,7,4,34,7,36,4,3,1,0,49,30,19,11,8,0,8,0,15,3,12,2,MARET
SULAWESI BARAT,MAMUJU,TOMMO,KALEPU,32,79,78,72,6,2,0,60,12,3,25,18,1,1,0,1,21,9,12,6,8,4,4,1,4,4,0,4,MARET
SULAWESI BARAT,MAMUJU,TOMMO,SANDANA,33,58,34,26,4,1,1,0,9,5,5,20,6,5,1,3,21,17,4,13,5,3,2,0,1,1,0,1,MARET
SULAWESI BARAT,MAMUJU,TOMMO,LELING BARAT,30,67,2,2,1,0,0,2,0,0,2,0,3,2,1,1,36,7,29,2,33,28,5,27,14,2,12,9,MARET
SULAWESI BARAT,MAMUJU,TOMMO,LELING UTARA,93,74,12,8,2,0,0,4,0,6,9,3,1,1,0,1,69,22,47,10,9,3,6,1,58,24,34,36,MARET
SULAWESI BARAT,MAMUJU,TOMMO,SALUDENGEN,89,68,22,2,1,0,0,2,2,14,21,0,8,6,2,5,54,39,15,22,20,16,4,12,55,53,2,45,MARET
SULAWESI BARAT,MAMUJU,SIMBORO DAN KEPULAUAN,SIMBORO,78,69,18,16,11,7,0,0,7,7,12,0,11,8,3,7,36,29,7,24,23,7,16,1,25,13,12,13,MARET
SULAWESI BARAT,MAMUJU,SIMBORO DAN KEPULAUAN,RANGAS,36,27,17,8,3,3,1,14,2,0,8,3,4,2,2,0,10,6,4,1,7,4,3,0,8,0,8,0,MARET
SULAWESI BARAT,MAMUJU,SIMBORO DAN KEPULAUAN,BOTTENG,64,22,22,16,12,6,2,10,9,0,21,1,3,0,3,0,19,6,13,3,18,2,16,0,4,2,2,1,MARET
SULAWESI BARAT,MAMUJU,SIMBORO DAN KEPULAUAN,SALETTO,40,25,8,3,1,0,0,6,2,0,7,1,4,4,0,2,23,6,17,1,7,3,4,3,24,24,0,14,MARET
SULAWESI BARAT,MAMUJU,SIMBORO DAN KEPULAUAN,SUMARE,36,28,7,3,0,0,0,1,3,3,5,1,3,1,2,0,14,13,1,13,1,0,1,0,18,6,12,7,MARET
SULAWESI BARAT,MAMUJU,SIMBORO DAN KEPULAUAN,BOTTENG UTARA,100,39,34,4,3,2,1,3,29,1,7,2,1,0,1,0,28,20,8,0,9,8,1,3,31,23,8,23,MARET
SULAWESI BARAT,MAMUJU,SIMBORO DAN KEPULAUAN,TAPANDULLU,97,14,6,3,0,0,0,3,3,0,5,1,8,8,0,8,10,7,3,4,6,0,6,0,8,4,4,6,MARET
SULAWESI BARAT,MAMUJU,SIMBORO DAN KEPULAUAN,PATI'DI,78,35,33,19,7,6,4,11,16,0,30,1,15,7,8,6,25,22,3,3,12,0,12,0,17,12,5,11,MARET
SULAWESI BARAT,MAMUJU,TAPALANG BARAT,DUNGKAIT,91,61,25,5,4,0,0,16,4,2,1,2,2,1,1,0,18,18,0,0,4,0,4,0,8,5,3,7,MARET
SULAWESI BARAT,MAMUJU,TAPALANG BARAT,LEBANI,38,30,17,16,4,2,0,10,3,4,0,0,4,1,3,0,30,24,6,15,9,4,5,3,11,11,0,7,MARET
SULAWESI BARAT,MAMUJU,TAPALANG BARAT,LABUANG RANO,92,23,20,20,16,10,0,18,2,0,6,12,15,4,11,3,21,21,0,13,19,0,19,0,4,0,4,4,MARET
SULAWESI BARAT,MAMUJU,TAPALANG BARAT,PASABU,86,50,30,22,8,1,1,1,13,9,27,0,5,1,4,1,32,19,13,8,15,13,2,0,43,26,17,21,MARET
SULAWESI BARAT,MAMUJU,TAPALANG BARAT,TANETE PAO,88,36,17,6,4,2,0,8,3,5,2,6,10,8,2,6,27,16,11,9,1,1,0,0,3,1,2,3,MARET
SULAWESI BARAT,MAMUJU,TAPALANG BARAT,PANGASAAN,99,77,72,26,5,0,0,16,42,3,53,11,15,5,10,5,29,19,10,8,27,27,0,6,51,31,20,29,MARET
SULAWESI BARAT,MAMUJU,TAPALANG BARAT,AHU,38,19,7,1,0,0,0,6,0,1,1,3,5,0,5,0,17,12,5,12,12,4,8,0,6,4,2,5,MARET
SULAWESI BARAT,MAMUJU,BONEHAU,BONEHAU,54,68,37,32,29,22,5,30,2,0,22,15,4,2,2,2,49,6,43,3,5,1,4,0,4,2,2,0,MARET
SULAWESI BARAT,MAMUJU,BONEHAU,SALUTIWO,57,46,29,1,1,1,0,22,3,2,15,1,5,5,0,2,13,5,8,2,0,0,0,0,13,6,7,5,MARET
SULAWESI BARAT,MAMUJU,BONEHAU,BUTTUADA,74,56,23,5,4,0,0,12,6,4,4,9,6,2,4,0,38,15,23,8,20,20,0,18,59,35,24,16,MARET
SULAWESI BARAT,MAMUJU,BONEHAU,TAMALEA,97,78,19,8,5,5,4,5,2,7,17,1,4,3,1,3,41,28,13,18,12,11,1,11,35,12,23,23,MARET
SULAWESI BARAT,MAMUJU,BONEHAU,LUMIKA,37,25,6,3,1,0,0,2,4,0,1,5,5,0,5,0,15,9,6,4,8,7,1,0,9,0,9,7,MARET
SULAWESI BARAT,MAMUJU,BONEHAU,MAPPU,94,28,18,14,11,11,3,0,5,2,18,0,18,9,9,3,27,14,13,7,2,1,1,0,16,10,6,2,MARET
SULAWESI BARAT,MAMUJU,BONEHAU,BANUADA,37,31,3,1,0,0,0,1,1,1,1,0,1,1,0,1,17,6,11,0,15,2,13,1,20,14,6,6,MARET
SULAWESI BARAT,MAMUJU,BONEHAU,HINUA,86,59,34,3,0,0,0,34,0,0,4,3,4,1,3,1,32,21,11,17,6,1,5,1,10,4,6,6,MARET
SULAWESI BARAT,MAMUJU,BONEHAU,KINATANG,100,66,17,14,11,2,1,4,6,1,5,6,7,2,5,1,51,33,18,16,28,26,2,4,25,3,22,0,MARET
SULAWESI BARAT,MAMUJU,KEP. BALA BALAKANG,BALA BALAKANG,68,75,24,7,2,1,1,2,16,4,9,8,9,7,2,6,33,30,3,15,9,7,2,7,23,13,10,14,MARET
SULAWESI BARAT,MAMUJU,KEP. BALA BALAKANG,BALA-BALAKANG TIMUR,82,42,9,3,0,0,0,9,0,0,3,2,1,1,0,0,29,9,20,1,28,16,12,2,28,19,9,6,MARET
SULAWESI BARAT,MAMUJU TENGAH,TOBADAK,MAHAHE,55,35,13,5,1,1,1,4,6,0,9,0,3,0,3,0,29,28,1,18,11,2,9,1,31,3,28,2,APRIL
SULAWESI BARAT,MAMUJU TENGAH,TOBADAK,SALOBAJA,64,76,45,31,25,16,9,4,19,13,26,15,10,2,8,1,21,7,14,5,3,1,2,0,2,1,1,0,APRIL
SULAWESI BARAT,MAMUJU TENGAH,TOBADAK,TOBADAK,34,59,12,10,8,4,0,2,8,0,12,0,2,2,0,2,13,5,8,1,10,10,0,9,42,8,34,3,APRIL
SULAWESI BARAT,MAMUJU TENGAH,TOBADAK,PALONGAAN,43,27,25,24,5,3,2,10,0,11,25,0,0,0,0,0,20,12,8,0,18,4,14,4,2,1,1,2,APRIL
SULAWESI BARAT,MAMUJU TENGAH,TOBADAK,BATU PARIGI,42,37,28,26,22,5,1,18,1,0,23,4,0,0,0,0,16,7,9,6,3,0,3,0,24,18,6,11,APRIL
SULAWESI BARAT,MAMUJU TENGAH,TOBADAK,BAMBADARU,76,58,11,1,0,0,0,1,6,3,7,0,12,2,10,2,34,28,6,23,4,0,4,0,8,3,5,4,APRIL
SULAWESI BARAT,MAMUJU TENGAH,TOBADAK,SEJATI,40,78,68,40,1,1,0,16,0,37,23,16,1,1,0,0,45,37,8,32,4,0,4,0,20,13,7,12,APRIL
SULAWESI BARAT,MAMUJU TENGAH,TOBADAK,SALOADAK,62,33,30,7,3,1,0,18,4,3,17,7,10,7,3,0,13,8,5,7,0,0,0,0,1,1,0,1,APRIL
SULAWESI BARAT,MAMUJU TENGAH,PANGALE,POLO PANGALE,78,14,1,0,0,0,0,0,1,0,0,1,13,13,0,1,13,11,2,3,10,3,7,1,13,1,12,4,APRIL
SULAWESI BARAT,MAMUJU TENGAH,PANGALE,PANGALE,71,68,38,4,3,1,0,1,31,5,28,10,7,1,6,1,55,19,36,11,55,23,32,19,55,25,30,40,APRIL
SULAWESI BARAT,MAMUJU TENGAH,PANGALE,SARTANAMAJU,62,15,12,5,4,3,0,10,0,1,11,1,12,8,4,4,15,12,3,4,6,2,4,2,2,1,1,1,APRIL
SULAWESI BARAT,MAMUJU TENGAH,PANGALE,POLO LERENG,87,42,3,3,1,1,1,0,0,1,3,0,17,17,0,2,41,39,2,22,1,0,1,0,13,13,0,4,APRIL
SULAWESI BARAT,MAMUJU TENGAH,PANGALE,KUO,94,16,13,13,10,4,1,3,2,0,10,3,11,2,9,2,12,11,1,9,1,1,0,1,9,4,5,8,APRIL
SULAWESI BARAT,MAMUJU TENGAH,PANGALE,POLO CAMBA,93,30,2,2,1,0,0,2,0,0,0,1,15,5,10,3,30,5,25,2,2,1,1,1,6,4,2,2,APRIL
SULAWESI BARAT,MAMUJU TENGAH,PANGALE,LAMBA-LAMBA,33,61,44,22,16,9,6,6,5,17,43,0,4,2,2,0,52,39,13,33,42,37,5,17,49,8,41,40,APRIL
SULAWESI BARAT,MAMUJU TENGAH,PANGALE,KOMBILING,78,58,45,26,14,7,3,12,13,10,10,15,2,2,0,1,56,46,10,6,6,4,2,1,34,30,4,24,APRIL
SULAWESI BARAT,MAMUJU TENGAH,PANGALE,LEMO-LEMO,76,67,12,8,0,0,0,2,9,1,5,2,2,1,1,0,12,8,4,0,12,5,7,1,42,7,35,9,APRIL
SULAWESI BARAT,MAMUJU TENGAH,BUDONG-BUDONG,BABANA,59,74,0,0,0,0,0,0,0,0,0,0,3,2,1,2,32,18,14,11,2,1,1,1,39,9,30,37,APRIL
SULAWESI BARAT,MAMUJU TENGAH,BUDONG-BUDONG,LUMU,67,50,16,4,2,1,0,13,1,1,13,2,12,5,7,3,36,23,13,17,30,1,29,1,60,31,29,17,APRIL
SULAWESI BARAT,MAMUJU TENGAH,BUDONG-BUDONG,PONTANAKAYANG,73,59,52,41,12,0,0,23,23,3,6,31,12,11,1,11,52,41,11,14,34,26,8,15,31,7,24,7,APRIL
SULAWESI BARAT,MAMUJU TENGAH,BUDONG-BUDONG,SALOGATTA,38,12,1,0,0,0,0,0,1,0,0,1,1,0,1,0,11,6,5,5,0,0,0,0,0,0,0,0,APRIL
SULAWESI BARAT,MAMUJU TENGAH,BUDONG-BUDONG,KIRE,96,63,48,16,7,1,1,17,16,6,33,8,3,1,2,1,57,13,44,7,30,5,25,2,30,3,27,5,APRIL
SULAWESI BARAT,MAMUJU TENGAH,BUDONG-BUDONG,TINALI,88,24,19,6,0,0,0,10,5,0,17,0,7,4,3,0,24,22,2,17,12,6,6,6,7,2,5,6,APRIL
SULAWESI BARAT,MAMUJU TENGAH,BUDONG-BUDONG,SALUMANURUNG,71,55,38,26,7,5,3,4,15,2,24,12,6,5,1,0,27,15,12,8,21,9,12,3,19,0,19,6,APRIL
SULAWESI BARAT,MAMUJU TENGAH,BUDONG-BUDONG,PASAPA,96,78,22,14,0,0,0,3,17,1,13,4,16,3,13,3,64,17,47,2,56,3,53,1,58,19,39,20,APRIL
SULAWESI BARAT,MAMUJU TENGAH,BUDONG-BUDONG,BOJO,93,59,20,7,4,4,1,10,6,3,14,3,8,2,6,0,43,42,1,22,0,0,0,0,28,8,20,24,APRIL
SULAWESI BARAT,MAMUJU TENGAH,BUDONG-BUDONG,BARAKKANG,54,63,8,2,1,0,0,6,1,1,3,0,9,9,0,2,33,23,10,21,11,3,8,1,20,13,7,14,APRIL
SULAWESI BARAT,MAMUJU TENGAH,BUDONG-BUDONG,LEMBAH HADA,82,14,3,1,0,0,0,2,1,0,1,0,8,8,0,7,10,7,3,2,9,8,1,1,11,4,7,7,APRIL
SULAWESI BARAT,MAMUJU TENGAH,TOPOYO,BUDONG-BUDONG,77,32,24,16,10,5,3,20,0,1,8,6,0,0,0,0,15,11,4,2,7,6,1,3,23,0,23,2,APRIL
SULAWESI BARAT,MAMUJU TENGAH,TOPOYO,TOPOYO,54,70,6,4,2,0,0,6,0,0,2,4,1,1,0,1,35,21,14,7,18,1,17,1,52,45,7,41,APRIL
SULAWESI BARAT,MAMUJU TENGAH,TOPOYO,TUMBU,66,55,45,31,9,1,0,30,8,1,21,19,6,3,3,2,27,17,10,4,22,16,6,9,57,2,55,14,APRIL
SULAWESI BARAT,MAMUJU TENGAH,TOPOYO,KABUBU,40,21,14,7,1,1,1,11,0,1,13,0,7,0,7,0,11,10,1,9,10,7,3,2,23,23,0,18,APRIL
SULAWESI BARAT,MAMUJU TENGAH,TOPOYO,WAEPUTEH,30,59,14,13,7,0,0,3,11,0,3,7,5,2,3,2,56,50,6,45,56,48,8,23,79,67,12,56,APRIL
SULAWESI BARAT,MAMUJU TENGAH,TOPOYO,TANGKOU,92,63,42,31,30,5,2,9,19,3,19,6,8,3,5,3,11,6,5,3,10,7,3,1,3,2,1,3,APRIL
SULAWESI BARAT,MAMUJU TENGAH,TOPOYO,TABOLANG,83,80,14,12,5,2,2,8,0,4,8,3,1,0,1,0,23,19,4,18,4,1,3,1,11,7,4,10,APRIL
SULAWESI BARAT,MAMUJU TENGAH,TOPOYO,PARAILI,55,71,1,0,0,0,0,1,0,0,1,0,1,1,0,1,36,32,4,11,11,11,0,0,3,1,2,2,APRIL
SULAWESI BARAT,MAMUJU TENGAH,TOPOYO,SALUPANGKANG,33,39,1,1,1,0,0,0,1,0,1,0,4,3,1,0,37,17,20,15,6,3,3,3,30,5,25,20,APRIL
SULAWESI BARAT,MAMUJU TENGAH,TOPOYO,SALUPANGKANG IV,86,34,9,9,8,3,1,7,0,0,9,0,2,2,0,2,12,7,5,0,7,3,4,2,10,3,7,3,APRIL
SULAWESI BARAT,MAMUJU TENGAH,TOPOYO,TAPPILINA,69,37,21,3,0,0,0,11,9,1,3,18,6,3,3,3,29,21,8,7,13,11,2,1,17,7,10,8,APRIL
SULAWESI BARAT,MAMUJU TENGAH,TOPOYO,BAMBAMANURUNG,81,40,6,5,4,0,0,4,1,0,3,3,14,10,4,9,23,22,1,12,16,12,4,9,0,0,0,0,APRIL
SULAWESI BARAT,MAMUJU TENGAH,TOPOYO,SALULEKBO,69,39,23,15,7,7,3,14,3,3,6,4,12,1,11,1,29,5,24,5,18,10,8,1,3,0,3,2,APRIL
SULAWESI BARAT,MAMUJU TENGAH,TOPOYO,PANGALLOANG,90,62,61,35,14,11,10,27,21,3,56,5,13,0,13,0,11,8,3,8,9,4,5,4,44,43,1,36,APRIL
SULAWESI BARAT,MAMUJU TENGAH,TOPOYO,SINABATTA,93,38,18,0,0,0,0,14,1,3,8,3,3,1,2,1,10,7,3,2,4,4,0,4,15,9,6,7,APRIL
SULAWESI BARAT,MAMUJU TENGAH,KAROSSA,KAROSSA,97,78,49,6,5,3,1,30,5,0,0,42,0,0,0,0,11,9,2,0,10,1,9,0,57,37,20,14,APRIL
SULAWESI BARAT,MAMUJU TENGAH,KAROSSA,TASOKKO,55,78,6,2,2,2,1,3,0,0,6,0,7,0,7,0,75,29,46,29,3,0,3,0,13,13,0,13,APRIL
SULAWESI BARAT,MAMUJU TENGAH,KAROSSA,LARA,81,52,36,1,0,0,0,14,4,9,24,9,15,10,5,1,32,27,5,8,17,6,11,6,14,6,8,1,APRIL
SULAWESI BARAT,MAMUJU TENGAH,KAROSSA,KADAILA,98,14,0,0,0,0,0,0,0,0,0,0,4,4,0,3,14,6,8,2,1,1,0,0,1,1,0,1,APRIL
SULAWESI BARAT,MAMUJU TENGAH,KAROSSA,KAYU CALLA,86,33,32,9,3,2,1,7,1,1,5,0,12,0,12,0,12,9,3,9,7,5,2,0,27,25,2,1,APRIL
SULAWESI BARAT,MAMUJU TENGAH,KAROSSA,LEMBAH HOPO,60,49,34,3,0,0,0,28,2,3,24,1,11,0,11,0,24,6,18,1,2,0,2,0,11,6,5,0,APRIL
SULAWESI BARAT,MAMUJU TENGAH,KAROSSA,BENGGAULU,81,40,30,10,9,9,2,15,0,7,22,1,9,1,8,1,33,11,22,6,27,9,18,1,33,17,16,17,APRIL
SULAWESI BARAT,MAMUJU TENGAH,KAROSSA,SUKA MAJU,98,67,20,10,5,2,1,12,1,4,16,4,3,0,3,0,56,34,22,6,10,9,1,8,40,23,17,6,APRIL
SULAWESI BARAT,MAMUJU TENGAH,KAROSSA,KAMBUNONG,97,22,21,7,5,5,0,11,4,5,20,0,7,4,3,4,13,13,0,2,7,2,5,0,0,0,0,0,APRIL
SULAWESI BARAT,MAMUJU TENGAH,KAROSSA,SALUBIRO,30,37,17,6,1,1,1,5,9,2,1,9,0,0,0,0,25,20,5,20,20,1,19,0,7,0,7,6,APRIL
SULAWESI BARAT,MAMUJU TENGAH,KAROSSA,SANJANGO,48,60,22,10,6,5,5,2,7,5,11,4,2,0,2,0,26,8,18,7,14,8,6,1,18,7,11,18,APRIL
SULAWESI BARAT,PASANGKAYU,BAMBAIRA,TAMPAURE,44,49,42,6,3,0,0,4,15,9,8,32,2,0,2,0,23,14,9,4,20,5,15,5,14,12,2,13,APRIL
SULAWESI BARAT,PASANGKAYU,BAMBAIRA,BAMBAIRA,46,29,21,14,3,1,0,7,7,2,15,0,8,7,1,3,26,13,13,11,25,25,0,13,0,0,0,0,APRIL
SULAWESI BARAT,PASANGKAYU,BAMBAIRA,KASOLOANG,73,22,9,8,3,1,1,5,1,0,1,2,12,12,0,1,12,10,2,1,10,0,10,0,24,12,12,12,APRIL
SULAWESI BARAT,PASANGKAYU,BAMBAIRA,KALUKU NANGKA,72,74,48,4,4,0,0,4,28,12,7,18,10,5,5,1,47,45,2,29,30,2,28,2,67,39,28,59,APRIL
SULAWESI BARAT,PASANGKAYU,BAMBALAMOTU,RANDOMAYANG,65,57,26,0,0,0,0,22,4,0,25,1,13,6,7,2,54,43,11,40,16,15,1,0,0,0,0,0,APRIL
SULAWESI BARAT,PASANGKAYU,BAMBALAMOTU,BAMBALAMOTU,63,60,56,32,11,1,1,43,1,3,34,22,2,0,2,0,22,14,8,6,2,0,2,0,44,4,40,27,APRIL
SULAWESI BARAT,PASANGKAYU,BAMBALAMOTU,POLEWALI,30,40,29,20,5,5,3,0,1,12,12,11,0,0,0,0,32,14,18,7,10,7,3,1,11,7,4,9,APRIL
SULAWESI BARAT,PASANGKAYU,BAMBALAMOTU,PANGIANG,35,57,51,1,0,0,0,44,2,4,49,0,0,0,0,0,42,31,11,16,25,9,16,7,1,1,0,0,APRIL
SULAWESI BARAT,PASANGKAYU,BAMBALAMOTU,KALOLA,66,40,29,29,0,0,0,6,13,5,7,17,1,1,0,0,29,21,8,0,17,14,3,1,7,0,7,3,APRIL
SULAWESI BARAT,PASANGKAYU,BAMBALAMOTU,WULAI,47,42,13,0,0,0,0,0,0,11,5,7,3,0,3,0,37,26,11,6,21,7,14,7,49,44,5,30,APRIL
SULAWESI BARAT,PASANGKAYU,BARAS,BARAS,39,52,42,27,19,9,6,1,29,2,14,27,6,2,4,0,33,33,0,13,24,24,0,15,27,14,13,23,APRIL
SULAWESI BARAT,PASANGKAYU,BARAS,BULU PARIGI,59,76,22,17,0,0,0,18,3,1,12,2,10,3,7,1,33,25,8,3,14,7,7,1,58,48,10,43,APRIL
SULAWESI BARAT,PASANGKAYU,BARAS,BALANTI,44,29,20,20,2,1,0,11,1,0,0,4,1,1,0,0,21,5,16,1,15,4,11,2,1,0,1,1,APRIL
SULAWESI BARAT,PASANGKAYU,BARAS,MOTU,70,42,25,5,5,5,2,6,3,12,23,0,5,3,2,1,19,11,8,7,18,13,5,12,35,27,8,15,APRIL
SULAWESI BARAT,PASANGKAYU,BARAS,TOWONI,39,47,40,6,6,3,0,37,2,1,6,21,6,2,4,1,31,13,18,10,8,4,4,3,23,21,2,15,APRIL
SULAWESI BARAT,PASANGKAYU,BARAS,KASANO,59,28,18,1,0,0,0,7,9,0,13,1,3,3,0,2,12,10,2,5,5,5,0,3,4,4,0,3,APRIL
SULAWESI BARAT,PASANGKAYU,BULU TABA,SUMBER SARI,45,58,40,8,7,2,2,10,25,0,2,17,6,5,1,3,49,17,32,15,12,11,1,8,12,9,3,10,APRIL
SULAWESI BARAT,PASANGKAYU,BULU TABA,LELEJAE,56,38,22,4,1,0,0,10,6,1,6,6,4,3,1,3,16,14,2,6,14,10,4,0,28,20,8,5,APRIL
SULAWESI BARAT,PASANGKAYU,BULU TABA,BUKIT HARAPAN,63,14,3,1,1,0,0,0,3,0,0,2,9,3,6,2,11,6,5,6,5,3,2,3,8,8,0,6,APRIL
SULAWESI BARAT,PASANGKAYU,BULU TABA,LILIMORI,92,28,12,1,0,0,0,0,11,1,10,2,1,1,0,0,22,20,2,13,17,1,16,1,5,1,4,3,APRIL
SULAWESI BARAT,PASANGKAYU,BULU TABA,KARAVE,97,47,36,3,0,0,0,2,26,1,30,0,11,7,4,1,34,34,0,18,24,13,11,12,21,3,18,8,APRIL
SULAWESI BARAT,PASANGKAYU,BULU TABA,KASTABUANA,56,62,30,18,6,2,0,10,3,15,10,8,0,0,0,0,23,5,18,2,14,8,6,3,27,9,18,24,APRIL
SULAWESI BARAT,PASANGKAYU,BULU TABA,OMPI,99,28,20,0,0,0,0,4,7,5,4,14,6,4,2,1,28,20,8,4,12,0,12,0,25,5,20,9,APRIL
SULAWESI BARAT,PASANGKAYU,DAPURANG,DAPURANG,71,19,3,3,1,0,0,0,0,3,0,0,5,4,1,2,19,18,1,3,18,11,7,10,20,4,16,13,APRIL
SULAWESI BARAT,PASANGKAYU,DAPURANG,BENGGAULU,85,71,6,4,1,0,0,3,0,1,1,3,17,2,15,1,71,68,3,64,34,32,2,11,83,44,39,13,APRIL
SULAWESI BARAT,PASANGKAYU,DAPURANG,TIRTABUANA,53,49,33,1,0,0,0,32,1,0,22,9,4,1,3,1,27,15,12,9,7,4,3,1,41,5,36,17,APRIL
SULAWESI BARAT,PASANGKAYU,DAPURANG,BULU BONGGU,47,76,20,5,4,0,0,18,0,2,6,7,2,1,1,1,76,56,20,6,27,6,21,1,22,10,12,17,APRIL
SULAWESI BARAT,PASANGKAYU,DAPURANG,SARASA,84,17,7,7,5,0,0,6,0,0,3,4,15,0,15,0,15,14,1,13,4,3,1,0,3,0,3,1,APRIL
SULAWESI BARAT,PASANGKAYU,DURIPOKU,TAMMARUNANG,81,30,29,26,0,0,0,10,19,0,25,4,4,0,4,0,17,16,1,11,2,0,2,0,14,10,4,9,APRIL
SULAWESI BARAT,PASANGKAYU,DURIPOKU,SAPTANAJAYA,58,51,4,3,1,1,0,4,0,0,0,0,6,4,2,2,45,40,5,23,39,24,15,1,1,1,0,0,APRIL
SULAWESI BARAT,PASANGKAYU,DURIPOKU,TARANGGI,79,50,22,6,4,2,0,10,4,6,2,14,14,13,1,10,18,6,12,2,14,6,8,5,45,17,28,8,APRIL
SULAWESI BARAT,PASANGKAYU,DURIPOKU,SIPAKAINGA,74,72,42,26,0,0,0,8,22,2,31,3,14,4,10,1,67,66,1,12,53,6,47,6,95,41,54,20,APRIL
SULAWESI BARAT,PASANGKAYU,LARIANG,KULU,50,17,15,2,1,0,0,3,7,5,1,13,6,1,5,1,10,10,0,9,2,1,1,0,8,5,3,6,APRIL
SULAWESI BARAT,PASANGKAYU,LARIANG,PARABU,67,18,4,3,2,0,0,1,1,2,4,0,12,11,1,8,12,5,7,2,8,6,2,2,8,0,8,5,APRIL
SULAWESI BARAT,PASANGKAYU,LARIANG,KENANGAN,79,13,13,11,0,0,0,2,9,2,10,2,12,10,2,3,13,10,3,4,8,3,5,1,7,0,7,2,APRIL
SULAWESI BARAT,PASANGKAYU,LARIANG,BAJAWALI,97,40,24,21,7,2,0,16,8,0,23,0,11,1,10,0,25,8,17,3,25,15,10,1,25,6,19,2,APRIL
SULAWESI BARAT,PASANGKAYU,LARIANG,SINGGANI,70,13,11,8,3,0,0,4,4,1,1,2,10,8,2,1,10,5,5,0,5,4,1,1,5,2,3,1,APRIL
SULAWESI BARAT,PASANGKAYU,LARIANG,BATU MATORU,49,57,40,37,1,0,0,15,23,2,29,5,1,0,1,0,15,9,6,0,0,0,0,0,21,3,18,6,APRIL
SULAWESI BARAT,PASANGKAYU,LARIANG,BAMBAKORO,49,41,41,8,8,6,6,10,8,0,32,6,6,6,0,4,40,13,27,12,7,7,0,0,17,8,9,14,APRIL
SULAWESI BARAT,PASANGKAYU,PASANGKAYU,KARYA BERSAMA,87,27,9,2,1,0,0,9,0,0,4,5,3,0,3,0,18,13,5,9,12,11,1,11,14,13,1,0,APRIL
SULAWESI BARAT,PASANGKAYU,PASANGKAYU,AKO,78,31,12,7,6,3,2,4,0,0,4,5,1,1,0,1,17,5,12,0,13,3,10,0,2,2,0,0,APRIL
SULAWESI BARAT,PASANGKAYU,PASANGKAYU,PASANGKAYU,60,51,17,7,4,1,1,6,6,2,7,8,9,2,7,1,22,16,6,13,0,0,0,0,9,6,3,8,APRIL
SULAWESI BARAT,PASANGKAYU,PASANGKAYU,MARTAJAYA,46,32,16,5,3,1,1,0,4,4,8,4,5,1,4,0,10,6,4,1,6,6,0,3,10,0,10,9,APRIL
SULAWESI BARAT,PASANGKAYU,PASANGKAYU,PAKAVA,63,36,12,4,1,0,0,10,0,1,6,6,4,3,1,0,13,6,7,2,12,9,3,4,24,7,17,0,APRIL
SULAWESI BARAT,PASANGKAYU,PASANGKAYU,GUNUNG SARI,75,40,16,16,16,12,7,2,5,1,12,3,13,10,3,2,13,8,5,4,10,7,3,2,19,1,18,2,APRIL
SULAWESI BARAT,PASANGKAYU,PEDONGGA,MALEI,40,68,5,5,0,0,0,3,0,2,3,1,1,1,0,1,29,29,0,6,0,0,0,0,10,4,6,1,APRIL
SULAWESI BARAT,PASANGKAYU,PEDONGGA,PEDANDA,47,18,6,6,3,0,0,0,4,2,4,2,5,1,4,1,10,9,1,9,2,1,1,0,9,5,4,7,APRIL
SULAWESI BARAT,PASANGKAYU,PEDONGGA,BATU OGE,57,63,5,1,1,0,0,0,0,3,3,2,6,6,0,3,51,39,12,13,15,12,3,2,7,6,1,6,APRIL
SULAWESI BARAT,PASANGKAYU,PEDONGGA,MARTASARI,31,68,23,15,7,3,0,19,4,0,13,3,1,0,1,0,66,8,58,4,56,11,45,5,55,36,19,39,APRIL
SULAWESI BARAT,PASANGKAYU,SARJO,SARJO,50,39,24,13,11,1,0,0,13,4,10,9,4,3,1,3,34,19,15,10,14,5,9,1,6,3,3,5,APRIL
SULAWESI BARAT,PASANGKAYU,SARJO,MAPONU,79,37,35,21,4,0,0,5,24,0,17,15,15,8,7,8,29,7,22,6,25,23,2,5,38,1,37,21,APRIL
SULAWESI BARAT,PASANGKAYU,SARJO,LETAWA,60,24,0,0,0,0,0,0,0,0,0,0,2,1,1,1,17,15,2,0,15,14,1,6,13,1,12,10,APRIL
SULAWESI BARAT,PASANGKAYU,SARJO,SARUDE,39,52,35,28,11,11,6,11,3,1,19,8,0,0,0,0,45,39,6,10,31,31,0,19,9,6,3,1,APRIL
SULAWESI BARAT,PASANGKAYU,SARUDU,DODA,57,29,17,4,1,1,0,5,6,5,9,8,5,3,2,2,17,17,0,16,10,5,5,0,12,2,10,9,APRIL
SULAWESI BARAT,PASANGKAYU,SARUDU,SARUDU,54,28,5,3,2,0,0,0,5,0,1,3,1,1,0,0,14,7,7,5,14,9,5,5,14,8,6,2,APRIL
SULAWESI BARAT,PASANGKAYU,SARUDU,BULU MARIO,73,36,4,1,1,0,0,4,0,0,2,2,12,7,5,0,22,5,17,3,14,5,9,3,14,9,5,0,APRIL
SULAWESI BARAT,PASANGKAYU,SARUDU,KUMASARI,67,40,28,15,14,7,1,22,5,0,4,24,2,2,0,2,32,15,17,3,30,2,28,1,18,7,11,3,APRIL
SULAWESI BARAT,PASANGKAYU,SARUDU,PATIKA,87,17,0,0,0,0,0,0,0,0,0,0,9,2,7,1,14,7,7,4,11,10,1,2,2,1,1,0,APRIL
SULAWESI BARAT,PASANGKAYU,TIKKE RAYA,MAKMUR JAYA,63,32,11,4,3,1,0,8,0,1,3,7,2,0,2,0,32,23,9,9,4,4,0,3,21,12,9,2,APRIL
SULAWESI BARAT,PASANGKAYU,TIKKE RAYA,LARIANG,97,59,38,4,3,3,0,20,0,14,29,3,2,2,0,2,22,9,13,6,3,1,2,1,43,16,27,18,APRIL
SULAWESI BARAT,PASANGKAYU,TIKKE RAYA,TIKKE,67,68,22,8,6,6,5,1,13,3,18,1,11,11,0,5,27,23,4,23,19,0,19,0,36,33,3,4,APRIL
SULAWESI BARAT,PASANGKAYU,TIKKE RAYA,PAJALELE,42,32,3,0,0,0,0,3,0,0,2,1,8,1,7,1,12,7,5,5,10,7,3,2,11,2,9,11,APRIL
SULAWESI BARAT,PASANGKAYU,TIKKE RAYA,JENGENG RAYA,71,35,12,12,12,2,0,8,0,2,12,0,4,1,3,0,28,16,12,11,26,1,25,1,15,2,13,0,APRIL
SULAWESI BARAT,MAJENE,BANGGAE,BANGGAE,31,13,12,8,3,2,1,8,2,0,12,0,3,3,0,1,10,5,5,1,2,0,2,0,2,1,1,2,APRIL
SULAWESI BARAT,MAJENE,BANGGAE,BARU,39,75,4,0,0,0,0,0,2,1,3,1,7,7,0,7,17,10,7,0,4,0,4,0,13,10,3,7,APRIL
SULAWESI BARAT,MAJENE,BANGGAE,PANGALI ALI,82,34,16,13,9,3,1,8,5,2,5,10,10,5,5,3,19,5,14,1,15,9,6,5,25,12,13,17,APRIL
SULAWESI BARAT,MAJENE,BANGGAE,TOTOLI,72,31,0,0,0,0,0,0,0,0,0,0,2,1,1,0,23,9,14,3,3,2,1,0,9,3,6,2,APRIL
SULAWESI BARAT,MAJENE,BANGGAE,RANGAS,87,47,47,19,15,6,0,7,11,22,9,36,4,4,0,1,47,46,1,42,31,5,26,2,57,7,50,0,APRIL
SULAWESI BARAT,MAJENE,BANGGAE,GALUNG,76,65,32,30,26,18,1,22,5,2,30,0,6,1,5,1,12,7,5,2,4,0,4,0,35,1,34,25,APRIL
SULAWESI BARAT,MAJENE,BANGGAE,PALIPI SOREANG,57,12,4,3,1,1,1,0,0,1,3,1,7,1,6,1,11,9,2,2,5,0,5,0,7,3,4,1,APRIL
SULAWESI BARAT,MAJENE,BANGGAE,PAMBOBORANG,77,42,22,3,3,0,0,8,3,11,9,5,4,2,2,1,15,9,6,2,0,0,0,0,1,0,1,0,APRIL
SULAWESI BARAT,MAJENE,BANGGAE TIMUR,BAURUNG,54,18,1,1,1,1,1,0,0,0,1,0,5,0,5,0,18,18,0,6,3,0,3,0,4,3,1,4,APRIL
SULAWESI BARAT,MAJENE,BANGGAE TIMUR,BARUGA,93,25,17,9,0,0,0,6,6,5,4,0,7,6,1,3,10,7,3,4,10,3,7,1,21,18,3,8,APRIL
SULAWESI BARAT,MAJENE,BANGGAE TIMUR,BARUGA DHUA,68,12,1,0,0,0,0,1,0,0,0,1,2,2,0,2,12,12,0,0,12,3,9,3,2,0,2,1,APRIL
SULAWESI BARAT,MAJENE,BANGGAE TIMUR,LABUANG,44,17,17,11,7,7,6,9,0,1,17,0,1,1,0,0,13,6,7,6,9,0,9,0,14,3,11,6,APRIL
SULAWESI BARAT,MAJENE,BANGGAE TIMUR,TANDE,40,36,14,12,2,1,0,12,2,0,11,3,3,2,1,2,17,9,8,7,17,5,12,2,4,3,1,3,APRIL
SULAWESI BARAT,MAJENE,BANGGAE TIMUR,LEMBANG,46,79,10,10,3,2,2,6,2,0,9,0,2,2,0,2,56,23,33,3,32,15,17,0,48,35,13,6,APRIL
SULAWESI BARAT,MAJENE,BANGGAE TIMUR,LABUANG UTARA,79,20,18,13,6,4,1,12,3,2,2,5,11,3,8,2,20,20,0,0,5,5,0,0,4,2,2,4,APRIL
SULAWESI BARAT,MAJENE,BANGGAE TIMUR,TANDE TIMUR,84,17,13,0,0,0,0,12,0,1,12,1,9,9,0,2,17,14,3,11,14,4,10,4,0,0,0,0,APRIL
SULAWESI BARAT,MAJENE,BANGGAE TIMUR,BUTTU BARUGA,89,13,3,2,2,2,1,1,1,0,1,2,12,12,0,9,12,9,3,9,11,5,6,0,9,8,1,8,APRIL
SULAWESI BARAT,MAJENE,MALUNDA,MALUNDA,67,54,31,8,6,2,2,22,6,1,25,1,0,0,0,0,28,25,3,0,28,4,24,3,7,3,4,3,APRIL
SULAWESI BARAT,MAJENE,MALUNDA,LAMUNGANG BATU,68,53,28,21,1,1,1,4,22,0,18,10,12,9,3,7,31,31,0,27,6,0,6,0,41,32,9,24,APRIL
SULAWESI BARAT,MAJENE,MALUNDA,BAMBANGAN,39,53,25,4,4,0,0,25,0,0,25,0,5,0,5,0,27,24,3,24,15,5,10,1,44,41,3,39,APRIL
SULAWESI BARAT,MAJENE,MALUNDA,LOMBANG,100,56,2,1,0,0,0,0,1,0,0,0,18,10,8,5,54,38,16,12,44,13,31,13,58,3,55,55,APRIL
SULAWESI BARAT,MAJENE,MALUNDA,LOMBONG,30,70,61,28,5,0,0,42,6,10,34,4,5,0,5,0,62,52,10,46,30,3,27,3,60,22,38,38,APRIL
SULAWESI BARAT,MAJENE,MALUNDA,MEKKATTA,80,35,31,30,21,2,2,2,19,3,9,10,6,4,2,0,24,6,18,3,16,13,3,2,24,2,22,12,APRIL
SULAWESI BARAT,MAJENE,MALUNDA,MALIAYA,96,68,44,42,41,32,29,11,4,0,26,16,3,1,2,1,64,12,52,2,47,2,45,1,4,1,3,1,APRIL
SULAWESI BARAT,MAJENE,MALUNDA,LOMBANG TIMUR,74,10,9,0,0,0,0,2,6,1,5,3,13,3,10,0,10,10,0,10,3,1,2,1,3,0,3,1,APRIL
SULAWESI BARAT,MAJENE,MALUNDA,SALUTAHONGAN,78,33,14,14,14,14,3,7,0,4,14,0,14,7,7,2,27,6,21,4,15,7,8,3,29,12,17,16,APRIL
SULAWESI BARAT,MAJENE,MALUNDA,LOMBONG TIMUR,55,59,8,0,0,0,0,5,2,1,4,3,7,0,7,0,56,23,33,23,14,2,12,0,8,2,6,6,APRIL
SULAWESI BARAT,MAJENE,MALUNDA,MEKKATTA SELATAN,77,54,48,26,6,2,0,30,12,3,19,0,10,8,2,6,29,16,13,3,21,17,4,8,4,0,4,1,APRIL
SULAWESI BARAT,MAJENE,MALUNDA,KAYUANGIN,66,20,8,6,5,4,4,0,2,0,6,0,12,8,4,8,17,17,0,9,9,8,1,4,15,1,14,2,APRIL
SULAWESI BARAT,MAJENE,PAMBOANG,LALAMPANUA,82,22,15,13,8,4,2,7,1,1,11,2,13,1,12,1,20,6,14,1,0,0,0,0,11,4,7,7,APRIL
SULAWESI BARAT,MAJENE,PAMBOANG,SIRINDU,86,42,7,0,0,0,0,0,0,6,0,2,3,3,0,0,14,11,3,6,5,2,3,1,23,12,11,22,APRIL
SULAWESI BARAT,MAJENE,PAMBOANG,ADOLANG,94,63,59,19,16,3,2,7,24,3,14,2,16,5,11,1,30,20,10,14,19,6,13,0,16,8,8,11,APRIL
SULAWESI BARAT,MAJENE,PAMBOANG,BABABULO,54,20,14,7,1,1,1,10,1,1,7,7,6,0,6,0,19,15,4,3,7,1,6,0,19,1,18,14,APRIL
SULAWESI BARAT,MAJENE,PAMBOANG,BONDE,100,61,8,6,4,4,4,4,0,0,0,7,6,6,0,5,18,16,2,10,3,0,3,0,19,5,14,17,APRIL
SULAWESI BARAT,MAJENE,PAMBOANG,BETTENG,50,78,54,12,4,2,0,3,5,9,9,30,4,4,0,0,51,33,18,26,19,17,2,12,63,45,18,23,APRIL
SULAWESI BARAT,MAJENE,PAMBOANG,SIMBANG,69,80,36,23,8,4,0,36,0,0,19,15,7,7,0,5,73,61,12,7,19,8,11,8,27,4,23,13,APRIL
SULAWESI BARAT,MAJENE,PAMBOANG,BONDE UTARA,62,71,35,27,0,0,0,15,15,0,33,2,4,4,0,1,62,8,54,4,1,1,0,0,45,39,6,31,APRIL
SULAWESI BARAT,MAJENE,PAMBOANG,BABABULO UTARA,67,67,57,18,17,4,1,1,20,27,50,5,5,2,3,0,29,23,6,1,20,18,2,14,6,2,4,5,APRIL
SULAWESI BARAT,MAJENE,PAMBOANG,BUTTU PAMBOANG,82,30,24,4,0,0,0,10,6,6,17,7,7,1,6,0,22,21,1,3,1,1,0,1,4,2,2,4,APRIL
SULAWESI BARAT,MAJENE,PAMBOANG,BANUA ADOLANG,100,18,0,0,0,0,0,0,0,0,0,0,1,0,1,0,14,12,2,2,5,5,0,1,0,0,0,0,APRIL
SULAWESI BARAT,MAJENE,PAMBOANG,ADOLANG DHUA,63,50,35,18,16,15,11,7,7,3,35,0,5,5,0,3,31,7,24,5,22,20,2,7,13,2,11,3,APRIL
SULAWESI BARAT,MAJENE,PAMBOANG,TINAMBUNG,93,78,1,0,0,0,0,0,0,0,0,0,2,2,0,2,71,60,11,42,39,3,36,1,89,10,79,38,APRIL
SULAWESI BARAT,MAJENE,PAMBOANG,PESULOANG,37,13,9,3,2,2,0,1,3,3,8,0,0,0,0,0,11,6,5,2,9,2,7,2,7,1,6,4,APRIL
SULAWESI BARAT,MAJENE,PAMBOANG,BALOMBONG,82,43,15,7,6,1,1,7,2,1,12,0,3,3,0,1,12,6,6,6,7,3,4,0,14,2,12,10,APRIL
SULAWESI BARAT,MAJENE,SENDANA,MOSSO,93,13,6,0,0,0,0,4,1,1,0,5,11,7,4,0,11,5,6,1,8,2,6,0,8,6,2,8,APRIL
SULAWESI BARAT,MAJENE,SENDANA,MOSSO DHUA,49,10,6,3,1,0,0,6,0,0,3,0,5,3,2,1,10,10,0,8,5,0,5,0,4,1,3,2,APRIL
SULAWESI BARAT,MAJENE,SENDANA,TOTOLISI SENDANA,60,29,21,20,18,5,5,12,0,4,4,16,3,2,1,2,12,12,0,0,10,5,5,3,20,19,1,2,APRIL
SULAWESI BARAT,MAJENE,SENDANA,TALLUBANUA,37,59,53,14,12,9,6,37,1,0,20,29,7,5,2,0,25,13,12,4,0,0,0,0,11,8,3,11,APRIL
SULAWESI BARAT,MAJENE,SENDANA,LALATEDZONG,86,41,3,3,1,0,0,1,1,0,0,0,6,4,2,2,36,26,10,10,32,13,19,12,7,7,0,7,APRIL
SULAWESI BARAT,MAJENE,SENDANA,BINANGA,83,53,51,15,13,1,1,14,8,16,17,3,4,4,0,2,16,12,4,5,1,0,1,0,11,0,11,3,APRIL
SULAWESI BARAT,MAJENE,SENDANA,PUTTADA,69,59,3,1,0,0,0,2,0,0,3,0,3,3,0,2,22,20,2,2,2,2,0,2,4,4,0,2,APRIL
SULAWESI BARAT,MAJENE,SENDANA,PAMINGGALAN,73,20,10,1,0,0,0,5,5,0,0,6,6,1,5,0,17,13,4,9,5,1,4,1,10,7,3,4,APRIL
SULAWESI BARAT,MAJENE,SENDANA,LEPPANGANG,65,15,11,7,3,0,0,2,4,4,7,1,7,0,7,0,13,9,4,9,13,13,0,12,6,1,5,5,APRIL
SULAWESI BARAT,MAJENE,SENDANA,PUNDAU,50,71,5,3,2,1,0,4,1,0,2,1,6,4,2,4,60,34,26,14,47,47,0,47,62,51,11,60,APRIL
SULAWESI BARAT,MAJENE,SENDANA,SENDANA,53,12,12,11,10,8,6,5,0,0,8,0,4,3,1,1,10,5,5,5,5,4,1,0,5,0,5,4,APRIL
SULAWESI BARAT,MAJENE,SENDANA,BANUA SENDANA,56,47,0,0,0,0,0,0,0,0,0,0,5,0,5,0,39,5,34,4,38,15,23,12,4,3,1,2,APRIL
SULAWESI BARAT,MAJENE,SENDANA,TALLUBANUA UTARA,33,70,59,23,3,1,0,20,16,15,23,16,2,0,2,0,31,24,7,11,27,12,15,1,71,6,65,68,APRIL
SULAWESI BARAT,MAJENE,SENDANA,LIMBORO RAMBU-RAMBU,83,63,8,1,1,1,0,0,6,2,2,2,10,1,9,1,52,20,32,17,5,5,0,1,33,16,17,8,APRIL
SULAWESI BARAT,MAJENE,SENDANA,LIMBUA,41,33,1,1,1,1,1,0,0,0,0,0,1,1,0,1,18,14,4,2,0,0,0,0,7,2,5,0,APRIL
SULAWESI BARAT,MAJENE,SENDANA,BUKIT SAMANG,74,15,1,1,0,0,0,1,0,0,0,0,1,1,0,0,10,8,2,8,5,3,2,0,15,15,0,3,APRIL
SULAWESI BARAT,MAJENE,TAMMERODO SENDANA,SEPPONG,83,53,27,13,3,3,2,24,0,0,6,15,4,2,2,1,39,17,22,12,29,16,13,10,60,14,46,40,APRIL
SULAWESI BARAT,MAJENE,TAMMERODO SENDANA,TAMMERODO,51,42,34,20,3,1,0,23,6,4,30,0,0,0,0,0,16,14,2,1,15,10,5,2,1,1,0,0,APRIL
SULAWESI BARAT,MAJENE,TAMMERODO SENDANA,ULIDANG,42,39,34,9,8,7,4,0,13,0,27,6,7,3,4,2,38,8,30,7,23,19,4,7,25,1,24,11,APRIL
SULAWESI BARAT,MAJENE,TAMMERODO SENDANA,TALLAMBALAO,96,42,25,4,4,4,0,19,6,0,18,6,11,6,5,6,34,9,25,8,10,6,4,0,0,0,0,0,APRIL
SULAWESI BARAT,MAJENE,TAMMERODO SENDANA,TAMMERODO UTARA,83,11,4,4,3,2,0,4,0,0,4,0,3,3,0,0,11,8,3,7,4,4,0,3,11,5,6,8,APRIL
SULAWESI BARAT,MAJENE,TAMMERODO SENDANA,MANYAMBA,76,45,16,16,11,2,2,8,5,0,1,10,0,0,0,0,25,25,0,15,0,0,0,0,30,23,7,22,APRIL
SULAWESI BARAT,MAJENE,TAMMERODO SENDANA,AWO,58,14,3,0,0,0,0,0,2,1,0,3,10,0,10,0,13,6,7,5,2,1,1,0,8,7,1,2,APRIL
SULAWESI BARAT,MAJENE,TUBO SENDANA,ONANG,73,52,0,0,0,0,0,0,0,0,0,0,0,0,0,0,20,14,6,4,2,1,1,0,13,11,2,0,APRIL
SULAWESI BARAT,MAJENE,TUBO SENDANA,TUBO,31,28,5,5,1,0,0,1,0,1,2,0,5,5,0,3,13,8,5,4,8,3,5,3,19,2,17,16,APRIL
SULAWESI BARAT,MAJENE,TUBO SENDANA,ONANG UTARA,62,71,21,18,6,6,4,12,0,5,13,8,8,1,7,1,70,18,52,3,20,19,1,13,48,34,14,34,APRIL
SULAWESI BARAT,MAJENE,TUBO SENDANA,TUBO SELATAN,55,69,44,30,20,16,16,26,2,0,2,23,1,1,0,1,47,14,33,4,18,16,2,3,66,7,59,18,APRIL
SULAWESI BARAT,MAJENE,TUBO SENDANA,BONDE BONDE,69,29,6,2,1,1,1,5,0,0,0,2,11,10,1,2,23,8,15,8,4,0,4,0,21,18,3,13,APRIL
SULAWESI BARAT,MAJENE,TUBO SENDANA,TUBO TENGAH,74,30,20,11,6,6,5,14,0,0,6,12,3,3,0,3,20,15,5,9,7,5,2,1,25,23,2,9,APRIL
SULAWESI BARAT,MAJENE,TUBO SENDANA,TUBO POANG,59,10,6,5,1,0,0,3,2,0,6,0,10,7,3,0,10,9,1,8,9,6,3,4,1,0,1,1,APRIL
SULAWESI BARAT,MAJENE,ULUMANDA,KABIRAAN,56,53,27,24,4,4,1,22,2,1,20,7,6,6,0,2,48,29,19,5,24,18,6,16,24,19,5,20,APRIL
SULAWESI BARAT,MAJENE,ULUMANDA,SAMBABO,36,52,40,9,4,4,2,15,23,0,3,19,1,1,0,0,19,16,3,11,17,5,12,5,23,1,22,12,APRIL
SULAWESI BARAT,MAJENE,ULUMANDA,TANDEALLO,44,69,61,35,8,7,2,14,10,30,34,3,5,3,2,2,59,49,10,23,48,32,16,10,68,68,0,66,APRIL
SULAWESI BARAT,MAJENE,ULUMANDA,ULUMANDA,94,18,11,9,9,9,6,1,0,1,9,0,18,0,18,0,16,15,1,10,16,16,0,5,16,16,0,4,APRIL
SULAWESI BARAT,MAJENE,ULUMANDA,SALUTAMBUNG,31,78,7,2,1,1,0,6,1,0,3,2,4,4,0,0,55,16,39,16,39,10,29,9,21,16,5,20,APRIL
SULAWESI BARAT,MAJENE,ULUMANDA,POPENGA,55,42,7,7,7,2,1,5,0,1,6,1,9,1,8,1,39,25,14,2,25,22,3,19,37,26,11,15,APRIL
SULAWESI BARAT,MAJENE,ULUMANDA,SULAI,39,70,22,11,4,0,0,7,10,2,1,12,3,2,1,2,70,50,20,35,55,7,48,6,61,18,43,8,APRIL
SULAWESI BARAT,MAJENE,ULUMANDA,PANGGALO,41,37,22,6,0,0,0,13,0,0,6,14,2,0,2,0,18,18,0,17,10,0,10,0,22,18,4,18,APRIL
SULAWESI BARAT,MAMASA,ARALLE,ARALLE,58,62,0,0,0,0,0,0,0,0,0,0,9,0,9,0,42,21,21,10,1,0,1,0,33,10,23,23,APRIL
SULAWESI BARAT,MAMASA,ARALLE,RALLE ANAK,62,36,33,11,7,5,3,20,5,4,25,6,0,0,0,0,30,14,16,4,2,1,1,0,16,7,9,14,APRIL
SULAWESI BARAT,MAMASA,ARALLE,PANETEAN,62,56,24,20,11,7,1,7,5,3,2,16,3,1,2,0,41,5,36,3,10,8,2,4,22,22,0,5,APRIL
SULAWESI BARAT,MAMASA,ARALLE,UHAILANU,50,68,5,0,0,0,0,1,4,0,3,2,3,0,3,0,40,13,27,3,35,11,24,4,79,34,45,23,APRIL
SULAWESI BARAT,MAMASA,ARALLE,ARALLE UTARA,65,66,12,0,0,0,0,12,0,0,9,0,5,2,3,1,65,23,42,19,49,11,38,5,59,15,44,14,APRIL
SULAWESI BARAT,MAMASA,ARALLE,UHAIDAHO,92,77,73,52,24,24,0,64,5,1,12,25,0,0,0,0,10,10,0,10,6,5,1,5,58,27,31,43,APRIL
SULAWESI BARAT,MAMASA,ARALLE,BARURU,47,22,17,8,5,2,1,12,0,1,9,3,1,0,1,0,13,7,6,7,1,1,0,1,15,2,13,14,APRIL
SULAWESI BARAT,MAMASA,ARALLE,RALLEANAK UTARA,33,10,8,8,4,4,2,5,1,0,3,4,3,2,1,1,10,9,1,3,6,6,0,5,11,2,9,3,APRIL
SULAWESI BARAT,MAMASA,ARALLE,PAMOSEANG PANGGA,38,80,48,16,2,1,0,29,8,0,42,2,5,0,5,0,54,40,14,10,26,0,26,0,73,38,35,61,APRIL
SULAWESI BARAT,MAMASA,ARALLE,KALABE,86,22,12,5,0,0,0,7,0,3,7,4,2,1,1,1,21,18,3,2,5,5,0,1,6,4,2,1,APRIL
SULAWESI BARAT,MAMASA,ARALLE,ARALLE SELATAN,56,48,37,14,0,0,0,8,1,19,35,0,3,0,3,0,45,9,36,7,4,2,2,0,18,9,9,3,APRIL
SULAWESI BARAT,MAMASA,ARALLE,HAHANGAN,30,72,47,4,3,0,0,37,5,0,30,4,6,4,2,0,14,13,1,3,13,8,5,1,30,12,18,13,APRIL
SULAWESI BARAT,MAMASA,BALLA,BALLA,95,80,30,11,9,9,6,4,0,14,25,5,12,8,4,0,14,5,9,2,8,5,3,5,38,29,9,22,APRIL
SULAWESI BARAT,MAMASA,BALLA,BALLA BARAT,36,42,42,4,1,1,0,2,16,6,23,2,0,0,0,0,15,15,0,4,11,5,6,0,27,3,24,26,APRIL
SULAWESI BARAT,MAMASA,BALLA,BALLA SATANETEAN,39,48,13,8,1,0,0,5,4,4,4,7,6,4,2,2,47,42,5,29,44,11,33,4,7,3,4,0,APRIL
SULAWESI BARAT,MAMASA,BALLA,BALLA TUMUKA,33,29,7,0,0,0,0,0,4,0,6,0,3,1,2,0,20,9,11,8,13,3,10,1,16,11,5,5,APRIL
SULAWESI BARAT,MAMASA,BALLA,SEPAKUAN,42,22,18,5,4,3,1,6,6,1,12,5,7,7,0,2,21,7,14,6,3,3,0,2,13,13,0,4,APRIL
SULAWESI BARAT,MAMASA,BALLA,PIDARA,88,35,33,15,10,1,0,7,6,1,14,19,12,9,3,1,17,6,11,5,3,1,2,0,2,0,2,0,APRIL
SULAWESI BARAT,MAMASA,BALLA,BAMBAPUANG,46,60,27,11,10,3,1,13,11,0,9,14,5,5,0,3,39,20,19,12,31,26,5,14,26,22,4,14,APRIL
SULAWESI BARAT,MAMASA,BALLA,BALLA TIMUR,44,46,45,45,3,0,0,33,10,0,43,2,6,0,6,0,17,9,8,0,10,9,1,7,31,13,18,5,APRIL
SULAWESI BARAT,MAMASA,BAMBANG,MOKALLANG,32,74,25,8,4,3,3,9,0,5,2,7,2,2,0,1,12,12,0,1,10,4,6,4,31,20,11,23,APRIL
SULAWESI BARAT,MAMASA,BAMBANG,MASOSO,43,75,66,43,7,3,0,14,2,46,36,4,5,3,2,3,58,32,26,1,24,7,17,4,50,2,48,36,APRIL
SULAWESI BARAT,MAMASA,BAMBANG,SALUASSING,76,30,1,0,0,0,0,1,0,0,0,0,7,0,7,0,24,18,6,10,20,1,19,1,35,18,17,20,APRIL
SULAWESI BARAT,MAMASA,BAMBANG,SALUBULO,73,59,47,39,31,31,5,37,3,0,15,6,3,2,1,2,49,8,41,8,13,8,5,8,24,21,3,0,APRIL
SULAWESI BARAT,MAMASA,BAMBANG,SALUKADI,77,55,40,7,7,7,0,11,21,0,16,19,1,1,0,1,28,8,20,3,18,12,6,4,18,9,9,9,APRIL
SULAWESI BARAT,MAMASA,BAMBANG,SALUKEPOPOK,35,72,0,0,0,0,0,0,0,0,0,0,4,0,4,0,16,15,1,6,5,4,1,3,0,0,0,0,APRIL
SULAWESI BARAT,MAMASA,BAMBANG,ULUMAMBI BARAT,73,35,10,1,0,0,0,4,6,0,10,0,3,3,0,2,20,11,9,2,2,0,2,0,5,1,4,5,APRIL
SULAWESI BARAT,MAMASA,BAMBANG,LIMBADEBATA,94,68,7,4,3,2,1,0,2,1,7,0,0,0,0,0,39,23,16,11,12,9,3,9,50,32,18,9,APRIL
SULAWESI BARAT,MAMASA,BAMBANG,TANETE TOMBA,61,56,16,6,3,0,0,0,11,1,4,8,7,3,4,2,40,9,31,5,38,8,30,5,45,30,15,29,APRIL
SULAWESI BARAT,MAMASA,BAMBANG,BAMBANG,47,49,31,10,2,0,0,8,21,0,17,3,3,2,1,0,12,9,3,3,0,0,0,0,12,11,1,1,APRIL
SULAWESI BARAT,MAMASA,BAMBANG,RANTELEMO,81,45,11,6,0,0,0,10,0,0,0,8,8,2,6,1,45,14,31,6,24,8,16,6,15,15,0,4,APRIL
SULAWESI BARAT,MAMASA,BAMBANG,SALUDENGEN,92,80,34,23,9,6,4,16,0,0,19,11,3,1,2,0,25,9,16,9,14,9,5,9,2,2,0,0,APRIL
SULAWESI BARAT,MAMASA,BAMBANG,ULUMAMBI,66,21,5,0,0,0,0,1,4,0,1,0,6,3,3,3,17,5,12,4,6,5,1,4,12,8,4,1,APRIL
SULAWESI BARAT,MAMASA,BAMBANG,BAMBANG TIMUR,52,47,17,12,1,0,0,7,9,1,1,1,1,0,1,0,32,9,23,9,6,3,3,2,9,5,4,1,APRIL
SULAWESI BARAT,MAMASA,BAMBANG,MINANGA,50,77,21,16,8,5,2,1,16,2,19,2,8,3,5,1,55,44,11,13,14,4,10,0,18,1,17,2,APRIL
SULAWESI BARAT,MAMASA,BAMBANG,SIKAMASE,66,25,20,1,0,0,0,11,7,1,16,1,6,4,2,0,11,5,6,2,0,0,0,0,17,16,1,0,APRIL
SULAWESI BARAT,MAMASA,BAMBANG,RANTETARIMA,30,17,6,1,0,0,0,1,3,2,1,1,0,0,0,0,11,10,1,6,6,0,6,0,0,0,0,0,APRIL
SULAWESI BARAT,MAMASA,BAMBANG,SALURURU,32,35,23,3,2,1,1,3,7,8,10,8,2,2,0,0,12,5,7,0,9,8,1,2,16,4,12,2,APRIL
SULAWESI BARAT,MAMASA,BAMBANG,SALUTABANG,92,28,14,7,7,4,3,10,1,0,7,6,2,2,0,2,27,22,5,12,3,3,0,2,6,2,4,4,APRIL
SULAWESI BARAT,MAMASA,BAMBANG,BALATANA,85,35,6,3,2,2,0,3,1,1,0,4,14,10,4,5,31,28,3,13,18,0,18,0,7,0,7,3,APRIL
SULAWESI BARAT,MAMASA,BUNTUMALANGKA,BUNTUMALANGKA,88,40,32,8,5,0,0,14,17,0,31,0,2,1,1,0,39,23,16,1,19,18,1,16,6,1,5,0,APRIL
SULAWESI BARAT,MAMASA,BUNTUMALANGKA,RANTEBERAN,95,78,65,45,3,1,1,33,27,0,16,21,0,0,0,0,31,25,6,24,3,0,3,0,14,8,6,7,APRIL
SULAWESI BARAT,MAMASA,BUNTUMALANGKA,KEBANGA,35,25,0,0,0,0,0,0,0,0,0,0,0,0,0,0,10,8,2,3,7,4,3,0,2,1,1,1,APRIL
SULAWESI BARAT,MAMASA,BUNTUMALANGKA,SALURINDU,89,55,26,26,14,13,4,9,0,2,10,3,5,2,3,2,23,7,16,3,1,0,1,0,39,33,6,38,APRIL
SULAWESI BARAT,MAMASA,BUNTUMALANGKA,TAORA,99,58,1,0,0,0,0,1,0,0,0,0,3,1,2,0,30,5,25,5,17,4,13,0,29,16,13,21,APRIL
SULAWESI BARAT,MAMASA,BUNTUMALANGKA,KABAE,75,79,55,1,0,0,0,43,10,1,54,1,6,0,6,0,51,5,46,4,9,4,5,2,1,1,0,1,APRIL
SULAWESI BARAT,MAMASA,BUNTUMALANGKA,SALUTAMBUN BARAT,96,10,1,1,1,0,0,0,1,0,0,1,6,1,5,0,10,10,0,6,0,0,0,0,6,1,5,0,APRIL
SULAWESI BARAT,MAMASA,BUNTUMALANGKA,PENATANGAN,39,32,15,0,0,0,0,10,3,0,14,0,4,4,0,0,15,12,3,9,12,6,6,2,4,3,1,1,APRIL
SULAWESI BARAT,MAMASA,BUNTUMALANGKA,SALUTAMBUN TIMUR,89,11,4,3,0,0,0,2,1,1,1,3,3,0,3,0,11,11,0,5,9,6,3,0,0,0,0,0,APRIL
SULAWESI BARAT,MAMASA,BUNTUMALANGKA,SALUTAMBUN,79,65,16,9,3,0,0,6,0,1,7,9,13,7,6,7,20,14,6,8,2,1,1,1,46,3,43,22,APRIL
SULAWESI BARAT,MAMASA,BUNTUMALANGKA,ARALLE TIMUR,52,49,46,14,14,7,2,22,22,0,22,5,3,3,0,1,25,7,18,0,8,6,2,1,1,1,0,0,APRIL
SULAWESI BARAT,MAMASA,MAMASA,MAMASA,48,39,18,10,3,0,0,12,0,3,14,3,3,2,1,2,15,6,9,1,9,6,3,5,15,11,4,12,APRIL
SULAWESI BARAT,MAMASA,MAMASA,RAMBUSARATU,45,50,6,4,2,1,0,6,0,0,0,2,3,3,0,0,21,12,9,0,8,4,4,4,7,3,4,7,APRIL
SULAWESI BARAT,MAMASA,MAMASA,OSANGO,78,44,31,14,0,0,0,27,2,1,12,17,11,8,3,4,36,10,26,10,23,13,10,13,0,0,0,0,APRIL
SULAWESI BARAT,MAMASA,MAMASA,LAMBANAN,31,14,1,1,0,0,0,1,0,0,0,0,2,0,2,0,12,12,0,1,9,2,7,0,9,6,3,1,APRIL
SULAWESI BARAT,MAMASA,MAMASA,LEMBANA SALULO,85,60,45,16,16,16,10,8,6,16,25,6,2,2,0,2,38,22,16,18,2,1,1,1,28,17,11,0,APRIL
SULAWESI BARAT,MAMASA,MAMASA,TAUPE,92,45,13,7,7,1,1,8,4,0,13,0,16,1,15,0,36,19,17,17,17,13,4,12,41,16,25,8,APRIL
SULAWESI BARAT,MAMASA,MAMASA,BUNTU BUDA,52,71,41,7,7,1,1,39,0,0,40,0,1,0,1,0,43,15,28,10,8,2,6,2,3,2,1,3,APRIL
SULAWESI BARAT,MAMASA,MAMASA,TONDOK BAKARU,31,42,7,3,2,2,2,1,0,0,1,5,2,2,0,0,29,19,10,3,29,10,19,6,26,16,10,12,APRIL
SULAWESI BARAT,MAMASA,MAMASA,PEBASSIAN,81,18,1,1,1,0,0,0,0,0,0,1,7,4,3,2,13,6,7,1,4,2,2,1,14,2,12,4,APRIL
SULAWESI BARAT,MAMASA,MAMASA,MAMBULILING,49,28,8,7,1,1,1,7,0,0,3,3,1,0,1,0,25,7,18,2,13,12,1,1,16,2,14,0,APRIL
SULAWESI BARAT,MAMASA,MAMASA,BOMBONG LAMBE,46,32,13,13,8,4,2,9,0,1,5,7,5,3,2,1,14,11,3,10,0,0,0,0,18,6,12,0,APRIL
SULAWESI BARAT,MAMASA,MAMASA,BUBUN BATU,89,69,51,2,0,0,0,39,1,5,22,16,0,0,0,0,57,41,16,9,39,38,1,6,53,52,1,53,APRIL
SULAWESI BARAT,MAMASA,MAMBI,MAMBI,44,61,34,7,3,3,2,2,8,10,31,0,7,5,2,1,50,31,19,20,3,0,3,0,42,36,6,28,APRIL
SULAWESI BARAT,MAMASA,MAMBI,TALIPUKKI,64,22,2,1,0,0,0,1,1,0,1,0,10,5,5,3,12,11,1,11,8,8,0,5,0,0,0,0,APRIL
SULAWESI BARAT,MAMASA,MAMBI,RANTEBULAHAN,44,70,8,2,0,0,0,3,2,3,7,0,2,0,2,0,64,30,34,0,23,14,9,11,25,21,4,1,APRIL
SULAWESI BARAT,MAMASA,MAMBI,SONDONGLAYU,91,66,37,5,2,2,2,11,21,0,35,0,14,14,0,1,36,31,5,16,31,25,6,2,59,35,24,55,APRIL
SULAWESI BARAT,MAMASA,MAMBI,SALUBANUA,73,63,45,22,16,9,1,39,0,3,4,22,4,0,4,0,49,29,20,14,7,7,0,3,37,8,29,29,APRIL
SULAWESI BARAT,MAMASA,MAMBI,TAPALINA,80,79,46,21,13,7,7,30,4,0,14,22,10,3,7,3,35,33,2,9,25,5,20,0,50,5,45,50,APRIL
SULAWESI BARAT,MAMASA,MAMBI,SENDANA,79,41,7,7,7,5,4,2,0,1,6,0,0,0,0,0,37,24,13,0,9,5,4,4,29,12,17,8,APRIL
SULAWESI BARAT,MAMASA,MAMBI,PAMOSEAN,84,22,8,5,0,0,0,2,3,1,6,2,8,5,3,5,18,14,4,7,3,3,0,1,9,1,8,6,APRIL
SULAWESI BARAT,MAMASA,MAMBI,SELUMAKA,50,12,10,10,9,0,0,0,5,3,3,3,4,1,3,1,12,6,6,4,12,7,5,6,18,9,9,4,APRIL
SULAWESI BARAT,MAMASA,MAMBI,BUJUNG MANURUNG,80,33,11,1,0,0,0,11,0,0,1,6,16,11,5,6,10,7,3,3,5,3,2,2,16,8,8,7,APRIL
SULAWESI BARAT,MAMASA,MAMBI,SALU ALO,92,47,35,23,5,4,4,17,10,2,21,7,12,11,1,7,14,11,3,3,4,1,3,1,1,0,1,0,APRIL
SULAWESI BARAT,MAMASA,MAMBI,INDOBANUA,68,37,1,0,0,0,0,1,0,0,0,0,9,0,9,0,19,10,9,0,19,4,15,1,0,0,0,0,APRIL
SULAWESI BARAT,MAMASA,MAMBI,SALUDURIAN,88,25,22,12,8,0,0,16,3,3,8,14,3,1,2,0,22,7,15,3,21,15,6,3,7,5,2,1,APRIL
SULAWESI BARAT,MAMASA,MEHALAAN,MEHALAAN,61,21,18,11,8,5,1,4,0,11,4,4,4,2,2,1,14,12,2,6,4,3,1,1,11,6,5,10,APRIL
SULAWESI BARAT,MAMASA,MEHALAAN,BOTTENG,55,53,17,9,2,0,0,8,8,0,10,0,3,0,3,0,19,15,4,6,5,0,5,0,26,24,2,23,APRIL
SULAWESI BARAT,MAMASA,MEHALAAN,SALUKONTA,44,56,39,32,27,19,16,7,3,8,28,7,1,0,1,0,24,15,9,14,9,0,9,0,44,4,40,19,APRIL
SULAWESI BARAT,MAMASA,MEHALAAN,MESAKADA,100,41,34,33,7,1,0,4,17,2,30,1,16,0,16,0,12,5,7,1,12,9,3,9,22,11,11,15,APRIL
SULAWESI BARAT,MAMASA,MEHALAAN,MEHALAAN BARAT,42,35,20,7,5,4,3,14,1,2,9,9,7,2,5,1,33,19,14,11,3,0,3,0,15,2,13,14,APRIL
SULAWESI BARAT,MAMASA,MEHALAAN,SALUAHOK,91,46,9,3,0,0,0,1,2,3,5,3,10,3,7,2,15,9,6,4,14,4,10,1,44,3,41,0,APRIL
SULAWESI BARAT,MAMASA,MEHALAAN,SALUBALO,46,19,17,6,5,4,3,4,7,3,2,2,3,0,3,0,10,10,0,2,8,6,2,0,19,9,10,19,APRIL
SULAWESI BARAT,MAMASA,MEHALAAN,PASSEMBUK,60,68,50,40,7,5,0,39,0,1,26,5,10,8,2,3,32,5,27,2,7,7,0,3,22,1,21,13,APRIL
SULAWESI BARAT,MAMASA,MEHALAAN,KONDO,38,16,0,0,0,0,0,0,0,0,0,0,6,1,5,0,11,8,3,7,0,0,0,0,7,5,2,1,APRIL
SULAWESI BARAT,MAMASA,MEHALAAN,LEKO SUKAMAJU,51,26,26,18,6,3,0,8,5,10,13,4,3,3,0,0,15,13,2,12,0,0,0,0,14,6,8,3,APRIL
SULAWESI BARAT,MAMASA,MEHALAAN,ULUMEA,38,80,17,1,1,0,0,10,4,0,11,5,3,3,0,2,36,13,23,9,3,3,0,3,54,14,40,41,APRIL
SULAWESI BARAT,MAMASA,MESSAWA,MESSAWA,47,57,21,6,0,0,0,7,13,0,19,0,0,0,0,0,10,6,4,1,1,1,0,1,10,4,6,4,APRIL
SULAWESI BARAT,MAMASA,MESSAWA,RIPPUNG,53,65,9,6,2,0,0,5,3,1,6,2,8,0,8,0,42,37,5,3,0,0,0,0,43,24,19,43,APRIL
SULAWESI BARAT,MAMASA,MESSAWA,MAKUANG,83,37,34,14,8,4,1,33,0,0,9,9,14,4,10,0,13,12,1,1,13,11,2,3,4,4,0,4,APRIL
SULAWESI BARAT,MAMASA,MESSAWA,SEPANG,38,46,15,8,1,1,0,5,6,3,4,10,2,0,2,0,38,6,32,4,16,6,10,0,7,5,2,6,APRIL
SULAWESI BARAT,MAMASA,MESSAWA,MALIMBONG,90,28,3,0,0,0,0,3,0,0,3,0,17,1,16,1,13,5,8,4,7,7,0,4,9,1,8,8,APRIL
SULAWESI BARAT,MAMASA,MESSAWA,MATANDE,41,39,6,3,3,2,0,3,0,0,4,2,5,5,0,3,22,6,16,3,7,2,5,0,11,7,4,0,APRIL
SULAWESI BARAT,MAMASA,MESSAWA,SIPAI,97,77,32,4,4,1,1,29,0,2,10,11,5,3,2,0,23,16,7,1,5,5,0,4,25,24,1,6,APRIL
SULAWESI BARAT,MAMASA,MESSAWA,PASMA MAMBU,91,73,38,28,23,20,17,19,1,1,3,21,7,6,1,2,30,30,0,24,19,18,1,17,13,12,1,6,APRIL
SULAWESI BARAT,MAMASA,MESSAWA,TANETE BATU,55,15,2,0,0,0,0,1,0,0,1,1,9,6,3,1,11,9,2,3,8,0,8,0,16,9,7,14,APRIL
SULAWESI BARAT,MAMASA,NOSU,NOSU,47,22,11,8,5,1,0,4,6,1,11,0,4,2,2,0,12,8,4,4,4,3,1,3,18,13,5,10,APRIL
SULAWESI BARAT,MAMASA,NOSU,MINANGA,91,17,0,0,0,0,0,0,0,0,0,0,3,3,0,3,10,10,0,1,2,0,2,0,13,1,12,2,APRIL
SULAWESI BARAT,MAMASA,NOSU,BATUPAPAN,52,37,33,20,20,15,12,8,10,1,29,1,3,3,0,3,30,8,22,0,25,4,21,0,9,2,7,0,APRIL
SULAWESI BARAT,MAMASA,NOSU,MASEWWE,61,38,16,3,3,0,0,15,0,0,9,0,11,9,2,6,29,20,9,8,14,13,1,1,0,0,0,0,APRIL
SULAWESI BARAT,MAMASA,NOSU,SIWI,54,16,10,0,0,0,0,5,2,2,9,0,3,1,2,0,12,6,6,4,9,0,9,0,14,6,8,3,APRIL
SULAWESI BARAT,MAMASA,NOSU,MINANGA TIMUR,49,41,36,1,1,0,0,31,5,0,20,15,6,4,2,0,32,18,14,10,6,5,1,1,31,29,2,26,APRIL
SULAWESI BARAT,MAMASA,NOSU,PARINDING,85,67,67,16,0,0,0,12,47,4,39,18,1,0,1,0,29,28,1,18,25,7,18,4,12,1,11,8,APRIL
SULAWESI BARAT,MAMASA,PANA,PANA,78,47,43,25,22,12,12,3,12,0,42,0,11,11,0,4,29,24,5,12,0,0,0,0,23,12,11,9,APRIL
SULAWESI BARAT,MAMASA,PANA,MANIPI,65,56,27,5,2,2,1,4,19,1,20,0,1,1,0,0,20,17,3,12,11,3,8,2,21,15,6,5,APRIL
SULAWESI BARAT,MAMASA,PANA,MAMULLU,89,62,26,5,3,0,0,12,7,6,21,1,2,0,2,0,13,13,0,0,4,3,1,2,33,15,18,12,APRIL
SULAWESI BARAT,MAMASA,PANA,SAPAN,64,25,17,13,5,3,3,9,5,0,5,11,6,2,4,1,20,7,13,2,1,0,1,0,12,1,11,12,APRIL
SULAWESI BARAT,MAMASA,PANA,DATUBARINGAN,90,60,14,0,0,0,0,7,7,0,11,3,16,6,10,3,22,8,14,4,10,7,3,5,0,0,0,0,APRIL
SULAWESI BARAT,MAMASA,PANA,PANURA,73,15,9,2,2,0,0,5,0,3,7,2,9,0,9,0,11,6,5,1,6,1,5,0,15,14,1,10,APRIL
SULAWESI BARAT,MAMASA,PANA,TALLANG BULAWAN,74,63,45,7,5,3,3,37,0,2,19,26,0,0,0,0,23,19,4,1,10,3,7,1,5,4,1,2,APRIL
SULAWESI BARAT,MAMASA,PANA,KARAKA,91,51,42,0,0,0,0,24,5,1,16,8,7,0,7,0,20,11,9,8,9,0,9,0,30,8,22,6,APRIL
SULAWESI BARAT,MAMASA,PANA,ULUSALU,44,53,37,27,24,10,7,27,3,0,17,2,7,5,2,0,46,8,38,2,2,1,1,1,34,28,6,34,APRIL
SULAWESI BARAT,MAMASA,PANA,WERI,51,26,6,0,0,0,0,4,1,0,5,1,1,0,1,0,15,7,8,2,4,3,1,0,8,4,4,1,APRIL
SULAWESI BARAT,MAMASA,PANA,SALUTAMBUN,32,33,28,23,8,2,1,7,13,1,19,6,6,2,4,1,10,9,1,3,6,5,1,1,21,14,7,9,APRIL
SULAWESI BARAT,MAMASA,PANA,SALOAN,38,36,28,26,20,2,2,9,12,0,6,14,4,0,4,0,27,18,9,17,17,5,12,4,39,3,36,12,APRIL
SULAWESI BARAT,MAMASA,PANA,ULUSALU INDAH,68,33,17,8,3,0,0,15,2,0,11,6,0,0,0,0,25,23,2,10,16,15,1,1,7,1,6,6,APRIL
SULAWESI BARAT,MAMASA,RANTEBULAHAN TIMUR,SALUMOKANAN,46,48,48,19,1,1,1,23,24,0,27,6,3,3,0,3,10,9,1,6,9,6,3,5,2,2,0,1,APRIL
SULAWESI BARAT,MAMASA,RANTEBULAHAN TIMUR,SALUMOKANAN BARAT,79,80,59,45,43,1,0,3,42,2,39,4,10,9,1,7,16,6,10,5,7,1,6,1,9,1,8,2,APRIL
SULAWESI BARAT,MAMASA,RANTEBULAHAN TIMUR,BUANGIN,89,12,3,3,1,1,1,1,1,0,1,1,8,1,7,1,12,9,3,1,12,10,2,9,17,12,5,6,APRIL
SULAWESI BARAT,MAMASA,RANTEBULAHAN TIMUR,BAMBANG BUDA,68,14,6,3,2,2,1,3,2,0,1,2,0,0,0,0,12,6,6,4,5,3,2,1,13,3,10,0,APRIL
SULAWESI BARAT,MAMASA,RANTEBULAHAN TIMUR,LEKO,89,25,14,12,0,0,0,5,8,0,1,5,15,1,14,0,25,13,12,8,5,0,5,0,22,10,12,5,APRIL
SULAWESI BARAT,MAMASA,RANTEBULAHAN TIMUR,KIRAK,57,69,62,33,26,0,0,43,1,9,43,14,7,6,1,0,41,10,31,0,41,26,15,5,24,10,14,20,APRIL
SULAWESI BARAT,MAMASA,RANTEBULAHAN TIMUR,SALUMOKANAN UTARA,49,13,12,6,1,1,0,0,3,9,10,2,9,6,3,0,11,7,4,0,1,1,0,0,5,0,5,3,APRIL
SULAWESI BARAT,MAMASA,RANTEBULAHAN TIMUR,SAMPALE,61,75,46,33,27,22,10,8,14,1,15,19,3,1,2,0,61,9,52,4,4,0,4,0,24,13,11,1,APRIL
SULAWESI BARAT,MAMASA,SESENAPADANG,OROBUA,61,63,44,30,18,1,1,24,3,8,44,0,8,1,7,0,30,20,10,4,11,9,2,1,45,8,37,18,APRIL
SULAWESI BARAT,MAMASA,SESENAPADANG,PALADAN,90,56,6,0,0,0,0,0,5,0,1,2,12,1,11,0,28,18,10,7,8,7,1,4,33,16,17,27,APRIL
SULAWESI BARAT,MAMASA,SESENAPADANG,OROBUA TIMUR,42,53,40,8,8,0,0,20,18,1,13,11,3,3,0,1,32,26,6,1,6,6,0,3,11,11,0,4,APRIL
SULAWESI BARAT,MAMASA,SESENAPADANG,RANTE PUANG,60,79,12,9,9,4,1,2,2,5,2,8,6,2,4,1,62,12,50,10,36,20,16,3,18,17,1,4,APRIL
SULAWESI BARAT,MAMASA,SESENAPADANG,SATENETEAN,58,56,7,1,0,0,0,1,2,2,6,0,1,1,0,0,51,33,18,21,3,2,1,0,24,18,6,16,APRIL
SULAWESI BARAT,MAMASA,SESENAPADANG,LISUAN ADA,50,25,24,22,7,7,2,21,0,1,10,6,3,2,1,1,13,5,8,2,8,2,6,0,7,0,7,4,APRIL
SULAWESI BARAT,MAMASA,SESENAPADANG,OROBUA SELATAN,45,59,15,11,5,5,1,13,0,0,9,2,1,1,0,1,28,7,21,5,21,15,6,13,42,3,39,33,APRIL
SULAWESI BARAT,MAMASA,SESENAPADANG,MALANGKENA PADANG,71,73,44,31,5,0,0,2,5,15,34,4,14,12,2,4,31,13,18,3,26,13,13,1,43,42,1,30,APRIL
SULAWESI BARAT,MAMASA,SESENAPADANG,MALIMBONG,66,72,61,32,28,21,19,16,14,2,4,25,7,2,5,1,60,20,40,2,49,4,45,0,77,19,58,48,APRIL
SULAWESI BARAT,MAMASA,SESENAPADANG,MARAMPAN OROBUA,42,49,48,32,5,2,2,24,11,5,12,14,6,5,1,3,20,15,5,5,16,14,2,2,32,14,18,11,APRIL
SULAWESI BARAT,MAMASA,SUMARORONG,SUMARORONG,35,18,14,6,5,4,4,10,0,0,11,2,3,1,2,0,15,7,8,5,7,4,3,2,14,5,9,8,APRIL
SULAWESI BARAT,MAMASA,SUMARORONG,TABONE,69,21,8,8,0,0,0,4,1,3,4,4,12,8,4,0,11,6,5,1,8,4,4,1,16,2,14,0,APRIL
SULAWESI BARAT,MAMASA,SUMARORONG,BATANG URU,94,27,26,26,13,7,7,15,4,0,8,15,7,2,5,0,17,11,6,1,0,0,0,0,5,0,5,3,APRIL
SULAWESI BARAT,MAMASA,SUMARORONG,SASAKAN,77,26,10,4,1,0,0,5,1,3,8,1,14,10,4,1,23,7,16,6,14,6,8,3,15,8,7,2,APRIL
SULAWESI BARAT,MAMASA,SUMARORONG,TADISI,37,45,25,19,6,0,0,23,2,0,14,0,2,0,2,0,44,44,0,4,21,17,4,5,32,6,26,32,APRIL
SULAWESI BARAT,MAMASA,SUMARORONG,SIBANAWA,100,55,29,29,25,1,1,14,4,0,24,0,15,11,4,8,41,22,19,21,32,0,32,0,49,14,35,5,APRIL
SULAWESI BARAT,MAMASA,SUMARORONG,BATANGNGURU TIMUR,59,12,12,2,0,0,0,8,0,0,3,7,10,8,2,4,10,7,3,0,2,1,1,1,9,5,4,6,APRIL
SULAWESI BARAT,MAMASA,SUMARORONG,SALUBALO,82,23,13,9,0,0,0,0,8,3,5,1,16,6,10,5,19,17,2,9,11,10,1,2,19,5,14,3,APRIL
SULAWESI BARAT,MAMASA,SUMARORONG,BANEA,51,69,30,13,10,5,4,15,10,0,9,13,6,5,1,0,25,16,9,0,15,4,11,2,35,15,20,13,APRIL
SULAWESI BARAT,MAMASA,SUMARORONG,RANTE KAMASE,62,70,42,36,31,7,2,28,0,9,41,1,5,4,1,3,20,13,7,13,7,4,3,3,12,9,3,4,APRIL
SULAWESI BARAT,MAMASA,TABANG,TABANG,80,33,16,15,9,2,0,7,9,0,14,0,12,3,9,2,25,13,12,1,9,5,4,4,26,19,7,18,APRIL
SULAWESI BARAT,MAMASA,TABANG,TADOKALUA,43,46,4,1,1,0,0,0,3,1,1,3,5,3,2,0,25,5,20,2,2,2,0,1,8,8,0,6,APRIL
SULAWESI BARAT,MAMASA,TABANG,TABANG BARAT,99,77,2,1,0,0,0,0,0,1,2,0,6,0,6,0,67,61,6,58,64,56,8,21,41,35,6,26,APRIL
SULAWESI BARAT,MAMASA,TABANG,MASUPU,65,75,55,37,21,9,7,40,1,7,42,8,6,0,6,0,64,52,12,0,4,0,4,0,55,10,45,47,APRIL
SULAWESI BARAT,MAMASA,TABANG,KALAMA,89,52,33,3,1,0,0,2,29,0,17,9,2,0,2,0,26,23,3,19,25,22,3,18,53,1,52,29,APRIL
SULAWESI BARAT,MAMASA,TABANG,BAKADISURA,98,21,0,0,0,0,0,0,0,0,0,0,17,6,11,6,14,6,8,1,13,6,7,4,6,2,4,2,APRIL
SULAWESI BARAT,MAMASA,TABANG,SALUKONA,65,50,45,26,23,11,8,13,17,1,29,5,13,6,7,5,45,32,13,0,26,13,13,10,21,14,7,21,APRIL
SULAWESI BARAT,MAMASA,TABULAHAN,LAKAHANG,92,44,5,0,0,0,0,4,1,0,1,0,4,4,0,0,19,7,12,0,14,7,7,0,20,4,16,1,APRIL
SULAWESI BARAT,MAMASA,TABULAHAN,PERIANGAN,97,80,68,14,7,1,1,48,4,1,37,26,7,0,7,0,45,7,38,6,31,29,2,7,6,5,1,5,APRIL
SULAWESI BARAT,MAMASA,TABULAHAN,MALATIRO,50,74,38,30,9,7,3,11,12,0,16,15,1,1,0,0,11,7,4,1,6,1,5,1,29,1,28,29,APRIL
SULAWESI BARAT,MAMASA,TABULAHAN,TABULAHAN,60,44,14,0,0,0,0,12,0,2,9,3,3,0,3,0,40,40,0,6,32,24,8,22,36,25,11,1,APRIL
SULAWESI BARAT,MAMASA,TABULAHAN,SALULEANG,35,41,2,2,0,0,0,2,0,0,2,0,6,2,4,1,15,9,6,1,12,3,9,0,13,9,4,1,APRIL
SULAWESI BARAT,MAMASA,TABULAHAN,TAMPAK KURRA,46,58,4,3,2,2,2,2,0,0,1,0,6,5,1,4,24,10,14,2,3,1,2,1,5,1,4,1,APRIL
SULAWESI BARAT,MAMASA,TABULAHAN,GANDANG DEWATA,41,68,51,30,14,11,9,7,24,11,29,2,8,6,2,2,14,11,3,8,0,0,0,0,7,2,5,2,APRIL
SULAWESI BARAT,MAMASA,TABULAHAN,BURANA,54,58,43,27,15,10,4,0,10,10,26,14,8,5,3,4,58,40,18,29,27,18,9,15,27,13,14,18,APRIL
SULAWESI BARAT,MAMASA,TABULAHAN,SALUBAKKA,77,29,26,12,2,0,0,18,0,5,9,3,3,1,2,0,22,17,5,13,14,9,5,2,7,3,4,2,APRIL
SULAWESI BARAT,MAMASA,TABULAHAN,PANGANDARAN,89,26,0,0,0,0,0,0,0,0,0,0,1,1,0,1,17,7,10,1,14,5,9,3,24,20,4,23,APRIL
SULAWESI BARAT,MAMASA,TABULAHAN,TALOPAK,68,23,2,1,0,0,0,0,2,0,2,0,9,5,4,1,22,6,16,0,1,1,0,0,12,3,9,6,APRIL
SULAWESI BARAT,MAMASA,TABULAHAN,PEU',83,17,9,8,3,3,2,6,1,0,4,5,3,1,2,0,11,5,6,2,4,4,0,1,1,1,0,0,APRIL
SULAWESI BARAT,MAMASA,TABULAHAN,TIMORO,89,30,2,1,1,1,1,1,0,0,2,0,0,0,0,0,10,6,4,1,8,2,6,2,10,7,3,1,APRIL
SULAWESI BARAT,MAMASA,TABULAHAN,LAKAHANG UTAMA,99,12,5,0,0,0,0,5,0,0,0,0,12,3,9,0,11,7,4,2,0,0,0,0,8,6,2,7,APRIL
SULAWESI BARAT,MAMASA,TANDUK KALUA,MINAKE,68,38,29,28,22,11,7,20,2,0,9,17,13,5,8,5,30,5,25,2,2,2,0,2,13,0,13,4,APRIL
SULAWESI BARAT,MAMASA,TANDUK KALUA,MALABO,74,62,21,15,5,3,0,10,4,3,4,4,5,0,5,0,30,24,6,7,19,2,17,1,23,21,2,19,APRIL
SULAWESI BARAT,MAMASA,TANDUK KALUA,SINDAGAMANIK,36,70,64,56,31,30,26,15,20,0,47,8,7,0,7,0,68,58,10,38,56,26,30,11,88,71,17,13,APRIL
SULAWESI BARAT,MAMASA,TANDUK KALUA,PARONDOBULAWAN,66,61,22,15,4,1,0,21,0,1,0,22,10,5,5,1,33,32,1,2,31,19,12,15,10,7,3,5,APRIL
SULAWESI BARAT,MAMASA,TANDUK KALUA,TAMALANTIK,64,58,55,40,3,0,0,9,26,8,4,27,5,2,3,0,52,38,14,17,0,0,0,0,38,19,19,5,APRIL
SULAWESI BARAT,MAMASA,TANDUK KALUA,MANNABABA,78,17,11,4,4,2,1,4,5,0,3,3,10,7,3,0,17,13,4,11,7,7,0,0,12,12,0,7,APRIL
SULAWESI BARAT,MAMASA,TANDUK KALUA,MESAKADA,92,69,10,1,0,0,0,5,0,1,8,1,11,3,8,3,33,16,17,14,16,15,1,6,5,0,5,2,APRIL
SULAWESI BARAT,MAMASA,TANDUK KALUA,BALLABATU,97,74,4,2,2,1,1,0,3,0,4,0,3,2,1,1,60,35,25,26,56,45,11,17,77,65,12,63,APRIL
SULAWESI BARAT,MAMASA,TANDUK KALUA,PAMBE,56,13,0,0,0,0,0,0,0,0,0,0,6,6,0,0,10,10,0,5,8,7,1,3,2,2,0,2,APRIL
SULAWESI BARAT,MAMASA,TANDUK KALUA,SALURANO,37,60,59,32,5,1,0,21,0,0,8,11,1,0,1,0,17,13,4,11,10,1,9,0,37,15,22,32,APRIL
SULAWESI BARAT,MAMASA,TANDUK KALUA,TALIMBUNG,58,30,2,2,1,1,0,1,0,1,2,0,2,2,0,2,22,22,0,11,1,0,1,0,7,3,4,1,APRIL
SULAWESI BARAT,MAMASA,TANDUK KALUA,KANAN,62,61,28,24,17,5,1,20,4,1,1,21,2,1,1,0,41,41,0,37,17,2,15,1,45,4,41,37,APRIL
SULAWESI BARAT,MAMASA,TAWALIAN,TAWALIAN,32,36,31,29,28,20,1,6,2,14,22,3,6,2,4,2,25,18,7,15,23,6,17,1,22,11,11,10,APRIL
SULAWESI BARAT,MAMASA,TAWALIAN,TAWALIAN TIMUR,75,38,4,3,3,2,1,0,0,3,4,0,13,11,2,4,14,11,3,8,3,1,2,0,0,0,0,0,APRIL
SULAWESI BARAT,MAMASA,TAWALIAN,KARIANGO,68,24,4,2,2,2,0,4,0,0,1,3,4,4,0,3,24,18,6,1,16,6,10,4,25,10,15,16,APRIL
SULAWESI BARAT,MAMASA,TAWALIAN,RANTETANGNGA,34,57,46,39,1,1,1,21,14,8,4,2,3,2,1,0,22,13,9,13,1,0,1,0,27,11,16,6,APRIL
SULAWESI BARAT,POLEWALI MANDAR,ALLU,PETOOSANG,32,70,34,8,3,3,1,2,18,11,34,0,2,1,1,0,44,44,0,34,4,3,1,1,26,2,24,20,APRIL
SULAWESI BARAT,POLEWALI MANDAR,ALLU,MOMBI,93,57,23,1,1,1,0,1,10,10,14,4,4,2,2,1,53,38,15,1,20,16,4,5,11,5,6,2,APRIL
SULAWESI BARAT,POLEWALI MANDAR,ALLU,KALUMAMMANG,84,78,31,9,2,1,0,31,0,0,25,0,4,1,3,1,54,38,16,34,48,7,41,1,33,19,14,1,APRIL
SULAWESI BARAT,POLEWALI MANDAR,ALLU,PAO-PAO,74,22,6,6,5,2,0,4,2,0,5,0,0,0,0,0,19,18,1,9,8,0,8,0,15,4,11,9,APRIL
SULAWESI BARAT,POLEWALI MANDAR,ALLU,PUPPU URING,94,37,37,35,12,10,4,25,0,8,15,6,13,7,6,4,31,7,24,2,11,6,5,0,7,2,5,5,APRIL
SULAWESI BARAT,POLEWALI MANDAR,ALLU,SARAGIAN,57,29,26,20,20,3,2,23,0,1,12,0,6,0,6,0,14,14,0,12,0,0,0,0,11,3,8,5,APRIL
SULAWESI BARAT,POLEWALI MANDAR,ALLU,SAYOANG,92,40,23,21,1,0,0,5,13,2,10,10,6,6,0,2,19,18,1,17,7,6,1,2,3,0,3,3,APRIL
SULAWESI BARAT,POLEWALI MANDAR,ALLU,ALU,70,22,3,2,2,1,0,0,1,1,0,2,6,5,1,2,17,14,3,6,9,0,9,0,23,20,3,7,APRIL
SULAWESI BARAT,POLEWALI MANDAR,ANREAPI,ANREAPI,99,55,42,5,1,0,0,2,36,3,3,7,11,2,9,0,51,30,21,3,50,47,3,4,84,41,43,43,APRIL
SULAWESI BARAT,POLEWALI MANDAR,ANREAPI,DUAMPANUA,67,42,42,5,2,2,0,26,3,5,29,9,7,2,5,1,33,27,6,19,23,10,13,3,26,21,5,17,APRIL
SULAWESI BARAT,POLEWALI MANDAR,ANREAPI,KELAPA DUA,95,42,5,0,0,0,0,4,0,0,5,0,2,0,2,0,32,14,18,12,27,3,24,3,19,19,0,15,APRIL
SULAWESI BARAT,POLEWALI MANDAR,ANREAPI,PAPPANDANGAN,78,73,4,2,2,0,0,2,0,2,2,1,8,1,7,0,33,30,3,3,28,5,23,3,4,1,3,1,APRIL
SULAWESI BARAT,POLEWALI MANDAR,ANREAPI,KUNYI,92,33,1,0,0,0,0,0,1,0,1,0,7,3,4,1,33,12,21,7,7,4,3,2,6,1,5,6,APRIL
SULAWESI BARAT,POLEWALI MANDAR,BALANIPA,BALANIPA,59,27,4,0,0,0,0,2,0,0,0,3,6,6,0,5,20,14,6,9,20,19,1,16,6,6,0,6,APRIL
SULAWESI BARAT,POLEWALI MANDAR,BALANIPA,TAMMAJARRA,48,71,15,9,4,1,1,10,4,0,15,0,8,7,1,4,68,23,45,15,20,3,17,0,30,10,20,21,APRIL
SULAWESI BARAT,POLEWALI MANDAR,BALANIPA,TAMANGGALLE,43,24,17,16,9,1,1,15,1,0,13,1,7,5,2,4,18,17,1,7,1,1,0,0,5,4,1,4,APRIL
SULAWESI BARAT,POLEWALI MANDAR,BALANIPA,MOSSO,43,80,44,29,3,0,0,29,4,1,18,0,6,4,2,1,54,26,28,10,40,17,23,3,76,24,52,57,APRIL
SULAWESI BARAT,POLEWALI MANDAR,BALANIPA,GALUNG TULUK,94,61,38,23,11,8,2,18,12,5,18,6,12,0,12,0,54,50,4,29,7,6,1,1,22,2,20,0,APRIL
SULAWESI BARAT,POLEWALI MANDAR,BALANIPA,SABANG SUBIK,56,22,3,0,0,0,0,3,0,0,1,1,8,7,1,6,22,15,7,4,8,2,6,0,4,0,4,0,APRIL
SULAWESI BARAT,POLEWALI MANDAR,BALANIPA,PAMBUSUANG,32,49,34,24,23,8,1,18,2,12,28,1,3,1,2,0,15,13,2,5,3,3,0,0,22,12,10,1,APRIL
SULAWESI BARAT,POLEWALI MANDAR,BALANIPA,BALA,74,31,22,11,0,0,0,14,7,1,19,3,11,2,9,2,26,8,18,0,23,4,19,3,1,0,1,0,APRIL
SULAWESI BARAT,POLEWALI MANDAR,BALANIPA,LAMBANAN,62,53,15,9,0,0,0,8,6,0,9,4,3,1,2,1,52,51,1,51,37,0,37,0,19,1,18,13,APRIL
SULAWESI BARAT,POLEWALI MANDAR,BALANIPA,LEGO,63,55,7,3,0,0,0,7,0,0,3,0,8,5,3,5,17,9,8,4,13,3,10,2,3,2,1,1,APRIL
SULAWESI BARAT,POLEWALI MANDAR,BALANIPA,PALLIS,51,32,30,15,14,12,4,19,7,0,14,10,4,3,1,3,19,18,1,6,18,0,18,0,10,10,0,2,APRIL
SULAWESI BARAT,POLEWALI MANDAR,BINUANG,AMASSANGAN,59,79,74,38,0,0,0,54,16,2,3,33,11,4,7,1,24,11,13,0,17,14,3,1,47,41,6,21,APRIL
SULAWESI BARAT,POLEWALI MANDAR,BINUANG,TONYAMAN,41,37,3,2,0,0,0,0,3,0,1,0,0,0,0,0,31,18,13,3,4,3,1,1,15,3,12,4,APRIL
SULAWESI BARAT,POLEWALI MANDAR,BINUANG,KUAJANG,86,45,32,5,1,1,1,31,0,0,32,0,4,2,2,0,18,13,5,2,11,7,4,5,18,3,15,9,APRIL
SULAWESI BARAT,POLEWALI MANDAR,BINUANG,PAKU,79,64,7,6,4,1,0,2,3,0,7,0,4,2,2,0,57,44,13,25,29,20,9,8,19,5,14,13,APRIL
SULAWESI BARAT,POLEWALI MANDAR,BINUANG,MIRRING,76,12,4,1,0,0,0,4,0,0,4,0,15,6,9,3,11,11,0,1,6,6,0,0,3,2,1,2,APRIL
SULAWESI BARAT,POLEWALI MANDAR,BINUANG,BATETANGNGA,98,62,55,19,11,2,1,42,5,3,4,3,10,4,6,3,50,36,14,12,19,10,9,5,6,5,1,1,APRIL
SULAWESI BARAT,POLEWALI MANDAR,BINUANG,MAMMI,87,76,56,55,20,19,9,30,11,0,32,16,11,10,1,7,62,24,38,21,49,1,48,1,65,61,4,24,APRIL
SULAWESI BARAT,POLEWALI MANDAR,BINUANG,KALEOK,93,19,13,1,1,1,1,6,2,1,4,4,0,0,0,0,13,8,5,8,0,0,0,0,6,4,2,0,APRIL
SULAWESI BARAT,POLEWALI MANDAR,BINUANG,AMOLA,44,40,14,7,2,1,1,5,2,1,2,8,5,5,0,0,28,27,1,13,22,4,18,1,34,8,26,10,APRIL
SULAWESI BARAT,POLEWALI MANDAR,BINUANG,REA,79,36,22,6,1,1,1,10,9,1,5,16,2,1,1,0,10,7,3,4,7,5,2,5,28,7,21,15,APRIL
SULAWESI BARAT,POLEWALI MANDAR,BULO,BULO,97,58,14,6,3,0,0,1,2,10,8,3,13,5,8,5,44,20,24,11,17,2,15,1,18,4,14,0,APRIL
SULAWESI BARAT,POLEWALI MANDAR,BULO,PULLIWA,95,45,10,9,4,4,0,9,0,1,4,6,2,2,0,0,37,32,5,7,31,5,26,5,16,15,1,4,APRIL
SULAWESI BARAT,POLEWALI MANDAR,BULO,PATAMBANUA,64,33,29,6,1,0,0,5,2,6,7,12,7,2,5,1,29,14,15,5,28,14,14,9,48,26,22,23,APRIL
SULAWESI BARAT,POLEWALI MANDAR,BULO,KAROMBANG,58,21,3,0,0,0,0,2,1,0,2,0,2,2,0,1,14,5,9,4,14,6,8,6,5,2,3,0,APRIL
SULAWESI BARAT,POLEWALI MANDAR,BULO,DAALA TIMUR,92,52,38,8,3,3,3,32,1,1,11,16,8,3,5,1,11,5,6,1,11,10,1,6,42,3,39,3,APRIL
SULAWESI BARAT,POLEWALI MANDAR,BULO,LENGGO,93,79,44,11,0,0,0,42,0,0,5,12,13,11,2,1,35,14,21,13,24,21,3,5,8,7,1,1,APRIL
SULAWESI BARAT,POLEWALI MANDAR,BULO,SABURA,82,63,22,20,7,3,1,17,0,4,16,6,8,5,3,1,62,62,0,8,62,9,53,7,51,36,15,37,APRIL
SULAWESI BARAT,POLEWALI MANDAR,BULO,SEPPORRAKI,39,21,10,6,1,0,0,8,0,2,1,8,4,4,0,4,20,16,4,5,16,0,16,0,28,16,12,0,APRIL
SULAWESI BARAT,POLEWALI MANDAR,BULO,IHING,59,56,8,4,2,2,2,6,0,0,2,0,5,5,0,2,32,27,5,26,5,5,0,4,29,22,7,23,APRIL
SULAWESI BARAT,POLEWALI MANDAR,CAMPALAGIAN,PAPPANG,50,55,19,14,13,10,9,5,0,4,13,3,0,0,0,0,53,20,33,1,17,8,9,8,49,29,20,44,APRIL
SULAWESI BARAT,POLEWALI MANDAR,CAMPALAGIAN,LALIKO,99,55,41,29,15,0,0,18,1,2,18,15,13,10,3,7,43,29,14,14,40,6,34,0,71,55,16,45,APRIL
SULAWESI BARAT,POLEWALI MANDAR,CAMPALAGIAN,BONDE,87,22,0,0,0,0,0,0,0,0,0,0,2,1,1,0,21,15,6,12,0,0,0,0,12,0,12,5,APRIL
SULAWESI BARAT,POLEWALI MANDAR,CAMPALAGIAN,KATUMBANGAN LEMO,46,32,19,1,0,0,0,1,1,17,3,9,3,0,3,0,15,7,8,1,12,8,4,6,26,2,24,9,APRIL
SULAWESI BARAT,POLEWALI MANDAR,CAMPALAGIAN,PANYAMPA,34,79,62,16,10,9,8,35,2,0,21,8,2,2,0,2,47,44,3,36,34,29,5,1,3,2,1,0,APRIL
SULAWESI BARAT,POLEWALI MANDAR,CAMPALAGIAN,SURUANG,94,59,20,13,1,1,0,10,2,0,15,5,18,1,17,0,48,8,40,8,5,1,4,1,24,13,11,10,APRIL
SULAWESI BARAT,POLEWALI MANDAR,CAMPALAGIAN,LAMPOKO,95,51,29,0,0,0,0,26,3,0,22,5,2,0,2,0,41,35,6,28,0,0,0,0,32,19,13,19,APRIL
SULAWESI BARAT,POLEWALI MANDAR,CAMPALAGIAN,KATUMBANGAN,93,57,23,15,7,6,2,18,1,1,23,0,8,4,4,1,50,24,26,4,43,10,33,8,26,4,22,11,APRIL
SULAWESI BARAT,POLEWALI MANDAR,CAMPALAGIAN,LAPEO,78,44,3,3,1,1,1,2,0,0,2,1,4,1,3,1,14,6,8,2,10,0,10,0,11,8,3,8,APRIL
SULAWESI BARAT,POLEWALI MANDAR,CAMPALAGIAN,PARAPPE,79,48,26,15,2,0,0,6,8,3,20,5,2,2,0,1,42,38,4,10,9,1,8,1,21,18,3,17,APRIL
SULAWESI BARAT,POLEWALI MANDAR,CAMPALAGIAN,ONGKO,88,34,21,16,12,8,5,5,11,0,12,4,9,8,1,7,10,5,5,3,6,6,0,3,8,3,5,8,APRIL
SULAWESI BARAT,POLEWALI MANDAR,CAMPALAGIAN,KENJE,99,39,25,24,18,9,4,8,11,1,24,0,3,1,2,1,11,10,1,0,5,4,1,2,10,8,2,2,APRIL
SULAWESI BARAT,POLEWALI MANDAR,CAMPALAGIAN,SUMARRANG,79,42,30,22,18,7,3,26,0,0,19,3,5,0,5,0,33,14,19,12,10,3,7,0,9,6,3,8,APRIL
SULAWESI BARAT,POLEWALI MANDAR,CAMPALAGIAN,BOTTO,30,44,40,0,0,0,0,8,19,10,30,5,4,1,3,1,25,5,20,2,13,3,10,1,14,11,3,0,APRIL
SULAWESI BARAT,POLEWALI MANDAR,CAMPALAGIAN,GATTUNGAN,95,66,33,28,3,0,0,5,16,0,10,19,5,2,3,2,46,25,21,21,42,2,40,2,38,28,10,27,APRIL
SULAWESI BARAT,POLEWALI MANDAR,CAMPALAGIAN,PADANG TIMUR,89,25,15,6,0,0,0,3,9,2,5,2,0,0,0,0,10,5,5,4,7,6,1,2,10,9,1,6,APRIL
SULAWESI BARAT,POLEWALI MANDAR,CAMPALAGIAN,PADANG,58,29,10,8,4,4,1,2,2,3,0,1,2,1,1,0,28,6,22,5,12,6,6,0,5,3,2,2,APRIL
SULAWESI BARAT,POLEWALI MANDAR,CAMPALAGIAN,LAGI-AGI,65,49,47,15,12,8,1,21,1,15,11,9,8,5,3,2,18,18,0,1,1,0,1,0,23,18,5,20,APRIL
SULAWESI BARAT,POLEWALI MANDAR,LIMBORO,LIMBORO,48,21,1,0,0,0,0,1,0,0,0,0,5,4,1,2,21,8,13,5,5,2,3,2,2,0,2,1,APRIL
SULAWESI BARAT,POLEWALI MANDAR,LIMBORO,LEMBANG LEMBANG,30,67,26,17,15,12,2,1,21,2,15,5,4,2,2,1,57,35,22,0,28,7,21,2,14,13,1,9,APRIL
SULAWESI BARAT,POLEWALI MANDAR,LIMBORO,TANDASURA,78,14,14,3,1,1,0,1,7,4,11,1,13,12,1,5,14,12,2,5,1,1,0,1,10,1,9,10,APRIL
SULAWESI BARAT,POLEWALI MANDAR,LIMBORO,SAMASUNDU,34,23,7,7,3,3,2,1,0,3,4,2,0,0,0,0,13,12,1,0,2,2,0,1,18,0,18,0,APRIL
SULAWESI BARAT,POLEWALI MANDAR,LIMBORO,NAPO,32,42,1,0,0,0,0,1,0,0,0,1,1,1,0,1,39,10,29,6,17,15,2,13,34,24,10,17,APRIL
SULAWESI BARAT,POLEWALI MANDAR,LIMBORO,TODANG TODANG,74,73,47,38,29,26,4,0,17,3,30,16,8,8,0,5,18,14,4,9,9,7,2,2,36,4,32,7,APRIL
SULAWESI BARAT,POLEWALI MANDAR,LIMBORO,PENDULANGAN,40,32,20,16,14,5,4,7,2,4,18,2,6,5,1,5,32,13,19,12,7,3,4,0,24,17,7,12,APRIL
SULAWESI BARAT,POLEWALI MANDAR,LIMBORO,RENGGEANG,90,36,22,15,12,5,2,15,3,1,1,5,12,12,0,3,33,19,14,4,21,14,7,4,26,3,23,2,APRIL
SULAWESI BARAT,POLEWALI MANDAR,LIMBORO,SALARRI,89,67,2,0,0,0,0,1,0,1,0,2,17,12,5,10,53,36,17,20,30,29,1,0,44,27,17,36,APRIL
SULAWESI BARAT,POLEWALI MANDAR,LIMBORO,TANGAN BARU,66,68,47,12,5,5,5,36,3,0,7,25,1,1,0,1,41,36,5,28,1,0,1,0,8,7,1,1,APRIL
SULAWESI BARAT,POLEWALI MANDAR,LIMBORO,PALECE,84,78,36,6,6,1,1,26,4,4,36,0,10,6,4,3,11,10,1,2,2,0,2,0,19,18,1,3,APRIL
SULAWESI BARAT,POLEWALI MANDAR,LUYO,BATUPANGA,90,42,19,16,11,2,2,15,1,0,10,0,6,0,6,0,18,12,6,12,7,2,5,0,14,12,2,5,APRIL
SULAWESI BARAT,POLEWALI MANDAR,LUYO,MAMBU,83,39,9,4,2,0,0,8,1,0,1,5,7,5,2,2,10,8,2,3,8,5,3,3,33,9,24,11,APRIL
SULAWESI BARAT,POLEWALI MANDAR,LUYO,TENGGELANG,81,71,31,4,4,4,0,25,5,0,16,3,9,4,5,2,10,5,5,0,2,0,2,0,36,34,2,36,APRIL
SULAWESI BARAT,POLEWALI MANDAR,LUYO,BARU,81,24,22,4,3,3,2,7,12,0,5,3,5,1,4,0,21,5,16,2,12,9,3,0,24,4,20,3,APRIL
SULAWESI BARAT,POLEWALI MANDAR,LUYO,PUSSUI,73,47,33,20,15,7,2,16,5,0,30,1,12,7,5,5,47,11,36,10,9,8,1,6,37,23,14,34,APRIL
SULAWESI BARAT,POLEWALI MANDAR,LUYO,MAPILI BARAT,76,62,38,27,16,2,1,10,12,1,14,19,11,3,8,1,19,15,4,4,4,1,3,0,33,11,22,32,APRIL
SULAWESI BARAT,POLEWALI MANDAR,LUYO,SAMBALI WALI,89,14,12,4,3,1,1,6,4,1,6,4,7,5,2,0,14,8,6,8,14,6,8,5,8,3,5,3,APRIL
SULAWESI BARAT,POLEWALI MANDAR,LUYO,BATUPANGA DAALA,31,14,6,5,3,2,2,2,0,2,5,1,4,0,4,0,12,11,1,5,3,1,2,1,3,0,3,2,APRIL
SULAWESI BARAT,POLEWALI MANDAR,LUYO,LUYO,90,61,26,19,16,1,0,6,7,11,21,2,13,8,5,7,29,7,22,3,14,0,14,0,41,8,33,29,APRIL
SULAWESI BARAT,POLEWALI MANDAR,LUYO,PUSSUI BARAT,56,50,50,17,2,1,0,25,23,1,14,12,6,4,2,4,36,13,23,9,35,14,21,12,3,3,0,2,APRIL
SULAWESI BARAT,POLEWALI MANDAR,LUYO,PUCCADI,57,32,6,0,0,0,0,4,1,1,2,3,0,0,0,0,22,16,6,13,3,0,3,0,19,2,17,11,APRIL
SULAWESI BARAT,POLEWALI MANDAR,MAPILLI,MAPILI,94,13,12,10,5,0,0,5,2,1,6,2,18,16,2,3,12,7,5,5,9,4,5,0,11,9,2,4,APRIL
SULAWESI BARAT,POLEWALI MANDAR,MAPILLI,UGIBARU,32,21,15,3,2,1,1,12,2,0,9,2,4,3,1,0,14,10,4,1,1,0,1,0,8,0,8,8,APRIL
SULAWESI BARAT,POLEWALI MANDAR,MAPILLI,RUMPA,77,44,35,14,6,2,0,10,18,7,14,8,13,5,8,4,32,31,1,23,13,5,8,4,37,10,27,14,APRIL
SULAWESI BARAT,POLEWALI MANDAR,MAPILLI,KURMA,34,20,12,6,2,2,1,7,2,0,3,6,1,1,0,1,11,11,0,0,5,4,1,2,6,4,2,5,APRIL
SULAWESI BARAT,POLEWALI MANDAR,MAPILLI,BUKU,84,14,12,11,6,4,4,2,5,1,10,1,11,7,4,4,13,8,5,0,0,0,0,0,5,4,1,4,APRIL
SULAWESI BARAT,POLEWALI MANDAR,MAPILLI,BONNE BONNE,85,54,51,13,11,5,2,49,0,0,20,12,6,1,5,1,50,40,10,34,46,31,15,21,55,18,37,17,APRIL
SULAWESI BARAT,POLEWALI MANDAR,MAPILLI,BEROANGIN,94,59,10,1,0,0,0,3,6,1,9,1,5,3,2,1,41,12,29,2,31,0,31,0,2,0,2,1,APRIL
SULAWESI BARAT,POLEWALI MANDAR,MAPILLI,SEGERANG,84,15,12,0,0,0,0,9,2,1,9,2,15,14,1,13,14,10,4,6,2,2,0,1,2,0,2,2,APRIL
SULAWESI BARAT,POLEWALI MANDAR,MAPILLI,BONRA,56,75,28,25,24,2,0,19,5,4,7,20,4,0,4,0,32,19,13,19,12,2,10,0,16,5,11,8,APRIL
SULAWESI BARAT,POLEWALI MANDAR,MAPILLI,SATTOKO,70,25,0,0,0,0,0,0,0,0,0,0,10,10,0,9,17,8,9,2,17,5,12,0,13,0,13,8,APRIL
SULAWESI BARAT,POLEWALI MANDAR,MAPILLI,RAPPANG BARAT,33,13,1,1,1,0,0,1,0,0,1,0,6,3,3,2,10,8,2,6,10,10,0,9,3,3,0,3,APRIL
SULAWESI BARAT,POLEWALI MANDAR,MAPILLI,LANDI KANUSUANG,69,37,33,2,0,0,0,28,5,0,16,12,12,7,5,6,20,18,2,0,3,2,1,2,16,7,9,9,APRIL
SULAWESI BARAT,POLEWALI MANDAR,MATAKALI,MATAKALI,80,76,46,37,13,12,8,19,11,6,43,0,4,4,0,2,21,6,15,3,11,10,1,7,33,17,16,18,APRIL
SULAWESI BARAT,POLEWALI MANDAR,MATAKALI,PETAMPANUA,68,33,31,29,13,11,1,7,21,2,22,7,13,0,13,0,33,15,18,3,9,3,6,3,12,5,7,2,APRIL
SULAWESI BARAT,POLEWALI MANDAR,MATAKALI,BARUMBUNG,52,33,16,8,3,3,1,1,5,8,12,0,1,1,0,1,28,27,1,18,0,0,0,0,6,3,3,6,APRIL
SULAWESI BARAT,POLEWALI MANDAR,MATAKALI,PASIANG,88,14,14,9,2,2,1,6,1,0,9,2,17,4,13,4,11,8,3,2,8,7,1,1,14,1,13,12,APRIL
SULAWESI BARAT,POLEWALI MANDAR,MATAKALI,TONROLIMA,36,72,45,11,7,6,3,28,14,0,42,2,0,0,0,0,16,12,4,11,3,2,1,0,41,12,29,2,APRIL
SULAWESI BARAT,POLEWALI MANDAR,MATAKALI,INDOMAKKOMBONG,63,40,11,3,2,0,0,6,3,0,6,3,2,0,2,0,29,18,11,3,13,12,1,12,17,10,7,15,APRIL
SULAWESI BARAT,POLEWALI MANDAR,MATAKALI,BUNGA-BUNGA,47,48,35,30,14,12,0,4,28,3,32,3,9,5,4,5,25,13,12,10,24,2,22,0,25,23,2,14,APRIL
SULAWESI BARAT,POLEWALI MANDAR,MATANGNGA,MATANGNGA,67,45,18,10,0,0,0,18,0,0,8,5,0,0,0,0,33,13,20,6,5,1,4,0,17,11,6,15,APRIL
SULAWESI BARAT,POLEWALI MANDAR,MATANGNGA,LILLI,89,66,19,7,6,1,0,11,3,4,10,9,13,9,4,6,50,13,37,7,31,1,30,1,14,11,3,11,APRIL
SULAWESI BARAT,POLEWALI MANDAR,MATANGNGA,RANGOAN,72,68,58,46,43,20,4,17,1,1,16,6,13,11,2,2,15,7,8,7,1,1,0,1,35,7,28,28,APRIL
SULAWESI BARAT,POLEWALI MANDAR,MATANGNGA,TAPUA,56,77,2,1,0,0,0,0,1,0,1,1,0,0,0,0,26,8,18,4,17,1,16,1,33,5,28,3,APRIL
SULAWESI BARAT,POLEWALI MANDAR,MATANGNGA,MAMBU TAPUA,31,38,5,0,0,0,0,4,1,0,3,1,4,2,2,2,30,8,22,7,21,10,11,6,20,12,8,1,APRIL
SULAWESI BARAT,POLEWALI MANDAR,MATANGNGA,BA'BA TAPUA,56,21,17,16,13,9,5,8,1,1,11,1,7,1,6,1,14,13,1,1,6,2,4,2,8,2,6,3,APRIL
SULAWESI BARAT,POLEWALI MANDAR,MATANGNGA,KATIMBANG,54,65,41,2,2,2,2,27,5,2,22,13,0,0,0,0,48,23,25,6,37,1,36,0,33,12,21,1,APRIL
SULAWESI BARAT,POLEWALI MANDAR,POLEWALI,POLEWALI,43,21,14,13,3,0,0,6,1,0,3,9,7,0,7,0,11,5,6,2,8,7,1,7,4,2,2,4,APRIL
SULAWESI BARAT,POLEWALI MANDAR,POLEWALI,WATTANG,72,74,55,2,1,1,0,39,10,2,13,14,2,1,1,1,36,33,3,31,5,2,3,2,50,11,39,39,APRIL
SULAWESI BARAT,POLEWALI MANDAR,POLEWALI,SULEWATANG,46,61,11,7,1,0,0,2,7,2,2,1,5,5,0,2,52,44,8,44,19,12,7,2,26,13,13,0,APRIL
SULAWESI BARAT,POLEWALI MANDAR,POLEWALI,LANTORA,52,51,16,8,2,1,1,15,0,0,14,2,0,0,0,0,29,12,17,5,18,10,8,0,39,37,2,23,APRIL
SULAWESI BARAT,POLEWALI MANDAR,POLEWALI,TAKATIDUNG,44,26,16,14,7,6,0,4,8,3,2,1,6,4,2,1,23,19,4,1,23,3,20,0,23,15,8,3,APRIL
SULAWESI BARAT,POLEWALI MANDAR,POLEWALI,PEKKABATA,90,40,19,3,3,1,0,8,10,0,1,16,9,8,1,3,10,9,1,0,5,3,2,0,29,23,6,6,APRIL
SULAWESI BARAT,POLEWALI MANDAR,POLEWALI,MADATE,48,49,3,0,0,0,0,0,0,1,3,0,9,6,3,2,44,15,29,12,25,17,8,15,42,8,34,10,APRIL
SULAWESI BARAT,POLEWALI MANDAR,POLEWALI,MANDING,48,39,3,0,0,0,0,3,0,0,3,0,5,0,5,0,37,10,27,4,18,13,5,13,37,33,4,37,APRIL
SULAWESI BARAT,POLEWALI MANDAR,POLEWALI,DARMA,30,49,46,37,35,19,0,11,30,1,29,6,6,6,0,6,15,7,8,2,7,3,4,3,20,10,10,0,APRIL
SULAWESI BARAT,POLEWALI MANDAR,TAPANGO,PELITAKAN,54,44,32,17,5,3,3,24,0,4,0,13,5,4,1,4,36,33,3,24,20,5,15,4,29,14,15,5,APRIL
SULAWESI BARAT,POLEWALI MANDAR,TAPANGO,TAPANGO,45,61,13,8,6,5,2,1,9,0,13,0,5,0,5,0,32,32,0,13,3,1,2,1,1,1,0,0,APRIL
SULAWESI BARAT,POLEWALI MANDAR,TAPANGO,RAPPANG,64,75,12,11,0,0,0,12,0,0,8,1,7,2,5,1,50,34,16,25,32,1,31,0,30,1,29,30,APRIL
SULAWESI BARAT,POLEWALI MANDAR,TAPANGO,DAKKA,73,80,58,7,0,0,0,9,3,12,29,11,0,0,0,0,71,36,35,8,69,3,66,0,43,18,25,7,APRIL
SULAWESI BARAT,POLEWALI MANDAR,TAPANGO,BATU,87,66,19,2,0,0,0,0,0,9,0,5,14,14,0,6,63,19,44,0,30,14,16,14,31,3,28,11,APRIL
SULAWESI BARAT,POLEWALI MANDAR,TAPANGO,RISO,64,80,23,15,11,4,1,4,12,2,1,4,2,0,2,0,19,5,14,4,19,16,3,10,35,17,18,10,APRIL
SULAWESI BARAT,POLEWALI MANDAR,TAPANGO,PALATTA,88,13,1,1,0,0,0,0,1,0,1,0,9,5,4,4,10,7,3,2,9,4,5,4,9,3,6,9,APRIL
SULAWESI BARAT,POLEWALI MANDAR,TAPANGO,TAPANGO BARAT,95,26,7,1,0,0,0,6,1,0,0,5,0,0,0,0,23,23,0,21,23,15,8,5,18,4,14,0,APRIL
SULAWESI BARAT,POLEWALI MANDAR,TAPANGO,KURRAK,82,43,20,4,4,3,2,14,4,0,4,11,16,15,1,15,25,25,0,23,15,5,10,3,11,8,3,9,APRIL
SULAWESI BARAT,POLEWALI MANDAR,TAPANGO,BUSSU,43,63,12,4,4,2,0,6,3,3,12,0,2,0,2,0,52,48,4,12,24,23,1,9,54,52,2,9,APRIL
SULAWESI BARAT,POLEWALI MANDAR,TAPANGO,TUTTULA,49,21,5,0,0,0,0,1,1,2,1,3,0,0,0,0,21,5,16,5,12,0,12,0,8,0,8,1,APRIL
SULAWESI BARAT,POLEWALI MANDAR,TAPANGO,JAMBU MALEA,61,17,13,12,10,8,8,1,0,2,11,0,0,0,0,0,16,11,5,6,10,5,5,4,21,21,0,11,APRIL
SULAWESI BARAT,POLEWALI MANDAR,TAPANGO,KALIMBUA,38,33,28,6,6,3,2,15,10,0,11,10,3,0,3,0,29,6,23,4,7,2,5,2,18,17,1,1,APRIL
SULAWESI BARAT,POLEWALI MANDAR,TAPANGO,BANATO REJO,77,65,32,13,8,6,5,2,7,16,15,2,3,3,0,3,24,7,17,4,12,12,0,11,43,24,19,15,APRIL
SULAWESI BARAT,POLEWALI MANDAR,TINAMBUNG,TINAMBUNG,73,43,26,2,2,0,0,4,15,4,6,4,9,1,8,0,11,11,0,4,8,4,4,1,35,32,3,26,APRIL
SULAWESI BARAT,POLEWALI MANDAR,TINAMBUNG,KARAMA,72,45,10,4,2,2,0,6,3,1,4,1,4,0,4,0,24,24,0,13,1,1,0,0,1,0,1,1,APRIL
SULAWESI BARAT,POLEWALI MANDAR,TINAMBUNG,TANGNGA TANGNGA,35,14,4,1,1,1,1,0,0,3,0,0,1,1,0,1,13,11,2,5,6,1,5,1,1,1,0,1,APRIL
SULAWESI BARAT,POLEWALI MANDAR,TINAMBUNG,LEKOPADIS,32,69,59,43,20,5,0,32,18,4,13,23,1,0,1,0,42,18,24,0,12,8,4,8,18,10,8,6,APRIL
SULAWESI BARAT,POLEWALI MANDAR,TINAMBUNG,GALUNG LOMBOK,53,33,18,8,5,1,1,13,3,0,9,0,2,0,2,0,12,10,2,3,1,1,0,1,9,4,5,7,APRIL
SULAWESI BARAT,POLEWALI MANDAR,TINAMBUNG,TANDUNG,79,47,22,8,5,1,0,7,13,0,0,13,6,1,5,1,12,11,1,0,3,0,3,0,3,3,0,2,APRIL
SULAWESI BARAT,POLEWALI MANDAR,TINAMBUNG,BATULAYA,69,59,22,13,5,4,3,7,6,0,14,2,8,0,8,0,32,25,7,3,19,10,9,3,35,9,26,14,APRIL
SULAWESI BARAT,POLEWALI MANDAR,TINAMBUNG,SEPABATU,81,23,3,2,2,0,0,2,0,0,3,0,15,9,6,8,19,18,1,9,16,3,13,3,30,1,29,3,APRIL
SULAWESI BARAT,POLEWALI MANDAR,TUTAR,TARAMANU,81,56,14,0,0,0,0,0,10,1,1,2,13,8,5,6,37,24,13,23,22,20,2,11,6,0,6,4,APRIL
SULAWESI BARAT,POLEWALI MANDAR,TUTAR,AMBOPADANG,82,80,41,6,3,2,0,39,2,0,29,0,2,1,1,1,45,29,16,4,18,15,3,15,34,3,31,24,APRIL
SULAWESI BARAT,POLEWALI MANDAR,TUTAR,TUBBI,49,79,56,27,5,1,0,21,17,4,31,22,3,3,0,2,58,19,39,1,1,1,0,0,7,4,3,4,APRIL
SULAWESI BARAT,POLEWALI MANDAR,TUTAR,RATTE,43,50,46,24,13,2,1,41,2,2,34,0,5,5,0,4,29,18,11,4,1,0,1,0,27,22,5,18,APRIL
SULAWESI BARAT,POLEWALI MANDAR,TUTAR,BESOANGIN,77,79,4,1,0,0,0,4,0,0,4,0,4,4,0,4,46,16,30,8,26,20,6,17,24,7,17,19,APRIL
SULAWESI BARAT,POLEWALI MANDAR,TUTAR,PIRIANG TAPIKO,51,22,9,9,1,1,1,8,0,0,9,0,6,0,6,0,21,6,15,1,2,1,1,0,14,9,5,5,APRIL
SULAWESI BARAT,POLEWALI MANDAR,TUTAR,PEBURRU,93,55,46,13,10,8,2,11,17,11,0,6,6,5,1,4,18,13,5,2,11,11,0,11,1,1,0,1,APRIL
SULAWESI BARAT,POLEWALI MANDAR,TUTAR,TALOBA,78,17,8,7,6,2,0,4,1,2,8,0,3,3,0,1,16,13,3,3,13,1,12,0,17,11,6,3,APRIL
SULAWESI BARAT,POLEWALI MANDAR,TUTAR,POLLEWANI,44,50,49,39,39,17,15,17,5,8,26,17,0,0,0,0,39,22,17,15,39,25,14,18,31,17,14,31,APRIL
SULAWESI BARAT,POLEWALI MANDAR,TUTAR,ARABUA,93,16,0,0,0,0,0,0,0,0,0,0,7,6,1,2,13,11,2,4,7,6,1,0,12,5,7,7,APRIL
SULAWESI BARAT,POLEWALI MANDAR,TUTAR,BESOANGIN UTARA,32,73,38,24,15,12,12,1,3,21,16,5,2,0,2,0,64,55,9,52,61,9,52,5,8,6,2,3,APRIL
SULAWESI BARAT,POLEWALI MANDAR,TUTAR,PODA,74,35,12,6,0,0,0,9,0,1,4,5,5,4,1,3,16,9,7,8,9,3,6,1,1,0,1,0,APRIL
SULAWESI BARAT,POLEWALI MANDAR,TUTAR,TARAMANU TUA,78,43,40,3,3,3,1,31,1,2,21,14,11,5,6,4,12,7,5,1,10,0,10,0,17,3,14,8,APRIL
SULAWESI BARAT,POLEWALI MANDAR,WONOMULYO,SIDODADI,60,37,2,0,0,0,0,1,0,1,2,0,6,2,4,2,12,8,4,6,1,1,0,0,12,4,8,9,APRIL
SULAWESI BARAT,POLEWALI MANDAR,WONOMULYO,SIDOREJO,42,42,3,0,0,0,0,3,0,0,3,0,0,0,0,0,22,8,14,6,1,1,0,0,7,0,7,5,APRIL
SULAWESI BARAT,POLEWALI MANDAR,WONOMULYO,SUMBEREJO,43,26,26,2,1,1,1,21,3,0,6,20,2,1,1,0,18,6,12,0,9,0,9,0,12,12,0,8,APRIL
SULAWESI BARAT,POLEWALI MANDAR,WONOMULYO,BUMIAYU,94,58,20,7,1,0,0,20,0,0,9,11,5,3,2,2,45,27,18,1,42,33,9,23,38,12,26,23,APRIL
SULAWESI BARAT,POLEWALI MANDAR,WONOMULYO,KEBUNSARI,91,45,43,16,9,1,1,6,20,5,42,0,5,1,4,0,12,9,3,2,0,0,0,0,26,1,25,24,APRIL
SULAWESI BARAT,POLEWALI MANDAR,WONOMULYO,BANUA BARU,54,47,40,19,17,5,0,10,18,8,29,7,8,5,3,1,38,6,32,6,3,0,3,0,21,21,0,12,APRIL
SULAWESI BARAT,POLEWALI MANDAR,WONOMULYO,NEPO,55,38,13,11,1,1,1,11,1,0,0,1,11,0,11,0,11,8,3,6,2,0,2,0,2,2,0,2,APRIL
SULAWESI BARAT,POLEWALI MANDAR,WONOMULYO,SUGIHWARAS,44,50,34,1,1,0,0,16,18,0,15,11,0,0,0,0,34,15,19,2,32,32,0,10,38,32,6,35,APRIL
SULAWESI BARAT,POLEWALI MANDAR,WONOMULYO,CAMPURJO,31,20,7,1,1,0,0,3,3,1,1,3,5,4,1,1,15,5,10,3,12,4,8,3,25,1,24,9,APRIL
SULAWESI BARAT,POLEWALI MANDAR,WONOMULYO,BUMIMULYO,68,19,14,10,4,1,1,11,0,2,9,5,7,4,3,2,17,6,11,4,1,0,1,0,4,1,3,1,APRIL
SULAWESI BARAT,POLEWALI MANDAR,WONOMULYO,TUMPILING,76,63,50,48,14,10,7,19,23,0,36,6,4,0,4,0,51,41,10,16,11,3,8,3,24,24,0,16,APRIL
SULAWESI BARAT,POLEWALI MANDAR,WONOMULYO,BAKKA-BAKKA,97,62,4,0,0,0,0,4,0,0,2,2,2,1,1,0,21,6,15,6,3,1,2,1,13,1,12,3,APRIL
SULAWESI BARAT,POLEWALI MANDAR,WONOMULYO,ARJO SARI,88,71,62,24,4,3,3,26,32,0,47,9,16,2,14,2,45,26,19,20,26,13,13,2,8,4,4,7,APRIL
SULAWESI BARAT,POLEWALI MANDAR,WONOMULYO,GALESON,99,71,70,60,30,19,19,4,23,5,29,14,12,1,11,1,56,50,6,11,18,5,13,1,33,2,31,1,APRIL
SULAWESI BARAT,MAMUJU,MAMUJU,BINANGA,37,30,18,1,1,0,0,18,0,0,12,0,5,5,0,4,17,9,8,2,2,0,2,0,22,4,18,11,APRIL
SULAWESI BARAT,MAMUJU,MAMUJU,MAMUNYU,90,50,24,8,8,6,6,2,12,0,19,4,12,12,0,8,20,10,10,7,4,0,4,0,33,32,1,13,APRIL
SULAWESI BARAT,MAMUJU,MAMUJU,KAREMA,93,27,6,2,0,0,0,6,0,0,0,0,0,0,0,0,11,5,6,4,10,9,1,0,2,0,2,0,APRIL
SULAWESI BARAT,MAMUJU,MAMUJU,RIMUKU,57,24,1,1,0,0,0,0,0,1,1,0,10,0,10,0,13,9,4,5,1,1,0,0,2,2,0,2,APRIL
SULAWESI BARAT,MAMUJU,MAMUJU,BAMBU,73,55,46,26,4,4,0,7,30,9,46,0,1,1,0,1,54,7,47,4,42,12,30,3,41,37,4,4,APRIL
SULAWESI BARAT,MAMUJU,MAMUJU,KARAMPUANG,64,37,13,11,9,5,2,2,7,0,8,2,7,4,3,4,19,13,6,4,15,8,7,4,28,25,3,17,APRIL
SULAWESI BARAT,MAMUJU,MAMUJU,TADUI,64,24,9,7,6,4,2,0,1,3,5,3,0,0,0,0,16,14,2,12,16,0,16,0,23,22,1,21,APRIL
SULAWESI BARAT,MAMUJU,MAMUJU,BATU PANNU,32,68,20,15,6,0,0,11,6,1,19,1,0,0,0,0,46,30,16,28,20,0,20,0,2,1,1,0,APRIL
SULAWESI BARAT,MAMUJU,TAPALANG,GALUNG,62,39,8,0,0,0,0,5,0,1,6,2,9,8,1,7,26,20,6,3,2,2,0,0,5,0,5,1,APRIL
SULAWESI BARAT,MAMUJU,TAPALANG,KASAMBANG,75,77,46,38,19,10,5,39,0,2,4,1,4,1,3,0,42,36,6,23,31,29,2,13,18,12,6,8,APRIL
SULAWESI BARAT,MAMUJU,TAPALANG,DAYANGINNA,63,19,4,3,2,0,0,4,0,0,2,2,11,11,0,11,12,11,1,6,9,8,1,8,5,2,3,0,APRIL
SULAWESI BARAT,MAMUJU,TAPALANG,OROBATU,49,23,1,0,0,0,0,0,1,0,1,0,7,5,2,4,13,9,4,7,6,5,1,1,18,13,5,6,APRIL
SULAWESI BARAT,MAMUJU,TAPALANG,TAKANDEANG,89,11,11,2,2,2,2,9,0,0,8,1,0,0,0,0,10,6,4,5,0,0,0,0,1,0,1,1,APRIL
SULAWESI BARAT,MAMUJU,TAPALANG,BELA,30,55,44,17,3,2,1,10,33,0,30,6,5,0,5,0,43,18,25,18,11,11,0,9,25,11,14,9,APRIL
SULAWESI BARAT,MAMUJU,TAPALANG,TAAN,70,52,12,7,0,0,0,12,0,0,4,1,12,0,12,0,52,18,34,11,13,11,2,4,14,2,12,9,APRIL
SULAWESI BARAT,MAMUJU,TAPALANG,TAMPALANG,98,18,0,0,0,0,0,0,0,0,0,0,3,2,1,2,15,6,9,6,12,10,2,0,2,0,2,1,APRIL
SULAWESI BARAT,MAMUJU,TAPALANG,RANTEDODA,67,10,9,6,2,0,0,5,3,0,7,2,12,2,10,0,10,10,0,9,5,2,3,0,11,11,0,11,APRIL
SULAWESI BARAT,MAMUJU,TAPALANG,KOPEANG,86,37,35,15,11,8,8,27,0,0,18,6,1,0,1,0,34,34,0,12,10,0,10,0,17,5,12,1,APRIL
SULAWESI BARAT,MAMUJU,KALUKKU,SINYONYOI,31,24,7,3,0,0,0,2,1,0,7,0,5,4,1,0,23,11,12,1,0,0,0,0,4,1,3,1,APRIL
SULAWESI BARAT,MAMUJU,KALUKKU,BEBANGA,67,24,11,0,0,0,0,4,2,4,8,1,10,1,9,0,10,9,1,2,4,3,1,0,13,13,0,7,APRIL
SULAWESI BARAT,MAMUJU,KALUKKU,KALUKKU,48,13,2,0,0,0,0,2,0,0,2,0,7,1,6,0,11,7,4,3,5,5,0,4,4,0,4,3,APRIL
SULAWESI BARAT,MAMUJU,KALUKKU,SINYONYOI SELATAN,36,36,6,2,1,1,1,0,4,1,4,0,0,0,0,0,27,26,1,4,15,8,7,3,8,6,2,8,APRIL
SULAWESI BARAT,MAMUJU,KALUKKU,SONDOANG,70,34,2,0,0,0,0,2,0,0,2,0,11,3,8,3,23,21,2,2,10,4,6,1,2,1,1,2,APRIL
SULAWESI BARAT,MAMUJU,KALUKKU,BERU-BERU,53,45,18,14,14,9,3,1,3,6,14,1,2,0,2,0,22,18,4,3,22,20,2,15,11,4,7,11,APRIL
SULAWESI BARAT,MAMUJU,KALUKKU,BELANG BELANG,90,26,18,15,3,3,1,11,3,1,11,2,8,3,5,1,17,7,10,5,13,3,10,2,24,16,8,23,APRIL
SULAWESI BARAT,MAMUJU,KALUKKU,KABULOANG,59,64,60,21,20,9,8,47,4,1,44,4,6,2,4,1,35,20,15,6,31,13,18,0,24,12,12,1,APRIL
SULAWESI BARAT,MAMUJU,KALUKKU,KEANG,37,54,10,6,1,0,0,8,1,1,3,6,5,3,2,0,38,30,8,24,1,0,1,0,8,1,7,8,APRIL
SULAWESI BARAT,MAMUJU,KALUKKU,POKKANG,81,21,9,0,0,0,0,0,8,1,6,3,1,1,0,0,18,7,11,3,17,10,7,10,29,13,16,26,APRIL
SULAWESI BARAT,MAMUJU,KALUKKU,GULILING,86,52,41,40,0,0,0,35,3,0,34,5,0,0,0,0,48,6,42,2,45,13,32,1,52,16,36,10,APRIL
SULAWESI BARAT,MAMUJU,KALUKKU,UHAIMATE,44,13,7,3,0,0,0,4,3,0,6,0,1,1,0,0,11,6,5,1,4,3,1,0,9,1,8,4,APRIL
SULAWESI BARAT,MAMUJU,KALUKKU,KALUKKU BARAT,70,45,10,4,3,2,2,5,1,1,7,2,8,1,7,1,14,9,5,3,0,0,0,0,8,2,6,0,APRIL
SULAWESI BARAT,MAMUJU,KALUKKU,PAMMULUKANG,54,26,11,11,11,1,1,10,0,0,8,0,0,0,0,0,17,14,3,1,12,2,10,0,8,1,7,0,APRIL
SULAWESI BARAT,MAMUJU,KALUMPANG,KALUMPANG,46,48,15,5,1,1,1,9,0,4,4,2,5,5,0,1,24,24,0,15,24,15,9,12,40,38,2,30,APRIL
SULAWESI BARAT,MAMUJU,KALUMPANG,KARATAUN,34,32,9,5,4,2,0,0,5,2,5,4,0,0,0,0,20,16,4,9,2,2,0,1,24,2,22,12,APRIL
SULAWESI BARAT,MAMUJU,KALUMPANG,KARAMA,65,75,51,22,16,5,1,44,1,2,42,5,1,1,0,1,27,19,8,6,12,0,12,0,0,0,0,0,APRIL
SULAWESI BARAT,MAMUJU,KALUMPANG,SIRAUN,57,57,44,1,0,0,0,10,34,0,21,6,11,11,0,4,15,7,8,4,6,5,1,5,3,3,0,3,APRIL
SULAWESI BARAT,MAMUJU,KALUMPANG,TUMOGA,66,36,2,1,1,0,0,0,1,1,1,1,8,1,7,1,27,12,15,10,10,5,5,2,28,9,19,23,APRIL
SULAWESI BARAT,MAMUJU,KALUMPANG,SALUMAKKI,43,69,0,0,0,0,0,0,0,0,0,0,7,2,5,1,38,19,19,18,32,11,21,9,66,64,2,1,APRIL
SULAWESI BARAT,MAMUJU,KALUMPANG,POLIO,73,50,15,6,2,1,1,14,0,0,0,14,5,5,0,5,37,21,16,2,16,16,0,7,49,38,11,41,APRIL
SULAWESI BARAT,MAMUJU,KALUMPANG,LIMBONG,95,64,12,12,5,2,2,4,4,2,1,1,17,6,11,5,34,28,6,11,14,2,12,1,52,5,47,45,APRIL
SULAWESI BARAT,MAMUJU,KALUMPANG,SANDAPANG,81,49,22,14,7,3,3,11,0,6,14,2,3,0,3,0,40,18,22,13,13,1,12,0,18,8,10,14,APRIL
SULAWESI BARAT,MAMUJU,KALUMPANG,KONDO BULO,79,16,9,7,7,4,0,6,1,2,1,1,3,3,0,3,14,8,6,7,1,1,0,0,12,2,10,2,APRIL
SULAWESI BARAT,MAMUJU,KALUMPANG,MAKKALIKI,77,25,16,5,3,3,2,6,4,2,13,1,7,6,1,1,22,6,16,5,17,5,12,4,12,10,2,2,APRIL
SULAWESI BARAT,MAMUJU,KALUMPANG,BATU MAKKADA,75,45,44,40,4,2,2,34,5,3,41,1,4,1,3,0,27,24,3,21,18,3,15,0,30,13,17,3,APRIL
SULAWESI BARAT,MAMUJU,KALUMPANG,LASA',90,38,7,6,4,3,3,4,0,0,0,2,16,8,8,2,10,10,0,0,7,2,5,2,21,8,13,12,APRIL
SULAWESI BARAT,MAMUJU,PAPALANG,TOABO,68,41,10,5,4,4,1,8,0,0,9,1,11,11,0,10,35,14,21,12,10,5,5,4,30,27,3,2,APRIL
SULAWESI BARAT,MAMUJU,PAPALANG,PAPALANG,89,62,23,20,15,5,0,19,2,2,0,22,12,1,11,1,37,36,1,28,36,19,17,7,62,62,0,44,APRIL
SULAWESI BARAT,MAMUJU,PAPALANG,BONDA,84,73,13,3,2,0,0,8,5,0,0,0,3,1,2,0,21,12,9,11,6,6,0,4,7,1,6,7,APRIL
SULAWESI BARAT,MAMUJU,PAPALANG,TOPORE,85,72,7,2,0,0,0,2,2,1,5,2,17,17,0,15,36,10,26,9,23,8,15,1,69,53,16,43,APRIL
SULAWESI BARAT,MAMUJU,PAPALANG,SALUKAYU,63,40,35,23,2,1,1,15,13,3,6,28,8,7,1,6,13,10,3,10,1,0,1,0,10,0,10,3,APRIL
SULAWESI BARAT,MAMUJU,PAPALANG,SUKADAMAI,87,45,41,0,0,0,0,23,5,3,16,2,15,4,11,2,34,27,7,0,22,6,16,6,32,31,1,10,APRIL
SULAWESI BARAT,MAMUJU,PAPALANG,BODA-BODA,67,11,7,0,0,0,0,3,0,0,3,4,0,0,0,0,10,8,2,5,8,1,7,0,10,6,4,7,APRIL
SULAWESI BARAT,MAMUJU,PAPALANG,SISANGO,85,77,70,63,26,23,11,33,4,6,29,34,17,5,12,0,54,29,25,15,6,2,4,2,45,39,6,5,APRIL
SULAWESI BARAT,MAMUJU,PAPALANG,BATU AMPA,62,33,9,4,1,0,0,9,0,0,2,4,0,0,0,0,14,7,7,2,13,10,3,5,27,23,4,18,APRIL
SULAWESI BARAT,MAMUJU,SAMPAGA,BUNDE,46,79,11,3,0,0,0,4,5,1,9,0,5,5,0,2,20,13,7,7,18,15,3,8,61,34,27,42,APRIL
SULAWESI BARAT,MAMUJU,SAMPAGA,KALONDING,94,66,58,39,39,23,19,5,9,17,2,38,17,17,0,8,12,12,0,6,4,1,3,1,44,9,35,36,APRIL
SULAWESI BARAT,MAMUJU,SAMPAGA,TARAILU,61,70,42,1,1,1,1,3,0,9,16,2,8,7,1,1,46,36,10,14,0,0,0,0,42,20,22,0,APRIL
SULAWESI BARAT,MAMUJU,SAMPAGA,SAMPAGA,48,25,11,8,3,1,1,10,0,0,4,5,9,4,5,2,20,14,6,12,15,8,7,7,20,8,12,17,APRIL
SULAWESI BARAT,MAMUJU,SAMPAGA,TANAMBUAH,98,43,23,17,14,1,0,14,5,4,11,6,6,1,5,0,19,17,2,12,16,4,12,1,4,4,0,4,APRIL
SULAWESI BARAT,MAMUJU,SAMPAGA,SALUBARANA,57,45,10,7,0,0,0,4,1,3,0,3,4,0,4,0,28,16,12,1,20,16,4,7,15,4,11,6,APRIL
SULAWESI BARAT,MAMUJU,SAMPAGA,LOSSO,35,40,6,4,4,0,0,1,5,0,3,3,0,0,0,0,31,9,22,3,9,4,5,4,23,19,4,18,APRIL
SULAWESI BARAT,MAMUJU,TOMMO,TOMMO,49,44,2,0,0,0,0,2,0,0,0,1,8,5,3,3,21,16,5,5,9,3,6,2,16,9,7,9,APRIL
SULAWESI BARAT,MAMUJU,TOMMO,CAMPALOGA,41,62,16,6,1,0,0,15,1,0,13,0,7,6,1,5,15,10,5,2,4,2,2,0,24,8,16,7,APRIL
SULAWESI BARAT,MAMUJU,TOMMO,BUANA SAKTI,60,65,11,4,1,0,0,3,2,6,6,1,10,0,10,0,31,7,24,1,15,1,14,0,4,3,1,1,APRIL
SULAWESI BARAT,MAMUJU,TOMMO,TAMEMONGGA,35,75,61,29,3,2,0,60,1,0,14,8,1,0,1,0,53,7,46,7,3,3,0,3,29,1,28,13,APRIL
SULAWESI BARAT,MAMUJU,TOMMO,TAMEJARRA,96,68,44,28,12,7,0,23,6,2,24,6,15,13,2,3,68,7,61,5,30,24,6,4,34,8,26,8,APRIL
SULAWESI BARAT,MAMUJU,TOMMO,RANTEMARIO,69,74,36,5,3,1,1,20,4,0,10,20,3,2,1,1,18,7,11,2,13,9,4,9,23,13,10,22,APRIL
SULAWESI BARAT,MAMUJU,TOMMO,MALINO,65,54,7,4,0,0,0,3,1,3,2,2,12,4,8,0,37,8,29,3,32,14,18,3,30,25,5,26,APRIL
SULAWESI BARAT,MAMUJU,TOMMO,KAKULLASANG,41,61,29,6,4,1,0,5,18,2,23,0,8,7,1,0,56,22,34,21,17,11,6,9,16,9,7,15,APRIL
SULAWESI BARAT,MAMUJU,TOMMO,LELING,34,43,9,0,0,0,0,8,1,0,7,2,2,1,1,1,22,6,16,6,19,17,2,9,2,2,0,0,APRIL
SULAWESI BARAT,MAMUJU,TOMMO,KALEPU,70,31,20,17,15,7,1,14,1,1,8,11,11,11,0,4,30,20,10,2,21,11,10,5,31,19,12,15,APRIL
SULAWESI BARAT,MAMUJU,TOMMO,SANDANA,56,52,13,11,11,3,0,0,10,2,1,3,11,0,11,0,18,11,7,10,11,0,11,0,33,8,25,15,APRIL
SULAWESI BARAT,MAMUJU,TOMMO,LELING BARAT,33,24,21,15,4,1,1,6,4,10,14,1,3,2,1,2,21,5,16,1,16,14,2,2,3,2,1,3,APRIL
SULAWESI BARAT,MAMUJU,TOMMO,LELING UTARA,92,29,1,1,0,0,0,0,1,0,1,0,7,7,0,7,17,17,0,6,17,12,5,2,29,20,9,24,APRIL
SULAWESI BARAT,MAMUJU,TOMMO,SALUDENGEN,65,42,39,7,0,0,0,5,6,23,25,8,13,11,2,9,39,10,29,1,12,2,10,1,18,7,11,9,APRIL
SULAWESI BARAT,MAMUJU,SIMBORO DAN KEPULAUAN,SIMBORO,77,75,25,13,11,1,0,7,18,0,24,0,13,5,8,0,58,54,4,11,44,8,36,6,57,10,47,51,APRIL
SULAWESI BARAT,MAMUJU,SIMBORO DAN KEPULAUAN,RANGAS,46,13,0,0,0,0,0,0,0,0,0,0,1,0,1,0,13,12,1,12,6,4,2,4,15,8,7,12,APRIL
SULAWESI BARAT,MAMUJU,SIMBORO DAN KEPULAUAN,BOTTENG,31,62,51,28,6,6,6,30,3,10,20,15,0,0,0,0,45,37,8,11,10,2,8,0,26,12,14,17,APRIL
SULAWESI BARAT,MAMUJU,SIMBORO DAN KEPULAUAN,SALETTO,75,66,38,32,9,0,0,27,6,5,5,19,0,0,0,0,49,31,18,25,29,19,10,12,10,2,8,6,APRIL
SULAWESI BARAT,MAMUJU,SIMBORO DAN KEPULAUAN,SUMARE,52,71,3,3,0,0,0,3,0,0,3,0,9,3,6,2,28,8,20,3,19,18,1,18,12,2,10,9,APRIL
SULAWESI BARAT,MAMUJU,SIMBORO DAN KEPULAUAN,BOTTENG UTARA,39,51,9,2,2,0,0,7,0,0,5,0,5,3,2,2,49,37,12,25,29,1,28,0,33,20,13,3,APRIL
SULAWESI BARAT,MAMUJU,SIMBORO DAN KEPULAUAN,TAPANDULLU,32,77,10,0,0,0,0,8,1,1,2,7,3,1,2,1,43,38,5,34,17,17,0,7,55,27,28,38,APRIL
SULAWESI BARAT,MAMUJU,SIMBORO DAN KEPULAUAN,PATI'DI,89,36,3,0,0,0,0,1,2,0,1,1,17,5,12,1,24,21,3,6,20,9,11,5,29,19,10,13,APRIL
SULAWESI BARAT,MAMUJU,TAPALANG BARAT,DUNGKAIT,81,74,55,23,22,1,1,39,15,0,45,1,16,14,2,5,11,5,6,5,8,2,6,0,5,5,0,2,APRIL
SULAWESI BARAT,MAMUJU,TAPALANG BARAT,LEBANI,58,27,25,17,13,11,2,4,17,0,16,9,2,0,2,0,21,20,1,12,19,8,11,7,5,2,3,3,APRIL
SULAWESI BARAT,MAMUJU,TAPALANG BARAT,LABUANG RANO,51,30,21,3,2,0,0,2,11,6,3,3,6,5,1,2,17,16,1,10,17,7,10,2,34,13,21,4,APRIL
SULAWESI BARAT,MAMUJU,TAPALANG BARAT,PASABU,64,50,5,0,0,0,0,5,0,0,3,2,12,7,5,6,45,39,6,35,3,3,0,0,13,0,13,3,APRIL
SULAWESI BARAT,MAMUJU,TAPALANG BARAT,TANETE PAO,86,50,44,12,8,5,4,36,0,0,14,11,13,4,9,0,44,9,35,4,44,28,16,20,42,20,22,5,APRIL
SULAWESI BARAT,MAMUJU,TAPALANG BARAT,PANGASAAN,91,27,21,16,10,1,0,20,0,1,20,1,1,0,1,0,15,11,4,8,3,2,1,1,3,3,0,1,APRIL
SULAWESI BARAT,MAMUJU,TAPALANG BARAT,AHU,76,71,67,27,26,13,11,33,1,21,10,0,9,1,8,1,30,12,18,1,25,13,12,11,69,40,29,57,APRIL
SULAWESI BARAT,MAMUJU,BONEHAU,BONEHAU,45,47,2,2,2,2,1,0,1,0,2,0,6,6,0,6,14,7,7,0,13,4,9,1,39,4,35,29,APRIL
SULAWESI BARAT,MAMUJU,BONEHAU,SALUTIWO,100,14,10,2,0,0,0,8,1,1,3,1,10,8,2,8,12,8,4,6,1,1,0,1,6,1,5,2,APRIL
SULAWESI BARAT,MAMUJU,BONEHAU,BUTTUADA,52,27,24,15,3,2,0,23,0,0,3,0,9,0,9,0,21,7,14,2,0,0,0,0,13,4,9,13,APRIL
SULAWESI BARAT,MAMUJU,BONEHAU,TAMALEA,58,22,12,11,1,0,0,11,1,0,10,1,5,2,3,0,21,11,10,7,3,1,2,1,8,0,8,3,APRIL
SULAWESI BARAT,MAMUJU,BONEHAU,LUMIKA,97,42,27,16,7,6,5,20,1,1,19,1,6,4,2,2,38,15,23,7,0,0,0,0,29,10,19,8,APRIL
SULAWESI BARAT,MAMUJU,BONEHAU,MAPPU,77,80,0,0,0,0,0,0,0,0,0,0,11,11,0,8,22,17,5,12,19,2,17,2,27,21,6,18,APRIL
SULAWESI BARAT,MAMUJU,BONEHAU,BANUADA,98,43,3,3,2,2,0,0,1,0,2,1,6,0,6,0,36,21,15,21,24,3,21,3,52,48,4,25,APRIL
SULAWESI BARAT,MAMUJU,BONEHAU,HINUA,74,31,15,10,0,0,0,3,12,0,3,3,12,5,7,4,14,10,4,5,6,0,6,0,27,22,5,26,APRIL
SULAWESI BARAT,MAMUJU,BONEHAU,KINATANG,34,10,8,1,0,0,0,6,1,0,1,5,4,0,4,0,10,6,4,2,0,0,0,0,4,4,0,1,APRIL
SULAWESI BARAT,MAMUJU,KEP. BALA BALAKANG,BALA BALAKANG,42,16,2,1,1,1,0,2,0,0,0,2,1,1,0,0,10,9,1,5,4,2,2,0,9,2,7,8,APRIL
SULAWESI BARAT,MAMUJU,KEP. BALA BALAKANG,BALA-BALAKANG TIMUR,65,74,20,11,10,9,5,1,7,4,7,11,13,9,4,8,25,22,3,10,9,9,0,7,25,10,15,23,APRIL
SULAWESI BARAT,MAMUJU TENGAH,TOBADAK,MAHAHE,95,14,1,0,0,0,0,1,0,0,1,0,15,6,9,4,10,9,1,1,2,1,1,1,9,2,7,9,MEI
SULAWESI BARAT,MAMUJU TENGAH,TOBADAK,SALOBAJA,40,12,7,6,0,0,0,1,6,0,0,0,5,5,0,3,12,6,6,1,3,2,1,2,4,1,3,3,MEI
SULAWESI BARAT,MAMUJU TENGAH,TOBADAK,TOBADAK,96,18,4,2,0,0,0,0,3,1,4,0,5,1,4,1,16,5,11,5,13,5,8,2,7,7,0,0,MEI
SULAWESI BARAT,MAMUJU TENGAH,TOBADAK,PALONGAAN,97,38,23,7,2,2,1,7,15,0,10,3,10,8,2,4,34,24,10,4,24,14,10,2,45,45,0,9,MEI
SULAWESI BARAT,MAMUJU TENGAH,TOBADAK,BATU PARIGI,57,61,22,2,2,0,0,16,1,5,0,21,7,4,3,4,10,5,5,1,2,2,0,0,26,6,20,11,MEI
SULAWESI BARAT,MAMUJU TENGAH,TOBADAK,BAMBADARU,69,60,1,1,1,1,1,0,0,0,0,1,4,2,2,2,60,5,55,4,21,9,12,3,54,39,15,30,MEI
SULAWESI BARAT,MAMUJU TENGAH,TOBADAK,SEJATI,67,42,27,26,14,1,0,7,17,1,21,2,10,7,3,5,41,7,34,7,26,10,16,10,5,5,0,0,MEI
SULAWESI BARAT,MAMUJU TENGAH,TOBADAK,SALOADAK,78,20,6,3,0,0,0,4,0,0,5,1,0,0,0,0,19,10,9,9,6,0,6,0,13,3,10,8,MEI
SULAWESI BARAT,MAMUJU TENGAH,PANGALE,POLO PANGALE,51,49,48,39,5,0,0,47,1,0,38,4,5,2,3,2,46,16,30,1,26,13,13,8,14,7,7,3,MEI
SULAWESI BARAT,MAMUJU TENGAH,PANGALE,PANGALE,66,26,8,1,0,0,0,1,7,0,3,0,12,9,3,6,19,9,10,2,5,3,2,0,13,12,1,12,MEI
SULAWESI BARAT,MAMUJU TENGAH,PANGALE,SARTANAMAJU,91,39,38,1,1,1,0,2,16,0,4,18,10,8,2,6,14,8,6,2,1,1,0,1,12,1,11,8,MEI
SULAWESI BARAT,MAMUJU TENGAH,PANGALE,POLO LERENG,83,72,10,7,2,1,1,6,2,1,9,1,6,4,2,3,36,30,6,0,30,1,29,1,16,4,12,4,MEI
SULAWESI BARAT,MAMUJU TENGAH,PANGALE,KUO,67,68,36,3,3,3,0,10,7,2,14,14,13,6,7,1,17,9,8,1,2,0,2,0,27,19,8,27,MEI
SULAWESI BARAT,MAMUJU TENGAH,PANGALE,POLO CAMBA,71,25,15,9,6,4,2,5,7,1,6,0,2,2,0,1,18,16,2,0,11,1,10,0,19,7,12,18,MEI
SULAWESI BARAT,MAMUJU TENGAH,PANGALE,LAMBA-LAMBA,86,28,20,1,0,0,0,10,5,4,11,1,3,2,1,1,16,13,3,12,13,13,0,2,10,0,10,3,MEI
SULAWESI BARAT,MAMUJU TENGAH,PANGALE,KOMBILING,73,72,27,9,5,3,3,12,11,1,26,0,0,0,0,0,27,19,8,2,24,17,7,17,37,20,17,37,MEI
SULAWESI BARAT,MAMUJU TENGAH,PANGALE,LEMO-LEMO,93,80,47,33,33,25,10,20,11,6,33,0,7,6,1,0,49,23,26,23,16,11,5,7,18,0,18,8,MEI
SULAWESI BARAT,MAMUJU TENGAH,BUDONG-BUDONG,BABANA,38,39,10,4,0,0,0,6,2,2,2,3,3,3,0,1,26,22,4,4,23,16,7,7,6,2,4,4,MEI
SULAWESI BARAT,MAMUJU TENGAH,BUDONG-BUDONG,LUMU,31,28,24,17,14,4,0,20,3,1,10,0,0,0,0,0,25,11,14,6,20,4,16,4,39,38,1,6,MEI
SULAWESI BARAT,MAMUJU TENGAH,BUDONG-BUDONG,PONTANAKAYANG,31,18,8,8,4,3,2,0,1,5,0,8,4,4,0,4,17,7,10,7,11,11,0,11,13,12,1,12,MEI
SULAWESI BARAT,MAMUJU TENGAH,BUDONG-BUDONG,SALOGATTA,32,66,49,42,37,30,8,11,18,4,27,2,0,0,0,0,13,5,8,4,10,4,6,1,9,3,6,3,MEI
SULAWESI BARAT,MAMUJU TENGAH,BUDONG-BUDONG,KIRE,75,62,14,11,5,4,3,8,0,1,10,1,1,0,1,0,56,49,7,16,38,23,15,8,6,1,5,0,MEI
SULAWESI BARAT,MAMUJU TENGAH,BUDONG-BUDONG,TINALI,67,51,12,7,2,0,0,3,0,9,1,10,4,2,2,1,42,17,25,0,34,11,23,8,31,29,2,28,MEI
SULAWESI BARAT,MAMUJU TENGAH,BUDONG-BUDONG,SALUMANURUNG,38,42,28,22,3,2,2,1,22,3,17,11,1,1,0,0,23,10,13,6,11,1,10,0,40,33,7,34,MEI
SULAWESI BARAT,MAMUJU TENGAH,BUDONG-BUDONG,PASAPA,74,59,50,0,0,0,0,49,1,0,3,22,10,4,6,4,34,8,26,4,27,14,13,10,4,1,3,3,MEI
SULAWESI BARAT,MAMUJU TENGAH,BUDONG-BUDONG,BOJO,90,75,70,65,30,28,4,33,26,7,56,6,8,5,3,4,61,29,32,10,5,3,2,1,15,15,0,6,MEI
SULAWESI BARAT,MAMUJU TENGAH,BUDONG-BUDONG,BARAKKANG,79,67,19,8,0,0,0,7,12,0,4,13,13,11,2,9,46,13,33,5,34,5,29,2,4,1,3,0,MEI
SULAWESI BARAT,MAMUJU TENGAH,BUDONG-BUDONG,LEMBAH HADA,90,11,3,1,1,0,0,2,0,1,0,2,9,9,0,8,11,11,0,9,6,0,6,0,7,3,4,2,MEI
SULAWESI BARAT,MAMUJU TENGAH,TOPOYO,BUDONG-BUDONG,31,16,6,6,1,1,1,1,0,2,1,4,5,2,3,1,14,8,6,1,1,0,1,0,7,6,1,4,MEI
SULAWESI BARAT,MAMUJU TENGAH,TOPOYO,TOPOYO,53,72,17,9,7,4,1,0,4,8,12,1,10,0,10,0,70,57,13,11,39,17,22,16,9,8,1,9,MEI
SULAWESI BARAT,MAMUJU TENGAH,TOPOYO,TUMBU,63,52,38,15,9,5,3,29,1,3,16,0,4,4,0,4,14,12,2,3,10,3,7,1,44,26,18,3,MEI
SULAWESI BARAT,MAMUJU TENGAH,TOPOYO,KABUBU,84,76,32,3,0,0,0,22,3,3,9,8,14,3,11,1,31,24,7,2,15,10,5,7,45,38,7,2,MEI
SULAWESI BARAT,MAMUJU TENGAH,TOPOYO,WAEPUTEH,83,42,7,6,3,3,3,2,0,0,6,1,7,0,7,0,33,18,15,5,13,3,10,3,30,17,13,6,MEI
SULAWESI BARAT,MAMUJU TENGAH,TOPOYO,TANGKOU,83,71,55,16,1,1,1,38,14,0,36,10,2,2,0,0,56,26,30,18,43,25,18,0,60,12,48,18,MEI
SULAWESI BARAT,MAMUJU TENGAH,TOPOYO,TABOLANG,39,24,11,8,6,0,0,9,1,0,11,0,7,7,0,0,20,8,12,0,13,6,7,5,27,7,20,15,MEI
SULAWESI BARAT,MAMUJU TENGAH,TOPOYO,PARAILI,93,18,3,1,1,0,0,3,0,0,0,3,1,1,0,0,14,7,7,0,8,7,1,6,4,1,3,3,MEI
SULAWESI BARAT,MAMUJU TENGAH,TOPOYO,SALUPANGKANG,33,40,7,5,5,2,2,0,2,1,0,0,2,1,1,0,11,7,4,3,0,0,0,0,17,7,10,12,MEI
SULAWESI BARAT,MAMUJU TENGAH,TOPOYO,SALUPANGKANG IV,65,21,8,7,1,1,0,2,0,6,4,1,11,2,9,1,12,12,0,1,6,0,6,0,19,18,1,11,MEI
SULAWESI BARAT,MAMUJU TENGAH,TOPOYO,TAPPILINA,89,44,43,2,1,1,1,3,16,0,19,15,14,12,2,1,22,8,14,6,4,4,0,2,20,0,20,14,MEI
SULAWESI BARAT,MAMUJU TENGAH,TOPOYO,BAMBAMANURUNG,62,79,47,30,25,8,1,41,2,1,4,32,5,5,0,3,24,15,9,13,13,5,8,4,49,49,0,14,MEI
SULAWESI BARAT,MAMUJU TENGAH,TOPOYO,SALULEKBO,58,21,17,15,1,0,0,9,5,3,5,1,11,6,5,0,19,15,4,7,8,6,2,4,6,3,3,0,MEI
SULAWESI BARAT,MAMUJU TENGAH,TOPOYO,PANGALLOANG,68,39,1,0,0,0,0,1,0,0,1,0,2,2,0,2,26,17,9,6,23,19,4,18,5,0,5,3,MEI
SULAWESI BARAT,MAMUJU TENGAH,TOPOYO,SINABATTA,62,76,2,1,0,0,0,2,0,0,1,1,9,8,1,0,31,21,10,5,26,1,25,0,32,17,15,14,MEI
SULAWESI BARAT,MAMUJU TENGAH,KAROSSA,KAROSSA,45,36,36,0,0,0,0,30,4,0,19,8,2,2,0,2,15,10,5,5,8,7,1,0,29,4,25,13,MEI
SULAWESI BARAT,MAMUJU TENGAH,KAROSSA,TASOKKO,80,17,7,2,2,1,0,3,2,1,2,1,16,8,8,7,11,10,1,5,8,5,3,5,15,15,0,4,MEI
SULAWESI BARAT,MAMUJU TENGAH,KAROSSA,LARA,74,16,6,6,1,0,0,6,0,0,4,2,5,1,4,0,16,14,2,3,12,7,5,6,5,3,2,2,MEI
SULAWESI BARAT,MAMUJU TENGAH,KAROSSA,KADAILA,77,18,6,3,3,3,2,1,1,1,6,0,4,1,3,0,11,7,4,5,1,0,1,0,2,0,2,1,MEI
SULAWESI BARAT,MAMUJU TENGAH,KAROSSA,KAYU CALLA,64,75,50,22,22,22,8,41,0,1,7,39,5,1,4,0,25,6,19,5,6,5,1,0,8,4,4,2,MEI
SULAWESI BARAT,MAMUJU TENGAH,KAROSSA,LEMBAH HOPO,64,28,12,0,0,0,0,11,1,0,12,0,11,6,5,3,20,17,3,3,11,0,11,0,28,15,13,12,MEI
SULAWESI BARAT,MAMUJU TENGAH,KAROSSA,BENGGAULU,33,45,33,23,13,7,4,25,1,1,28,4,6,3,3,1,39,37,2,23,15,7,8,1,46,41,5,2,MEI
SULAWESI BARAT,MAMUJU TENGAH,KAROSSA,SUKA MAJU,70,21,9,7,4,3,0,4,3,0,8,1,4,0,4,0,15,5,10,2,6,4,2,0,7,2,5,0,MEI
SULAWESI BARAT,MAMUJU TENGAH,KAROSSA,KAMBUNONG,75,50,26,23,5,5,2,8,11,3,2,22,3,3,0,3,48,17,31,1,18,12,6,4,22,0,22,2,MEI
SULAWESI BARAT,MAMUJU TENGAH,KAROSSA,SALUBIRO,99,43,35,34,11,3,0,21,14,0,20,0,10,4,6,3,19,14,5,7,13,1,12,0,35,7,28,32,MEI
SULAWESI BARAT,MAMUJU TENGAH,KAROSSA,SANJANGO,49,14,8,6,5,0,0,6,1,1,2,5,9,7,2,3,10,9,1,7,9,4,5,4,7,5,2,5,MEI
SULAWESI BARAT,PASANGKAYU,BAMBAIRA,TAMPAURE,98,38,11,11,4,2,2,6,1,2,2,3,3,0,3,0,19,6,13,3,9,1,8,1,31,20,11,8,MEI
SULAWESI BARAT,PASANGKAYU,BAMBAIRA,BAMBAIRA,97,20,15,10,10,5,0,10,4,1,5,6,18,15,3,12,16,16,0,16,16,6,10,2,19,7,12,8,MEI
SULAWESI BARAT,PASANGKAYU,BAMBAIRA,KASOLOANG,57,48,33,3,2,2,0,21,6,3,17,9,8,7,1,3,10,6,4,1,6,3,3,3,37,29,8,25,MEI
SULAWESI BARAT,PASANGKAYU,BAMBAIRA,KALUKU NANGKA,71,73,43,43,9,0,0,24,14,2,22,4,7,5,2,1,62,54,8,36,1,1,0,1,48,36,12,16,MEI
SULAWESI BARAT,PASANGKAYU,BAMBALAMOTU,RANDOMAYANG,100,36,1,0,0,0,0,1,0,0,0,0,16,15,1,5,35,10,25,4,33,14,19,5,35,9,26,24,MEI
SULAWESI BARAT,PASANGKAYU,BAMBALAMOTU,BAMBALAMOTU,33,78,5,5,0,0,0,4,0,1,0,3,3,2,1,2,72,53,19,1,51,0,51,0,31,2,29,17,MEI
SULAWESI BARAT,PASANGKAYU,BAMBALAMOTU,POLEWALI,92,63,59,35,24,24,0,6,10,17,8,39,13,2,11,1,38,20,18,9,2,0,2,0,44,20,24,12,MEI
SULAWESI BARAT,PASANGKAYU,BAMBALAMOTU,PANGIANG,85,40,3,1,0,0,0,1,0,2,0,1,17,13,4,3,36,9,27,5,18,14,4,7,8,6,2,8,MEI
SULAWESI BARAT,PASANGKAYU,BAMBALAMOTU,KALOLA,100,71,5,3,2,0,0,0,3,0,5,0,3,0,3,0,34,25,9,5,23,4,19,0,47,22,25,27,MEI
SULAWESI BARAT,PASANGKAYU,BAMBALAMOTU,WULAI,55,44,20,17,6,0,0,0,18,1,1,4,10,3,7,0,13,11,2,6,8,8,0,8,19,2,17,9,MEI
SULAWESI BARAT,PASANGKAYU,BARAS,BARAS,67,57,22,5,0,0,0,3,9,8,19,0,12,12,0,9,53,5,48,3,23,7,16,4,7,5,2,5,MEI
SULAWESI BARAT,PASANGKAYU,BARAS,BULU PARIGI,72,47,2,1,1,0,0,1,1,0,2,0,10,6,4,6,30,23,7,13,11,3,8,2,25,1,24,24,MEI
SULAWESI BARAT,PASANGKAYU,BARAS,BALANTI,66,77,0,0,0,0,0,0,0,0,0,0,6,2,4,1,38,9,29,9,5,4,1,1,32,27,5,17,MEI
SULAWESI BARAT,PASANGKAYU,BARAS,MOTU,35,12,12,9,3,3,3,5,2,0,9,3,7,4,3,2,12,11,1,7,0,0,0,0,0,0,0,0,MEI
SULAWESI BARAT,PASANGKAYU,BARAS,TOWONI,80,55,35,30,14,1,0,35,0,0,6,1,11,11,0,10,36,9,27,0,9,2,7,2,14,10,4,11,MEI
SULAWESI BARAT,PASANGKAYU,BARAS,KASANO,59,36,16,9,0,0,0,7,1,4,12,0,6,2,4,2,33,27,6,27,29,3,26,2,51,14,37,46,MEI
SULAWESI BARAT,PASANGKAYU,BULU TABA,SUMBER SARI,75,18,9,8,8,8,2,6,0,1,7,0,8,5,3,0,12,8,4,0,12,7,5,4,15,1,14,14,MEI
SULAWESI BARAT,PASANGKAYU,BULU TABA,LELEJAE,98,48,7,1,1,1,0,6,0,0,1,2,5,2,3,0,22,9,13,4,20,9,11,9,25,12,13,7,MEI
SULAWESI BARAT,PASANGKAYU,BULU TABA,BUKIT HARAPAN,67,52,12,4,1,1,0,4,7,0,9,3,10,7,3,7,30,7,23,5,22,14,8,1,27,0,27,13,MEI
SULAWESI BARAT,PASANGKAYU,BULU TABA,LILIMORI,35,42,18,5,1,1,1,10,0,0,12,1,7,7,0,0,24,20,4,9,4,4,0,1,29,23,6,13,MEI
SULAWESI BARAT,PASANGKAYU,BULU TABA,KARAVE,48,30,12,11,8,2,0,11,0,0,2,7,8,7,1,3,26,20,6,10,12,4,8,3,15,9,6,4,MEI
SULAWESI BARAT,PASANGKAYU,BULU TABA,KASTABUANA,62,35,31,31,30,27,16,15,0,0,7,5,4,2,2,0,11,11,0,3,10,5,5,4,18,18,0,11,MEI
SULAWESI BARAT,PASANGKAYU,BULU TABA,OMPI,64,14,1,1,1,1,1,0,0,0,1,0,4,1,3,0,13,11,2,2,7,4,3,3,1,0,1,0,MEI
SULAWESI BARAT,PASANGKAYU,DAPURANG,DAPURANG,39,33,7,2,0,0,0,3,0,3,6,1,6,2,4,2,12,7,5,2,0,0,0,0,15,10,5,7,MEI
SULAWESI BARAT,PASANGKAYU,DAPURANG,BENGGAULU,66,16,11,0,0,0,0,9,0,0,3,7,3,1,2,0,16,9,7,1,16,9,7,9,18,0,18,5,MEI
SULAWESI BARAT,PASANGKAYU,DAPURANG,TIRTABUANA,98,22,17,9,6,2,0,5,1,4,17,0,17,8,9,4,13,12,1,10,8,6,2,0,13,11,2,13,MEI
SULAWESI BARAT,PASANGKAYU,DAPURANG,BULU BONGGU,69,15,14,4,2,0,0,8,2,4,2,12,7,0,7,0,15,14,1,2,4,0,4,0,1,0,1,1,MEI
SULAWESI BARAT,PASANGKAYU,DAPURANG,SARASA,76,70,17,3,1,0,0,3,11,0,15,0,12,10,2,4,26,12,14,11,16,15,1,12,23,12,11,10,MEI
SULAWESI BARAT,PASANGKAYU,DURIPOKU,TAMMARUNANG,57,69,63,63,2,2,0,63,0,0,56,6,10,4,6,4,64,56,8,6,15,0,15,0,28,18,10,24,MEI
SULAWESI BARAT,PASANGKAYU,DURIPOKU,SAPTANAJAYA,66,75,18,1,0,0,0,0,12,3,5,2,0,0,0,0,33,17,16,12,14,8,6,3,24,4,20,9,MEI
SULAWESI BARAT,PASANGKAYU,DURIPOKU,TARANGGI,66,31,17,11,3,0,0,1,0,7,0,9,10,3,7,1,14,5,9,5,6,0,6,0,24,22,2,19,MEI
SULAWESI BARAT,PASANGKAYU,DURIPOKU,SIPAKAINGA,41,46,8,8,5,4,1,1,5,1,4,2,1,0,1,0,27,17,10,11,24,13,11,7,55,14,41,53,MEI
SULAWESI BARAT,PASANGKAYU,LARIANG,KULU,52,18,9,7,5,5,1,1,5,1,5,4,6,2,4,0,12,7,5,3,4,0,4,0,6,0,6,4,MEI
SULAWESI BARAT,PASANGKAYU,LARIANG,PARABU,75,60,60,8,2,0,0,47,11,1,21,35,13,8,5,3,22,8,14,8,19,0,19,0,57,7,50,29,MEI
SULAWESI BARAT,PASANGKAYU,LARIANG,KENANGAN,31,63,4,1,0,0,0,4,0,0,2,2,3,1,2,1,49,10,39,6,14,12,2,8,48,38,10,38,MEI
SULAWESI BARAT,PASANGKAYU,LARIANG,BAJAWALI,52,76,13,10,6,3,3,7,0,1,12,1,10,4,6,2,11,9,2,6,1,1,0,0,11,5,6,8,MEI
SULAWESI BARAT,PASANGKAYU,LARIANG,SINGGANI,80,77,33,33,27,18,1,21,2,9,7,5,1,1,0,1,60,37,23,35,24,14,10,2,42,14,28,24,MEI
SULAWESI BARAT,PASANGKAYU,LARIANG,BATU MATORU,95,55,15,3,0,0,0,2,10,3,15,0,7,7,0,6,33,17,16,7,1,1,0,1,9,9,0,7,MEI
SULAWESI BARAT,PASANGKAYU,LARIANG,BAMBAKORO,47,27,27,17,16,12,1,19,3,2,21,5,5,5,0,0,25,12,13,9,24,10,14,7,10,10,0,10,MEI
SULAWESI BARAT,PASANGKAYU,PASANGKAYU,KARYA BERSAMA,57,29,11,6,2,1,1,1,6,2,11,0,10,0,10,0,10,8,2,3,4,2,2,2,10,4,6,0,MEI
SULAWESI BARAT,PASANGKAYU,PASANGKAYU,AKO,71,60,58,51,45,20,19,7,28,1,13,30,4,2,2,2,43,23,20,13,5,0,5,0,43,35,8,14,MEI
SULAWESI BARAT,PASANGKAYU,PASANGKAYU,PASANGKAYU,35,28,17,1,0,0,0,4,4,3,2,0,7,4,3,1,20,11,9,1,18,12,6,3,18,15,3,14,MEI
SULAWESI BARAT,PASANGKAYU,PASANGKAYU,MARTAJAYA,83,46,34,26,7,4,1,14,12,5,5,0,16,6,10,1,18,5,13,3,0,0,0,0,21,11,10,1,MEI
SULAWESI BARAT,PASANGKAYU,PASANGKAYU,PAKAVA,30,60,50,10,5,0,0,44,3,1,44,2,1,1,0,1,12,10,2,3,11,8,3,8,40,23,17,1,MEI
SULAWESI BARAT,PASANGKAYU,PASANGKAYU,GUNUNG SARI,87,40,7,5,5,3,2,3,2,0,5,0,8,2,6,1,22,12,10,0,3,1,2,1,21,10,11,20,MEI
SULAWESI BARAT,PASANGKAYU,PEDONGGA,MALEI,69,56,13,8,1,0,0,3,2,4,3,5,13,2,11,0,18,5,13,1,6,3,3,2,25,11,14,3,MEI
SULAWESI BARAT,PASANGKAYU,PEDONGGA,PEDANDA,81,39,28,22,3,2,2,21,1,1,1,11,15,4,11,0,19,13,6,11,13,3,10,0,26,16,10,23,MEI
SULAWESI BARAT,PASANGKAYU,PEDONGGA,BATU OGE,44,63,53,6,0,0,0,13,20,5,45,6,4,4,0,3,27,14,13,4,20,10,10,5,8,2,6,4,MEI
SULAWESI BARAT,PASANGKAYU,PEDONGGA,MARTASARI,96,10,4,0,0,0,0,0,0,4,1,2,7,5,2,0,10,8,2,7,0,0,0,0,3,2,1,1,MEI
SULAWESI BARAT,PASANGKAYU,SARJO,SARJO,40,53,28,10,1,1,0,15,10,0,21,1,2,1,1,1,48,11,37,8,6,6,0,0,4,1,3,0,MEI
SULAWESI BARAT,PASANGKAYU,SARJO,MAPONU,55,31,27,9,5,3,2,4,0,7,1,20,10,3,7,2,23,7,16,4,13,10,3,4,22,9,13,15,MEI
SULAWESI BARAT,PASANGKAYU,SARJO,LETAWA,92,10,8,4,4,3,3,2,0,1,6,0,16,8,8,4,10,7,3,1,8,6,2,5,5,1,4,1,MEI
SULAWESI BARAT,PASANGKAYU,SARJO,SARUDE,66,41,6,5,3,0,0,4,1,1,6,0,10,4,6,3,36,12,24,9,34,20,14,7,46,29,17,40,MEI
SULAWESI BARAT,PASANGKAYU,SARUDU,DODA,100,55,54,37,22,6,1,30,0,13,47,6,13,13,0,13,45,29,16,12,1,1,0,1,21,7,14,1,MEI
SULAWESI BARAT,PASANGKAYU,SARUDU,SARUDU,62,22,5,0,0,0,0,0,2,2,1,4,5,0,5,0,22,9,13,6,8,6,2,0,5,0,5,4,MEI
SULAWESI BARAT,PASANGKAYU,SARUDU,BULU MARIO,48,72,56,35,20,4,4,25,18,0,5,6,0,0,0,0,56,49,7,30,38,26,12,23,78,14,64,73,MEI
SULAWESI BARAT,PASANGKAYU,SARUDU,KUMASARI,47,53,48,4,3,3,1,45,0,1,23,14,0,0,0,0,40,33,7,8,16,6,10,6,4,2,2,3,MEI
SULAWESI BARAT,PASANGKAYU,SARUDU,PATIKA,75,33,18,7,6,1,0,0,15,1,15,3,8,5,3,3,18,17,1,5,13,0,13,0,5,3,2,3,MEI
SULAWESI BARAT,PASANGKAYU,TIKKE RAYA,MAKMUR JAYA,55,27,18,4,0,0,0,9,8,0,12,1,4,4,0,0,10,6,4,1,7,2,5,1,4,4,0,2,MEI
SULAWESI BARAT,PASANGKAYU,TIKKE RAYA,LARIANG,85,77,31,2,0,0,0,6,19,0,6,16,1,0,1,0,74,55,19,24,11,3,8,3,20,8,12,17,MEI
SULAWESI BARAT,PASANGKAYU,TIKKE RAYA,TIKKE,84,67,4,2,2,0,0,3,1,0,2,1,0,0,0,0,58,22,36,15,38,34,4,2,18,5,13,5,MEI
SULAWESI BARAT,PASANGKAYU,TIKKE RAYA,PAJALELE,50,43,43,8,8,6,1,11,21,6,5,19,3,0,3,0,34,20,14,12,1,1,0,0,17,13,4,15,MEI
SULAWESI BARAT,PASANGKAYU,TIKKE RAYA,JENGENG RAYA,51,21,12,9,4,1,1,3,1,2,9,1,10,5,5,0,16,6,10,5,12,11,1,8,2,1,1,0,MEI
SULAWESI BARAT,MAJENE,BANGGAE,BANGGAE,43,59,30,28,12,5,5,14,3,1,7,1,3,3,0,1,11,7,4,3,3,3,0,2,21,3,18,6,MEI
SULAWESI BARAT,MAJENE,BANGGAE,BARU,69,24,8,7,0,0,0,4,4,0,2,6,0,0,0,0,22,12,10,7,10,9,1,1,6,4,2,0,MEI
SULAWESI BARAT,MAJENE,BANGGAE,PANGALI ALI,31,13,6,3,1,0,0,3,3,0,6,0,6,0,6,0,11,6,5,1,3,0,3,0,10,0,10,7,MEI
SULAWESI BARAT,MAJENE,BANGGAE,TOTOLI,41,13,6,6,1,1,0,1,1,4,1,0,6,3,3,1,10,10,0,6,5,1,4,1,2,0,2,0,MEI
SULAWESI BARAT,MAJENE,BANGGAE,RANGAS,34,25,25,16,0,0,0,23,0,2,11,10,5,1,4,0,22,5,17,5,9,4,5,4,8,8,0,2,MEI
SULAWESI BARAT,MAJENE,BANGGAE,GALUNG,48,13,2,1,1,0,0,1,1,0,2,0,8,4,4,1,11,6,5,2,11,11,0,3,14,1,13,10,MEI
SULAWESI BARAT,MAJENE,BANGGAE,PALIPI SOREANG,75,61,16,12,3,1,0,10,5,1,7,0,1,1,0,0,45,33,12,13,1,1,0,0,33,15,18,4,MEI
SULAWESI BARAT,MAJENE,BANGGAE,PAMBOBORANG,99,69,59,55,38,37,20,18,11,10,25,34,13,5,8,0,22,19,3,11,14,10,4,5,54,43,11,19,MEI
SULAWESI BARAT,MAJENE,BANGGAE TIMUR,BAURUNG,58,48,39,8,2,1,1,5,8,24,6,27,9,5,4,2,16,13,3,6,7,6,1,6,21,8,13,14,MEI
SULAWESI BARAT,MAJENE,BANGGAE TIMUR,BARUGA,73,20,1,1,1,0,0,0,1,0,1,0,11,7,4,2,13,13,0,4,10,0,10,0,3,1,2,3,MEI
SULAWESI BARAT,MAJENE,BANGGAE TIMUR,BARUGA DHUA,33,26,9,4,2,1,0,0,8,1,6,0,5,5,0,2,21,21,0,16,4,1,3,1,21,10,11,10,MEI
SULAWESI BARAT,MAJENE,BANGGAE TIMUR,LABUANG,47,79,25,24,15,2,0,7,14,2,15,8,5,1,4,0,58,58,0,17,54,42,12,14,47,0,47,41,MEI
SULAWESI BARAT,MAJENE,BANGGAE TIMUR,TANDE,39,37,36,13,6,4,4,29,1,0,29,3,3,1,2,0,10,10,0,2,4,2,2,2,29,27,2,26,MEI
SULAWESI BARAT,MAJENE,BANGGAE TIMUR,LEMBANG,60,59,23,15,5,3,3,1,14,2,11,8,10,7,3,4,22,14,8,2,2,1,1,0,15,12,3,8,MEI
SULAWESI BARAT,MAJENE,BANGGAE TIMUR,LABUANG UTARA,62,10,3,2,0,0,0,1,2,0,1,2,8,5,3,1,10,8,2,6,9,1,8,1,11,1,10,8,MEI
SULAWESI BARAT,MAJENE,BANGGAE TIMUR,TANDE TIMUR,97,69,17,17,6,6,0,3,3,2,14,3,0,0,0,0,12,8,4,0,7,3,4,1,50,15,35,39,MEI
SULAWESI BARAT,MAJENE,BANGGAE TIMUR,BUTTU BARUGA,62,55,50,41,10,7,5,13,24,0,9,7,8,0,8,0,48,6,42,5,3,0,3,0,10,2,8,10,MEI
SULAWESI BARAT,MAJENE,MALUNDA,MALUNDA,45,78,33,8,8,0,0,8,4,19,22,11,4,0,4,0,62,55,7,18,44,27,17,3,98,15,83,97,MEI
SULAWESI BARAT,MAJENE,MALUNDA,LAMUNGANG BATU,38,59,47,19,16,11,6,21,12,1,5,12,5,5,0,4,28,9,19,5,18,9,9,1,21,1,20,6,MEI
SULAWESI BARAT,MAJENE,MALUNDA,BAMBANGAN,96,61,46,26,22,18,18,27,1,0,29,4,2,1,1,1,29,28,1,9,25,13,12,2,19,11,8,11,MEI
SULAWESI BARAT,MAJENE,MALUNDA,LOMBANG,41,37,32,10,0,0,0,27,2,3,19,5,4,3,1,1,16,15,1,0,9,3,6,3,28,21,7,19,MEI
SULAWESI BARAT,MAJENE,MALUNDA,LOMBONG,69,59,4,3,0,0,0,3,1,0,1,0,3,1,2,0,22,16,6,0,14,7,7,2,37,18,19,11,MEI
SULAWESI BARAT,MAJENE,MALUNDA,MEKKATTA,87,75,22,7,2,2,2,7,7,4,17,2,8,0,8,0,55,15,40,6,45,23,22,2,56,56,0,17,MEI
SULAWESI BARAT,MAJENE,MALUNDA,MALIAYA,35,29,0,0,0,0,0,0,0,0,0,0,4,1,3,1,29,20,9,7,5,1,4,0,15,3,12,7,MEI
SULAWESI BARAT,MAJENE,MALUNDA,LOMBANG TIMUR,74,14,8,0,0,0,0,1,5,1,8,0,13,5,8,3,11,9,2,5,1,1,0,1,7,7,0,7,MEI
SULAWESI BARAT,MAJENE,MALUNDA,SALUTAHONGAN,93,40,38,37,13,3,2,6,29,1,18,19,10,5,5,0,20,8,12,6,4,1,3,1,16,9,7,14,MEI
SULAWESI BARAT,MAJENE,MALUNDA,LOMBONG TIMUR,56,66,44,14,2,2,2,22,20,0,13,26,1,1,0,1,10,9,1,7,10,9,1,8,56,31,25,29,MEI
SULAWESI BARAT,MAJENE,MALUNDA,MEKKATTA SELATAN,78,23,0,0,0,0,0,0,0,0,0,0,8,2,6,0,21,15,6,5,10,10,0,2,12,1,11,12,MEI
SULAWESI BARAT,MAJENE,MALUNDA,KAYUANGIN,90,71,60,9,1,0,0,41,3,16,38,20,4,4,0,1,32,27,5,2,6,4,2,1,3,2,1,0,MEI
SULAWESI BARAT,MAJENE,PAMBOANG,LALAMPANUA,42,77,62,34,23,1,0,33,21,6,35,11,7,4,3,1,12,9,3,8,11,10,1,1,13,12,1,4,MEI
SULAWESI BARAT,MAJENE,PAMBOANG,SIRINDU,37,38,8,8,2,2,0,0,7,1,5,1,5,4,1,4,28,19,9,14,23,13,10,6,16,13,3,12,MEI
SULAWESI BARAT,MAJENE,PAMBOANG,ADOLANG,42,40,22,16,14,1,0,0,5,4,1,13,3,1,2,0,34,11,23,3,20,13,7,4,14,1,13,6,MEI
SULAWESI BARAT,MAJENE,PAMBOANG,BABABULO,70,18,6,2,2,0,0,1,0,4,4,1,9,4,5,0,13,5,8,3,2,1,1,1,12,12,0,12,MEI
SULAWESI BARAT,MAJENE,PAMBOANG,BONDE,73,49,9,6,5,4,4,3,1,0,7,0,10,10,0,10,41,16,25,9,10,0,10,0,21,12,9,20,MEI
SULAWESI BARAT,MAJENE,PAMBOANG,BETTENG,72,18,13,4,1,1,0,13,0,0,7,4,14,10,4,1,18,12,6,11,17,15,2,12,22,9,13,12,MEI
SULAWESI BARAT,MAJENE,PAMBOANG,SIMBANG,74,64,38,29,15,0,0,11,14,13,37,1,8,3,5,0,54,39,15,3,39,23,16,17,13,1,12,9,MEI
SULAWESI BARAT,MAJENE,PAMBOANG,BONDE UTARA,45,70,56,47,40,29,13,30,1,0,2,26,7,0,7,0,22,12,10,7,22,11,11,9,37,21,16,27,MEI
SULAWESI BARAT,MAJENE,PAMBOANG,BABABULO UTARA,33,21,6,3,0,0,0,3,2,0,1,4,3,0,3,0,11,5,6,5,3,3,0,3,11,5,6,8,MEI
SULAWESI BARAT,MAJENE,PAMBOANG,BUTTU PAMBOANG,84,50,46,18,17,14,6,5,8,10,5,28,8,8,0,3,40,9,31,3,13,2,11,1,6,4,2,4,MEI
SULAWESI BARAT,MAJENE,PAMBOANG,BANUA ADOLANG,54,36,25,1,1,1,1,22,2,0,14,1,2,1,1,1,28,9,19,9,11,6,5,4,28,4,24,7,MEI
SULAWESI BARAT,MAJENE,PAMBOANG,ADOLANG DHUA,51,61,3,1,0,0,0,0,3,0,3,0,3,0,3,0,50,38,12,11,19,14,5,10,13,2,11,10,MEI
SULAWESI BARAT,MAJENE,PAMBOANG,TINAMBUNG,57,73,3,2,1,1,0,0,0,3,1,0,5,3,2,0,31,6,25,0,24,21,3,0,12,9,3,6,MEI
SULAWESI BARAT,MAJENE,PAMBOANG,PESULOANG,83,71,65,21,20,2,1,63,0,0,60,4,16,15,1,12,55,25,30,7,4,4,0,0,31,24,7,31,MEI
SULAWESI BARAT,MAJENE,PAMBOANG,BALOMBONG,37,76,46,7,2,1,0,37,0,3,7,6,6,1,5,0,64,63,1,41,59,11,48,7,71,37,34,19,MEI
SULAWESI BARAT,MAJENE,SENDANA,MOSSO,85,31,26,7,1,0,0,8,14,2,20,4,8,3,5,1,13,13,0,12,5,1,4,0,24,17,7,20,MEI
SULAWESI BARAT,MAJENE,SENDANA,MOSSO DHUA,48,75,42,22,11,7,6,8,16,12,37,1,7,2,5,0,66,44,22,21,47,6,41,4,62,20,42,18,MEI
SULAWESI BARAT,MAJENE,SENDANA,TOTOLISI SENDANA,37,29,19,3,2,2,2,3,12,2,19,0,5,1,4,0,19,18,1,15,15,4,11,4,27,27,0,2,MEI
SULAWESI BARAT,MAJENE,SENDANA,TALLUBANUA,89,36,20,10,8,2,2,10,1,1,1,17,14,5,9,4,29,14,15,10,13,11,2,1,20,2,18,19,MEI
SULAWESI BARAT,MAJENE,SENDANA,LALATEDZONG,32,20,16,8,0,0,0,7,5,2,16,0,5,3,2,1,20,17,3,14,10,7,3,6,0,0,0,0,MEI
SULAWESI BARAT,MAJENE,SENDANA,BINANGA,39,68,32,24,10,5,1,25,6,0,1,20,1,1,0,0,12,12,0,12,3,1,2,0,27,16,11,16,MEI
SULAWESI BARAT,MAJENE,SENDANA,PUTTADA,64,42,14,10,1,0,0,2,9,0,1,10,1,0,1,0,17,16,1,7,13,4,9,1,40,23,17,32,MEI
SULAWESI BARAT,MAJENE,SENDANA,PAMINGGALAN,41,73,9,5,3,0,0,5,1,2,4,1,8,8,0,7,23,16,7,16,0,0,0,0,3,3,0,3,MEI
SULAWESI BARAT,MAJENE,SENDANA,LEPPANGANG,75,13,8,1,0,0,0,5,1,2,8,0,12,11,1,10,12,10,2,4,12,6,6,2,19,1,18,3,MEI
SULAWESI BARAT,MAJENE,SENDANA,PUNDAU,57,29,11,1,1,0,0,1,8,0,0,0,2,1,1,0,11,6,5,4,0,0,0,0,10,2,8,10,MEI
SULAWESI BARAT,MAJENE,SENDANA,SENDANA,71,25,22,15,9,4,1,1,0,0,7,10,0,0,0,0,24,13,11,5,5,3,2,3,13,3,10,7,MEI
SULAWESI BARAT,MAJENE,SENDANA,BANUA SENDANA,69,28,27,12,8,2,1,22,3,0,16,8,7,2,5,2,21,12,9,4,11,2,9,2,11,0,11,7,MEI
SULAWESI BARAT,MAJENE,SENDANA,TALLUBANUA UTARA,41,37,3,3,0,0,0,2,1,0,0,2,7,0,7,0,12,9,3,3,3,0,3,0,1,1,0,1,MEI
SULAWESI BARAT,MAJENE,SENDANA,LIMBORO RAMBU-RAMBU,36,55,42,27,12,0,0,17,13,7,14,6,0,0,0,0,13,11,2,9,8,5,3,3,20,17,3,19,MEI
SULAWESI BARAT,MAJENE,SENDANA,LIMBUA,87,15,3,3,0,0,0,1,2,0,0,1,10,9,1,0,15,8,7,7,1,1,0,0,1,0,1,1,MEI
SULAWESI BARAT,MAJENE,SENDANA,BUKIT SAMANG,43,69,52,3,0,0,0,19,20,1,44,1,0,0,0,0,14,7,7,1,11,7,4,0,54,50,4,52,MEI
SULAWESI BARAT,MAJENE,TAMMERODO SENDANA,SEPPONG,52,42,2,1,0,0,0,0,1,0,2,0,4,4,0,2,25,17,8,16,2,2,0,1,5,4,1,0,MEI
SULAWESI BARAT,MAJENE,TAMMERODO SENDANA,TAMMERODO,77,32,7,1,0,0,0,0,3,2,4,3,7,4,3,2,15,8,7,8,8,1,7,0,18,0,18,13,MEI
SULAWESI BARAT,MAJENE,TAMMERODO SENDANA,ULIDANG,49,17,12,0,0,0,0,4,7,0,4,4,1,0,1,0,16,15,1,2,0,0,0,0,8,8,0,0,MEI
SULAWESI BARAT,MAJENE,TAMMERODO SENDANA,TALLAMBALAO,85,12,7,5,5,1,0,1,3,2,7,0,9,6,3,4,12,7,5,1,12,2,10,1,16,1,15,15,MEI
SULAWESI BARAT,MAJENE,TAMMERODO SENDANA,TAMMERODO UTARA,96,66,39,13,1,0,0,28,7,2,6,11,14,8,6,8,19,5,14,4,16,16,0,16,34,19,15,27,MEI
SULAWESI BARAT,MAJENE,TAMMERODO SENDANA,MANYAMBA,73,74,20,8,7,3,1,14,0,4,4,3,5,0,5,0,17,13,4,10,16,4,12,4,13,2,11,9,MEI
SULAWESI BARAT,MAJENE,TAMMERODO SENDANA,AWO,55,11,3,1,1,0,0,3,0,0,3,0,8,2,6,2,11,10,1,10,3,3,0,1,3,1,2,1,MEI
SULAWESI BARAT,MAJENE,TUBO SENDANA,ONANG,73,12,4,1,1,1,0,4,0,0,4,0,0,0,0,0,12,8,4,2,4,4,0,0,11,2,9,10,MEI
SULAWESI BARAT,MAJENE,TUBO SENDANA,TUBO,46,77,37,13,8,4,1,8,19,5,34,0,6,1,5,1,40,27,13,1,10,5,5,0,21,20,1,16,MEI
SULAWESI BARAT,MAJENE,TUBO SENDANA,ONANG UTARA,74,72,51,44,20,0,0,8,12,16,23,27,2,2,0,2,64,22,42,15,11,0,11,0,20,9,11,10,MEI
SULAWESI BARAT,MAJENE,TUBO SENDANA,TUBO SELATAN,50,26,14,11,4,1,0,6,6,0,2,2,5,3,2,0,24,9,15,8,19,9,10,1,33,4,29,21,MEI
SULAWESI BARAT,MAJENE,TUBO SENDANA,BONDE BONDE,69,46,4,0,0,0,0,1,2,1,4,0,0,0,0,0,24,10,14,8,8,0,8,0,8,5,3,2,MEI
SULAWESI BARAT,MAJENE,TUBO SENDANA,TUBO TENGAH,46,14,4,2,0,0,0,1,2,0,4,0,6,6,0,6,11,5,6,1,7,0,7,0,4,0,4,4,MEI
SULAWESI BARAT,MAJENE,TUBO SENDANA,TUBO POANG,50,13,8,0,0,0,0,6,2,0,0,8,1,0,1,0,13,7,6,6,11,4,7,4,14,14,0,7,MEI
SULAWESI BARAT,MAJENE,ULUMANDA,KABIRAAN,44,15,8,2,0,0,0,2,1,3,3,1,5,4,1,0,13,10,3,1,6,1,5,1,5,4,1,3,MEI
SULAWESI BARAT,MAJENE,ULUMANDA,SAMBABO,83,53,44,42,1,0,0,42,2,0,22,21,0,0,0,0,21,14,7,12,21,8,13,6,4,3,1,3,MEI
SULAWESI BARAT,MAJENE,ULUMANDA,TANDEALLO,65,63,52,1,1,1,1,8,29,1,0,45,7,7,0,7,44,19,25,6,27,21,6,9,63,5,58,52,MEI
SULAWESI BARAT,MAJENE,ULUMANDA,ULUMANDA,78,68,53,36,31,4,1,45,1,3,7,1,6,2,4,2,13,9,4,8,12,11,1,10,6,4,2,1,MEI
SULAWESI BARAT,MAJENE,ULUMANDA,SALUTAMBUNG,49,54,48,3,0,0,0,15,9,12,1,43,5,0,5,0,35,33,2,12,8,0,8,0,2,2,0,1,MEI
SULAWESI BARAT,MAJENE,ULUMANDA,POPENGA,86,42,31,4,0,0,0,15,10,0,18,2,15,7,8,6,20,20,0,12,0,0,0,0,4,2,2,3,MEI
SULAWESI BARAT,MAJENE,ULUMANDA,SULAI,80,37,29,13,9,5,4,21,1,3,18,5,10,0,10,0,20,13,7,12,13,12,1,9,38,17,21,5,MEI
SULAWESI BARAT,MAJENE,ULUMANDA,PANGGALO,62,38,18,0,0,0,0,7,10,0,7,5,0,0,0,0,34,18,16,15,24,2,22,0,16,9,7,5,MEI
SULAWESI BARAT,MAMASA,ARALLE,ARALLE,74,48,2,0,0,0,0,1,0,0,0,1,3,2,1,1,45,35,10,31,33,4,29,4,3,1,2,2,MEI
SULAWESI BARAT,MAMASA,ARALLE,RALLE ANAK,70,16,1,0,0,0,0,0,0,0,0,1,13,8,5,0,13,11,2,11,0,0,0,0,6,4,2,1,MEI
SULAWESI BARAT,MAMASA,ARALLE,PANETEAN,34,80,53,33,12,11,7,9,6,27,40,6,3,2,1,1,16,7,9,7,10,8,2,5,65,5,60,7,MEI
SULAWESI BARAT,MAMASA,ARALLE,UHAILANU,67,75,55,19,8,3,1,25,3,0,35,4,2,2,0,1,65,26,39,5,32,6,26,1,25,22,3,4,MEI
SULAWESI BARAT,MAMASA,ARALLE,ARALLE UTARA,55,45,10,5,0,0,0,2,6,0,8,1,7,7,0,0,39,12,27,3,26,10,16,10,35,5,30,7,MEI
SULAWESI BARAT,MAMASA,ARALLE,UHAIDAHO,34,77,42,17,13,2,1,32,6,3,14,18,6,3,3,0,68,16,52,12,33,26,7,0,74,61,13,56,MEI
SULAWESI BARAT,MAMASA,ARALLE,BARURU,41,44,30,25,20,12,3,12,4,8,12,15,4,2,2,2,42,28,14,7,7,2,5,2,21,16,5,20,MEI
SULAWESI BARAT,MAMASA,ARALLE,RALLEANAK UTARA,87,18,5,3,2,2,0,0,1,2,0,5,0,0,0,0,13,11,2,11,9,7,2,3,19,12,7,10,MEI
SULAWESI BARAT,MAMASA,ARALLE,PAMOSEANG PANGGA,42,34,24,6,4,4,2,11,5,4,7,16,4,3,1,3,33,32,1,14,7,1,6,0,26,15,11,1,MEI
SULAWESI BARAT,MAMASA,ARALLE,KALABE,34,57,0,0,0,0,0,0,0,0,0,0,0,0,0,0,57,50,7,44,29,4,25,4,21,6,15,5,MEI
SULAWESI BARAT,MAMASA,ARALLE,ARALLE SELATAN,58,62,27,8,3,2,2,9,4,12,24,1,6,6,0,6,15,7,8,3,4,2,2,1,1,0,1,0,MEI
SULAWESI BARAT,MAMASA,ARALLE,HAHANGAN,68,24,21,19,12,9,7,13,1,0,16,2,1,1,0,0,11,10,1,3,0,0,0,0,7,2,5,6,MEI
SULAWESI BARAT,MAMASA,BALLA,BALLA,42,51,35,30,26,3,3,0,1,26,18,5,7,7,0,7,17,5,12,0,9,7,2,2,18,8,10,8,MEI
SULAWESI BARAT,MAMASA,BALLA,BALLA BARAT,78,57,0,0,0,0,0,0,0,0,0,0,1,0,1,0,34,34,0,11,7,2,5,0,4,3,1,2,MEI
SULAWESI BARAT,MAMASA,BALLA,BALLA SATANETEAN,83,11,0,0,0,0,0,0,0,0,0,0,1,1,0,0,10,9,1,0,6,3,3,1,12,10,2,5,MEI
SULAWESI BARAT,MAMASA,BALLA,BALLA TUMUKA,66,49,11,3,0,0,0,10,1,0,10,1,9,9,0,6,49,26,23,10,29,23,6,0,54,13,41,18,MEI
SULAWESI BARAT,MAMASA,BALLA,SEPAKUAN,88,40,18,5,2,1,1,13,2,0,1,12,5,5,0,5,32,26,6,0,1,1,0,0,23,11,12,2,MEI
SULAWESI BARAT,MAMASA,BALLA,PIDARA,32,14,6,3,3,1,1,0,2,3,5,0,2,2,0,0,12,6,6,5,6,6,0,6,7,4,3,0,MEI
SULAWESI BARAT,MAMASA,BALLA,BAMBAPUANG,83,59,46,38,15,10,0,43,3,0,22,17,4,4,0,4,20,14,6,11,15,12,3,0,37,20,17,23,MEI
SULAWESI BARAT,MAMASA,BALLA,BALLA TIMUR,49,20,12,3,1,0,0,2,7,3,7,0,0,0,0,0,14,10,4,3,10,10,0,1,7,2,5,4,MEI
SULAWESI BARAT,MAMASA,BAMBANG,MOKALLANG,85,69,64,27,4,2,2,17,45,0,22,16,2,2,0,0,41,30,11,29,9,6,3,3,23,14,9,13,MEI
SULAWESI BARAT,MAMASA,BAMBANG,MASOSO,70,30,11,10,10,6,6,5,0,0,6,3,14,6,8,5,25,23,2,8,14,9,5,7,27,23,4,3,MEI
SULAWESI BARAT,MAMASA,BAMBANG,SALUASSING,79,22,22,4,0,0,0,2,12,2,20,2,9,4,5,3,20,16,4,13,13,11,2,6,17,8,9,2,MEI
SULAWESI BARAT,MAMASA,BAMBANG,SALUBULO,40,20,16,3,3,2,0,8,8,0,9,0,0,0,0,0,12,10,2,2,6,6,0,6,18,1,17,11,MEI
SULAWESI BARAT,MAMASA,BAMBANG,SALUKADI,51,44,44,7,4,0,0,15,16,1,33,3,3,0,3,0,24,22,2,21,2,2,0,1,8,5,3,6,MEI
SULAWESI BARAT,MAMASA,BAMBANG,SALUKEPOPOK,32,33,26,16,11,7,3,10,9,1,16,2,6,1,5,0,20,5,15,5,13,11,2,4,28,1,27,25,MEI
SULAWESI BARAT,MAMASA,BAMBANG,ULUMAMBI BARAT,97,55,51,44,9,9,3,5,3,13,1,32,7,7,0,4,33,20,13,5,23,12,11,8,1,1,0,0,MEI
SULAWESI BARAT,MAMASA,BAMBANG,LIMBADEBATA,92,29,6,1,0,0,0,6,0,0,4,1,5,3,2,0,22,6,16,1,18,16,2,12,34,3,31,34,MEI
SULAWESI BARAT,MAMASA,BAMBANG,TANETE TOMBA,82,35,12,12,4,3,2,6,1,3,6,5,7,0,7,0,25,5,20,1,16,8,8,6,34,28,6,9,MEI
SULAWESI BARAT,MAMASA,BAMBANG,BAMBANG,87,35,32,24,8,0,0,9,11,9,9,9,3,2,1,1,12,9,3,9,7,0,7,0,29,9,20,20,MEI
SULAWESI BARAT,MAMASA,BAMBANG,RANTELEMO,50,68,60,41,21,3,1,15,6,21,23,23,6,1,5,0,14,13,1,9,9,4,5,2,24,14,10,6,MEI
SULAWESI BARAT,MAMASA,BAMBANG,SALUDENGEN,49,77,32,22,14,10,7,8,4,1,24,4,9,1,8,0,48,27,21,23,43,36,7,11,62,46,16,25,MEI
SULAWESI BARAT,MAMASA,BAMBANG,ULUMAMBI,68,50,35,21,8,7,6,11,7,0,35,0,1,1,0,1,34,6,28,4,19,1,18,0,13,11,2,3,MEI
SULAWESI BARAT,MAMASA,BAMBANG,BAMBANG TIMUR,59,76,48,36,36,34,3,0,20,17,33,2,3,1,2,0,38,26,12,22,18,14,4,4,70,1,69,7,MEI
SULAWESI BARAT,MAMASA,BAMBANG,MINANGA,81,63,46,21,9,9,4,41,1,0,15,26,1,1,0,1,11,9,2,8,7,3,4,1,20,10,10,14,MEI
SULAWESI BARAT,MAMASA,BAMBANG,SIKAMASE,40,77,29,27,14,11,11,14,2,0,2,4,2,0,2,0,44,19,25,3,5,2,3,0,7,4,3,1,MEI
SULAWESI BARAT,MAMASA,BAMBANG,RANTETARIMA,58,53,21,2,2,1,1,8,7,1,3,0,5,4,1,0,44,37,7,34,24,10,14,9,8,8,0,4,MEI
SULAWESI BARAT,MAMASA,BAMBANG,SALURURU,38,31,29,3,3,0,0,23,1,0,0,13,0,0,0,0,17,12,5,6,13,7,6,5,8,7,1,1,MEI
SULAWESI BARAT,MAMASA,BAMBANG,SALUTABANG,70,39,1,0,0,0,0,0,0,0,0,0,3,3,0,2,22,17,5,0,20,17,3,5,22,12,10,15,MEI
SULAWESI BARAT,MAMASA,BAMBANG,BALATANA,57,18,16,3,0,0,0,11,2,3,12,2,7,6,1,3,13,10,3,6,8,3,5,1,15,10,5,10,MEI
SULAWESI BARAT,MAMASA,BUNTUMALANGKA,BUNTUMALANGKA,44,26,6,2,0,0,0,1,0,2,5,1,0,0,0,0,21,16,5,14,7,6,1,6,10,1,9,6,MEI
SULAWESI BARAT,MAMASA,BUNTUMALANGKA,RANTEBERAN,82,15,14,13,4,3,2,8,4,0,12,1,3,3,0,0,15,5,10,5,12,1,11,0,9,8,1,2,MEI
SULAWESI BARAT,MAMASA,BUNTUMALANGKA,KEBANGA,35,48,28,5,3,3,1,21,0,1,14,11,7,7,0,5,10,10,0,5,10,2,8,0,25,15,10,25,MEI
SULAWESI BARAT,MAMASA,BUNTUMALANGKA,SALURINDU,47,33,10,2,0,0,0,10,0,0,8,2,2,2,0,0,19,9,10,0,13,9,4,6,2,0,2,2,MEI
SULAWESI BARAT,MAMASA,BUNTUMALANGKA,TAORA,59,24,20,13,6,3,0,19,0,1,18,1,4,2,2,1,17,7,10,5,8,5,3,0,12,0,12,12,MEI
SULAWESI BARAT,MAMASA,BUNTUMALANGKA,KABAE,69,24,11,0,0,0,0,9,2,0,6,3,0,0,0,0,10,6,4,6,0,0,0,0,15,3,12,6,MEI
SULAWESI BARAT,MAMASA,BUNTUMALANGKA,SALUTAMBUN BARAT,96,38,31,29,10,2,1,1,16,1,22,3,15,1,14,0,14,10,4,6,0,0,0,0,21,16,5,2,MEI
SULAWESI BARAT,MAMASA,BUNTUMALANGKA,PENATANGAN,91,29,21,3,3,0,0,3,18,0,3,14,14,0,14,0,10,5,5,0,6,6,0,4,23,21,2,6,MEI
SULAWESI BARAT,MAMASA,BUNTUMALANGKA,SALUTAMBUN TIMUR,60,23,10,5,0,0,0,3,5,1,4,4,6,4,2,1,12,12,0,11,7,0,7,0,6,0,6,4,MEI
SULAWESI BARAT,MAMASA,BUNTUMALANGKA,SALUTAMBUN,46,76,69,26,26,17,12,10,28,1,47,15,7,0,7,0,75,6,69,0,73,6,67,2,8,7,1,3,MEI
SULAWESI BARAT,MAMASA,BUNTUMALANGKA,ARALLE TIMUR,84,75,34,24,14,12,0,16,9,8,31,1,7,3,4,2,66,52,14,2,39,18,21,12,38,8,30,34,MEI
SULAWESI BARAT,MAMASA,MAMASA,MAMASA,73,75,33,1,1,0,0,23,5,1,21,6,13,10,3,5,61,44,17,31,4,0,4,0,37,26,11,13,MEI
SULAWESI BARAT,MAMASA,MAMASA,RAMBUSARATU,98,10,0,0,0,0,0,0,0,0,0,0,7,6,1,3,10,9,1,2,10,0,10,0,15,14,1,15,MEI
SULAWESI BARAT,MAMASA,MAMASA,OSANGO,41,75,55,8,4,1,0,1,23,17,38,13,6,3,3,3,45,5,40,2,7,2,5,1,36,33,3,20,MEI
SULAWESI BARAT,MAMASA,MAMASA,LAMBANAN,63,73,53,11,1,1,1,19,14,18,38,0,10,6,4,0,53,46,7,2,4,1,3,0,53,26,27,34,MEI
SULAWESI BARAT,MAMASA,MAMASA,LEMBANA SALULO,93,37,17,12,5,3,1,0,3,10,14,1,13,10,3,10,34,6,28,2,16,16,0,1,20,15,5,14,MEI
SULAWESI BARAT,MAMASA,MAMASA,TAUPE,63,63,40,1,1,0,0,8,29,1,40,0,5,3,2,1,33,13,20,5,22,8,14,6,0,0,0,0,MEI
SULAWESI BARAT,MAMASA,MAMASA,BUNTU BUDA,85,40,29,7,4,1,0,24,4,0,27,1,15,2,13,2,13,13,0,4,9,3,6,2,31,4,27,2,MEI
SULAWESI BARAT,MAMASA,MAMASA,TONDOK BAKARU,60,59,40,9,9,2,2,37,0,0,38,0,0,0,0,0,11,6,5,0,8,5,3,3,29,6,23,10,MEI
SULAWESI BARAT,MAMASA,MAMASA,PEBASSIAN,55,30,9,1,0,0,0,7,1,0,7,0,7,1,6,0,23,14,9,11,18,5,13,4,20,18,2,16,MEI
SULAWESI BARAT,MAMASA,MAMASA,MAMBULILING,34,22,2,1,1,0,0,0,0,1,1,1,5,1,4,0,17,12,5,2,4,3,1,3,4,4,0,3,MEI
SULAWESI BARAT,MAMASA,MAMASA,BOMBONG LAMBE,54,33,31,22,6,0,0,9,17,0,17,5,7,7,0,0,26,5,21,4,9,1,8,1,2,0,2,2,MEI
SULAWESI BARAT,MAMASA,MAMASA,BUBUN BATU,82,13,7,5,5,0,0,6,0,1,6,1,10,9,1,4,11,5,6,0,10,5,5,5,13,3,10,0,MEI
SULAWESI BARAT,MAMASA,MAMBI,MAMBI,57,50,36,7,7,5,0,23,7,1,0,17,9,0,9,0,28,5,23,5,26,11,15,1,4,0,4,1,MEI
SULAWESI BARAT,MAMASA,MAMBI,TALIPUKKI,82,33,20,13,9,5,3,7,0,3,3,17,16,15,1,15,12,10,2,2,3,2,1,2,13,2,11,10,MEI
SULAWESI BARAT,MAMASA,MAMBI,RANTEBULAHAN,89,54,47,2,2,2,2,14,4,13,29,6,16,2,14,2,25,16,9,8,1,1,0,1,32,24,8,25,MEI
SULAWESI BARAT,MAMASA,MAMBI,SONDONGLAYU,66,36,8,3,3,3,2,4,2,0,6,2,4,1,3,0,32,15,17,12,26,20,6,16,20,1,19,12,MEI
SULAWESI BARAT,MAMASA,MAMBI,SALUBANUA,53,41,29,28,9,4,3,11,11,1,23,5,6,2,4,1,34,12,22,9,7,5,2,2,14,13,1,8,MEI
SULAWESI BARAT,MAMASA,MAMBI,TAPALINA,50,41,33,14,10,5,3,28,1,1,17,2,9,5,4,2,41,33,8,13,13,13,0,11,20,8,12,11,MEI
SULAWESI BARAT,MAMASA,MAMBI,SENDANA,50,67,50,29,3,1,1,11,11,22,3,44,8,2,6,2,23,11,12,0,23,17,6,10,19,1,18,19,MEI
SULAWESI BARAT,MAMASA,MAMBI,PAMOSEAN,67,18,16,1,0,0,0,15,0,1,14,0,10,8,2,6,18,12,6,11,9,4,5,1,10,4,6,7,MEI
SULAWESI BARAT,MAMASA,MAMBI,SELUMAKA,86,18,17,4,1,0,0,4,6,4,14,0,15,8,7,4,10,6,4,1,5,2,3,0,5,5,0,5,MEI
SULAWESI BARAT,MAMASA,MAMBI,BUJUNG MANURUNG,63,71,6,4,1,0,0,5,1,0,5,0,1,0,1,0,15,5,10,3,9,7,2,3,51,40,11,51,MEI
SULAWESI BARAT,MAMASA,MAMBI,SALU ALO,35,72,68,56,56,38,31,21,10,4,19,2,2,0,2,0,67,39,28,31,50,17,33,15,48,46,2,41,MEI
SULAWESI BARAT,MAMASA,MAMBI,INDOBANUA,45,37,29,4,3,3,2,4,7,15,22,4,1,1,0,0,11,6,5,2,7,3,4,2,9,5,4,0,MEI
SULAWESI BARAT,MAMASA,MAMBI,SALUDURIAN,68,42,42,29,3,3,3,5,22,12,28,2,6,5,1,5,10,6,4,0,4,4,0,0,31,10,21,4,MEI
SULAWESI BARAT,MAMASA,MEHALAAN,MEHALAAN,51,58,39,22,0,0,0,30,7,0,10,26,8,2,6,0,26,20,6,7,21,0,21,0,9,5,4,8,MEI
SULAWESI BARAT,MAMASA,MEHALAAN,BOTTENG,75,49,47,34,29,24,21,9,6,0,22,1,15,8,7,5,13,10,3,2,13,13,0,9,8,7,1,8,MEI
SULAWESI BARAT,MAMASA,MEHALAAN,SALUKONTA,78,24,13,2,2,0,0,11,1,0,8,4,5,1,4,1,10,9,1,7,5,3,2,1,7,2,5,5,MEI
SULAWESI BARAT,MAMASA,MEHALAAN,MESAKADA,96,44,24,6,4,3,3,14,4,1,15,2,13,10,3,10,24,22,2,20,23,11,12,4,34,22,12,0,MEI
SULAWESI BARAT,MAMASA,MEHALAAN,MEHALAAN BARAT,33,25,10,4,2,1,1,8,0,0,4,4,4,0,4,0,22,19,3,9,0,0,0,0,12,1,11,4,MEI
SULAWESI BARAT,MAMASA,MEHALAAN,SALUAHOK,88,34,7,1,0,0,0,7,0,0,3,3,1,1,0,0,13,12,1,1,11,8,3,0,7,4,3,6,MEI
SULAWESI BARAT,MAMASA,MEHALAAN,SALUBALO,49,63,42,27,23,1,0,37,0,0,26,2,3,1,2,0,30,22,8,20,29,5,24,2,23,12,11,12,MEI
SULAWESI BARAT,MAMASA,MEHALAAN,PASSEMBUK,74,11,11,9,4,3,1,0,7,3,0,10,0,0,0,0,11,6,5,4,6,6,0,1,1,1,0,0,MEI
SULAWESI BARAT,MAMASA,MEHALAAN,KONDO,54,61,20,19,1,1,0,4,0,10,6,11,9,3,6,2,59,11,48,9,2,1,1,1,9,3,6,6,MEI
SULAWESI BARAT,MAMASA,MEHALAAN,LEKO SUKAMAJU,41,70,59,22,17,2,2,0,19,17,13,20,1,0,1,0,13,7,6,1,0,0,0,0,46,4,42,29,MEI
SULAWESI BARAT,MAMASA,MEHALAAN,ULUMEA,86,41,30,3,1,0,0,21,7,1,25,2,16,8,8,3,31,5,26,4,24,24,0,0,14,14,0,6,MEI
SULAWESI BARAT,MAMASA,MESSAWA,MESSAWA,56,14,14,9,1,1,1,8,3,1,5,7,4,4,0,3,14,5,9,0,13,1,12,0,20,7,13,9,MEI
SULAWESI BARAT,MAMASA,MESSAWA,RIPPUNG,69,36,9,9,1,0,0,6,0,1,7,0,3,3,0,2,10,10,0,8,9,0,9,0,5,2,3,4,MEI
SULAWESI BARAT,MAMASA,MESSAWA,MAKUANG,62,41,26,21,16,7,1,5,5,4,25,1,4,4,0,4,41,28,13,13,36,23,13,21,44,23,21,28,MEI
SULAWESI BARAT,MAMASA,MESSAWA,SEPANG,85,10,3,2,0,0,0,0,2,0,0,3,3,3,0,0,10,10,0,10,9,3,6,3,9,7,2,4,MEI
SULAWESI BARAT,MAMASA,MESSAWA,MALIMBONG,82,13,2,1,1,0,0,2,0,0,0,2,3,3,0,3,13,9,4,0,6,5,1,4,8,3,5,1,MEI
SULAWESI BARAT,MAMASA,MESSAWA,MATANDE,77,69,26,17,6,5,1,22,3,0,6,6,12,6,6,2,62,12,50,4,13,6,7,4,12,11,1,12,MEI
SULAWESI BARAT,MAMASA,MESSAWA,SIPAI,57,70,14,3,1,1,0,2,6,0,4,6,2,0,2,0,66,63,3,1,42,35,7,10,68,44,24,21,MEI
SULAWESI BARAT,MAMASA,MESSAWA,PASMA MAMBU,84,56,52,45,45,32,15,8,13,6,47,4,7,4,3,0,53,9,44,1,14,0,14,0,31,0,31,12,MEI
SULAWESI BARAT,MAMASA,MESSAWA,TANETE BATU,35,17,13,11,4,0,0,3,2,8,7,2,5,2,3,1,14,8,6,4,12,4,8,2,0,0,0,0,MEI
SULAWESI BARAT,MAMASA,NOSU,NOSU,60,35,20,7,3,1,0,10,6,1,0,7,5,2,3,2,22,13,9,9,11,10,1,9,20,16,4,20,MEI
SULAWESI BARAT,MAMASA,NOSU,MINANGA,63,40,29,13,10,4,3,20,6,0,0,22,12,6,6,0,30,9,21,5,7,3,4,3,35,4,31,31,MEI
SULAWESI BARAT,MAMASA,NOSU,BATUPAPAN,95,66,25,25,9,4,3,4,9,0,23,0,2,1,1,1,14,7,7,4,14,12,2,5,37,24,13,4,MEI
SULAWESI BARAT,MAMASA,NOSU,MASEWWE,85,59,58,25,10,2,2,44,9,1,41,10,14,11,3,2,36,24,12,22,23,4,19,3,39,5,34,5,MEI
SULAWESI BARAT,MAMASA,NOSU,SIWI,48,33,20,20,17,12,3,11,6,0,5,6,7,0,7,0,13,7,6,6,7,5,2,4,19,10,9,4,MEI
SULAWESI BARAT,MAMASA,NOSU,MINANGA TIMUR,38,23,10,7,0,0,0,6,0,0,5,1,6,3,3,0,23,22,1,1,8,0,8,0,14,2,12,10,MEI
SULAWESI BARAT,MAMASA,NOSU,PARINDING,48,18,13,12,12,8,0,3,6,2,10,2,7,3,4,0,17,6,11,4,9,2,7,1,7,1,6,2,MEI
SULAWESI BARAT,MAMASA,PANA,PANA,37,79,66,54,25,12,3,11,35,8,42,0,2,0,2,0,16,10,6,10,1,1,0,1,9,7,2,6,MEI
SULAWESI BARAT,MAMASA,PANA,MANIPI,95,31,7,4,2,0,0,1,2,0,2,2,15,4,11,4,15,5,10,0,5,1,4,0,8,6,2,7,MEI
SULAWESI BARAT,MAMASA,PANA,MAMULLU,76,25,24,21,8,0,0,24,0,0,17,5,6,4,2,1,18,14,4,10,7,4,3,3,4,4,0,1,MEI
SULAWESI BARAT,MAMASA,PANA,SAPAN,40,54,46,28,24,13,11,28,5,1,44,1,8,0,8,0,48,16,32,12,26,11,15,3,25,7,18,18,MEI
SULAWESI BARAT,MAMASA,PANA,DATUBARINGAN,93,19,2,2,1,0,0,2,0,0,0,0,1,0,1,0,11,7,4,3,6,2,4,0,9,4,5,2,MEI
SULAWESI BARAT,MAMASA,PANA,PANURA,59,30,4,0,0,0,0,4,0,0,2,2,6,2,4,0,13,13,0,3,5,2,3,0,22,10,12,10,MEI
SULAWESI BARAT,MAMASA,PANA,TALLANG BULAWAN,66,46,26,13,8,8,1,21,0,1,20,5,3,3,0,0,31,13,18,2,0,0,0,0,22,11,11,12,MEI
SULAWESI BARAT,MAMASA,PANA,KARAKA,74,73,20,8,1,0,0,9,6,2,10,5,10,7,3,6,55,5,50,3,34,31,3,30,28,11,17,18,MEI
SULAWESI BARAT,MAMASA,PANA,ULUSALU,99,60,35,16,5,5,3,26,3,0,20,0,18,11,7,2,58,55,3,19,54,2,52,1,49,16,33,17,MEI
SULAWESI BARAT,MAMASA,PANA,WERI,90,52,9,0,0,0,0,9,0,0,2,3,17,13,4,8,21,17,4,15,3,2,1,1,20,0,20,15,MEI
SULAWESI BARAT,MAMASA,PANA,SALUTAMBUN,91,69,9,0,0,0,0,2,3,4,1,4,9,0,9,0,38,16,22,4,7,3,4,0,17,16,1,1,MEI
SULAWESI BARAT,MAMASA,PANA,SALOAN,97,51,23,5,4,4,2,21,0,0,17,0,13,7,6,7,20,14,6,14,18,4,14,3,47,4,43,17,MEI
SULAWESI BARAT,MAMASA,PANA,ULUSALU INDAH,93,21,14,2,2,1,1,3,8,2,9,4,10,2,8,0,13,10,3,2,4,4,0,1,1,0,1,1,MEI
SULAWESI BARAT,MAMASA,RANTEBULAHAN TIMUR,SALUMOKANAN,49,35,1,1,0,0,0,0,0,0,1,0,2,0,2,0,33,27,6,15,13,12,1,8,24,17,7,1,MEI
SULAWESI BARAT,MAMASA,RANTEBULAHAN TIMUR,SALUMOKANAN BARAT,38,13,9,0,0,0,0,5,1,3,1,6,4,4,0,1,11,5,6,4,1,0,1,0,8,2,6,8,MEI
SULAWESI BARAT,MAMASA,RANTEBULAHAN TIMUR,BUANGIN,90,59,12,1,1,1,1,2,8,0,7,3,2,2,0,0,35,25,10,7,23,15,8,2,58,1,57,4,MEI
SULAWESI BARAT,MAMASA,RANTEBULAHAN TIMUR,BAMBANG BUDA,72,41,20,15,7,5,4,2,11,0,0,20,7,7,0,4,31,28,3,20,29,9,20,9,34,21,13,16,MEI
SULAWESI BARAT,MAMASA,RANTEBULAHAN TIMUR,LEKO,100,47,27,25,7,6,2,6,9,3,12,9,19,6,13,0,21,14,7,0,20,11,9,8,3,1,2,2,MEI
SULAWESI BARAT,MAMASA,RANTEBULAHAN TIMUR,KIRAK,40,52,36,10,0,0,0,7,13,2,35,1,2,2,0,2,25,12,13,5,7,5,2,0,19,12,7,13,MEI
SULAWESI BARAT,MAMASA,RANTEBULAHAN TIMUR,SALUMOKANAN UTARA,62,67,18,18,8,7,2,9,7,0,13,4,1,0,1,0,11,11,0,4,2,0,2,0,26,12,14,18,MEI
SULAWESI BARAT,MAMASA,RANTEBULAHAN TIMUR,SAMPALE,86,41,10,1,1,1,0,0,6,1,1,5,2,2,0,1,29,27,2,3,2,2,0,2,28,22,6,3,MEI
SULAWESI BARAT,MAMASA,SESENAPADANG,OROBUA,36,80,37,33,12,4,3,25,3,5,37,0,2,1,1,1,75,46,29,28,25,14,11,5,44,0,44,43,MEI
SULAWESI BARAT,MAMASA,SESENAPADANG,PALADAN,91,37,33,5,5,2,2,20,3,6,3,11,9,0,9,0,12,12,0,9,5,5,0,1,29,3,26,25,MEI
SULAWESI BARAT,MAMASA,SESENAPADANG,OROBUA TIMUR,68,37,33,20,7,4,4,7,0,3,9,6,11,3,8,2,20,5,15,1,4,0,4,0,8,8,0,2,MEI
SULAWESI BARAT,MAMASA,SESENAPADANG,RANTE PUANG,99,23,14,0,0,0,0,5,7,1,11,2,13,6,7,0,17,9,8,2,5,0,5,0,10,0,10,1,MEI
SULAWESI BARAT,MAMASA,SESENAPADANG,SATENETEAN,100,58,49,20,1,0,0,9,5,30,21,5,17,14,3,8,34,19,15,2,3,0,3,0,22,12,10,16,MEI
SULAWESI BARAT,MAMASA,SESENAPADANG,LISUAN ADA,39,45,22,7,2,0,0,15,6,1,0,15,6,0,6,0,16,10,6,7,6,3,3,3,21,11,10,18,MEI
SULAWESI BARAT,MAMASA,SESENAPADANG,OROBUA SELATAN,70,39,14,5,3,3,1,8,2,2,4,0,7,7,0,5,36,24,12,17,3,3,0,1,23,1,22,10,MEI
SULAWESI BARAT,MAMASA,SESENAPADANG,MALANGKENA PADANG,71,76,17,13,7,3,2,6,1,8,3,3,12,5,7,0,51,18,33,14,37,2,35,2,17,1,16,7,MEI
SULAWESI BARAT,MAMASA,SESENAPADANG,MALIMBONG,87,60,16,12,11,5,5,1,0,9,16,0,9,8,1,4,41,6,35,1,13,0,13,0,8,1,7,2,MEI
SULAWESI BARAT,MAMASA,SESENAPADANG,MARAMPAN OROBUA,51,28,16,13,4,2,2,2,3,6,11,3,9,0,9,0,12,11,1,8,6,1,5,0,21,6,15,0,MEI
SULAWESI BARAT,MAMASA,SUMARORONG,SUMARORONG,32,50,3,0,0,0,0,1,1,0,2,0,6,6,0,4,39,16,23,3,26,14,12,8,17,0,17,0,MEI
SULAWESI BARAT,MAMASA,SUMARORONG,TABONE,49,32,32,25,24,4,2,24,3,2,18,0,4,3,1,2,22,18,4,10,4,1,3,0,7,4,3,7,MEI
SULAWESI BARAT,MAMASA,SUMARORONG,BATANG URU,68,78,33,20,0,0,0,22,0,7,18,5,8,6,2,5,59,23,36,22,5,2,3,0,8,6,2,1,MEI
SULAWESI BARAT,MAMASA,SUMARORONG,SASAKAN,54,49,2,0,0,0,0,2,0,0,1,1,2,1,1,1,37,27,10,7,3,2,1,1,17,4,13,2,MEI
SULAWESI BARAT,MAMASA,SUMARORONG,TADISI,50,73,7,7,2,1,1,5,0,1,3,1,5,3,2,1,57,49,8,33,27,6,21,6,26,0,26,8,MEI
SULAWESI BARAT,MAMASA,SUMARORONG,SIBANAWA,44,59,4,1,1,0,0,1,0,3,3,0,3,2,1,2,23,8,15,2,20,9,11,8,27,15,12,10,MEI
SULAWESI BARAT,MAMASA,SUMARORONG,BATANGNGURU TIMUR,75,32,20,1,1,0,0,16,0,3,2,8,5,5,0,1,20,13,7,0,4,3,1,1,10,6,4,6,MEI
SULAWESI BARAT,MAMASA,SUMARORONG,SALUBALO,38,15,1,0,0,0,0,0,0,1,0,0,3,2,1,1,10,9,1,0,2,0,2,0,7,4,3,3,MEI
SULAWESI BARAT,MAMASA,SUMARORONG,BANEA,43,73,24,8,5,5,5,1,4,10,0,7,6,5,1,4,18,10,8,8,5,0,5,0,17,5,12,2,MEI
SULAWESI BARAT,MAMASA,SUMARORONG,RANTE KAMASE,88,30,16,5,0,0,0,9,0,1,5,10,0,0,0,0,26,14,12,13,8,1,7,1,9,5,4,1,MEI
SULAWESI BARAT,MAMASA,TABANG,TABANG,54,10,10,6,6,5,2,2,5,1,0,7,10,0,10,0,10,6,4,5,9,5,4,4,1,0,1,0,MEI
SULAWESI BARAT,MAMASA,TABANG,TADOKALUA,48,20,6,2,2,1,0,4,0,1,4,0,5,1,4,0,20,15,5,12,11,2,9,2,18,2,16,18,MEI
SULAWESI BARAT,MAMASA,TABANG,TABANG BARAT,45,30,23,9,9,9,1,3,11,1,3,4,0,0,0,0,28,20,8,6,17,5,12,0,26,1,25,0,MEI
SULAWESI BARAT,MAMASA,TABANG,MASUPU,35,33,8,6,1,0,0,6,1,1,6,0,4,2,2,2,20,5,15,2,7,5,2,3,18,5,13,4,MEI
SULAWESI BARAT,MAMASA,TABANG,KALAMA,43,73,6,6,2,2,2,3,1,0,3,0,1,0,1,0,25,12,13,9,13,4,9,1,15,15,0,12,MEI
SULAWESI BARAT,MAMASA,TABANG,BAKADISURA,99,45,28,3,3,0,0,19,9,0,14,11,1,1,0,0,36,29,7,12,35,16,19,11,64,18,46,55,MEI
SULAWESI BARAT,MAMASA,TABANG,SALUKONA,56,73,7,7,1,0,0,6,1,0,3,4,6,3,3,0,69,62,7,45,68,0,68,0,69,7,62,49,MEI
SULAWESI BARAT,MAMASA,TABULAHAN,LAKAHANG,99,55,43,13,4,1,1,18,7,9,1,9,4,0,4,0,38,26,12,24,9,4,5,1,0,0,0,0,MEI
SULAWESI BARAT,MAMASA,TABULAHAN,PERIANGAN,40,34,24,7,4,0,0,0,22,2,0,1,2,2,0,0,12,9,3,5,3,3,0,1,24,6,18,13,MEI
SULAWESI BARAT,MAMASA,TABULAHAN,MALATIRO,80,43,40,35,13,0,0,1,25,5,19,1,9,9,0,3,39,20,19,13,20,4,16,2,25,24,1,15,MEI
SULAWESI BARAT,MAMASA,TABULAHAN,TABULAHAN,90,47,29,17,3,2,0,16,4,0,6,9,11,9,2,1,46,5,41,4,6,1,5,1,28,13,15,24,MEI
SULAWESI BARAT,MAMASA,TABULAHAN,SALULEANG,80,55,15,11,9,9,3,6,0,2,13,2,7,2,5,0,54,21,33,21,40,39,1,16,3,0,3,2,MEI
SULAWESI BARAT,MAMASA,TABULAHAN,TAMPAK KURRA,68,27,15,7,7,3,0,12,2,1,13,1,3,1,2,1,21,18,3,16,13,10,3,7,15,15,0,9,MEI
SULAWESI BARAT,MAMASA,TABULAHAN,GANDANG DEWATA,48,18,1,0,0,0,0,1,0,0,0,0,0,0,0,0,15,9,6,4,15,5,10,0,0,0,0,0,MEI
SULAWESI BARAT,MAMASA,TABULAHAN,BURANA,77,55,51,43,35,35,4,20,24,1,16,5,1,0,1,0,33,9,24,1,11,11,0,5,14,9,5,12,MEI
SULAWESI BARAT,MAMASA,TABULAHAN,SALUBAKKA,51,48,20,3,1,0,0,19,1,0,17,3,4,4,0,3,29,17,12,4,27,2,25,1,60,5,55,54,MEI
SULAWESI BARAT,MAMASA,TABULAHAN,PANGANDARAN,78,64,51,28,22,6,4,4,32,3,39,2,8,8,0,7,14,13,1,5,4,0,4,0,30,8,22,1,MEI
SULAWESI BARAT,MAMASA,TABULAHAN,TALOPAK,98,68,7,6,1,1,1,6,0,0,1,2,17,8,9,0,56,35,21,24,32,13,19,8,71,6,65,65,MEI
SULAWESI BARAT,MAMASA,TABULAHAN,PEU',87,76,62,37,37,25,17,39,4,0,28,1,3,1,2,0,60,17,43,12,12,11,1,10,32,13,19,3,MEI
SULAWESI BARAT,MAMASA,TABULAHAN,TIMORO,55,33,21,20,20,3,1,9,4,5,5,5,8,0,8,0,22,17,5,1,4,3,1,2,22,22,0,15,MEI
SULAWESI BARAT,MAMASA,TABULAHAN,LAKAHANG UTAMA,74,13,4,2,0,0,0,4,0,0,2,0,10,7,3,7,13,11,2,9,13,3,10,0,11,3,8,6,MEI
SULAWESI BARAT,MAMASA,TANDUK KALUA,MINAKE,37,21,12,1,1,1,1,7,2,0,4,0,0,0,0,0,17,17,0,3,9,5,4,1,13,10,3,11,MEI
SULAWESI BARAT,MAMASA,TANDUK KALUA,MALABO,70,45,40,15,14,10,4,1,0,7,22,14,9,8,1,4,33,24,9,18,10,10,0,3,30,1,29,1,MEI
SULAWESI BARAT,MAMASA,TANDUK KALUA,SINDAGAMANIK,41,17,5,4,1,0,0,4,0,0,4,0,0,0,0,0,14,8,6,8,14,3,11,2,4,4,0,0,MEI
SULAWESI BARAT,MAMASA,TANDUK KALUA,PARONDOBULAWAN,63,47,18,7,5,4,3,13,0,0,10,1,1,1,0,0,32,31,1,23,27,8,19,8,47,13,34,33,MEI
SULAWESI BARAT,MAMASA,TANDUK KALUA,TAMALANTIK,40,15,3,2,1,1,0,1,0,0,1,1,4,4,0,1,10,9,1,6,9,4,5,3,19,13,6,2,MEI
SULAWESI BARAT,MAMASA,TANDUK KALUA,MANNABABA,40,59,43,4,4,0,0,11,15,14,11,29,1,0,1,0,56,10,46,1,34,19,15,11,38,0,38,8,MEI
SULAWESI BARAT,MAMASA,TANDUK KALUA,MESAKADA,75,53,53,41,16,5,2,20,11,0,9,12,11,6,5,0,40,27,13,8,35,30,5,10,26,1,25,16,MEI
SULAWESI BARAT,MAMASA,TANDUK KALUA,BALLABATU,48,68,45,28,12,2,1,1,39,4,12,1,0,0,0,0,19,6,13,4,14,7,7,2,49,12,37,36,MEI
SULAWESI BARAT,MAMASA,TANDUK KALUA,PAMBE,95,76,74,68,29,25,16,0,43,4,46,16,16,16,0,12,35,16,19,7,4,1,3,1,28,22,6,2,MEI
SULAWESI BARAT,MAMASA,TANDUK KALUA,SALURANO,48,58,26,13,11,8,6,13,0,6,2,14,8,8,0,6,10,10,0,2,9,9,0,4,19,4,15,13,MEI
SULAWESI BARAT,MAMASA,TANDUK KALUA,TALIMBUNG,78,24,9,5,3,2,0,2,1,5,8,0,11,0,11,0,12,8,4,3,5,5,0,4,20,0,20,5,MEI
SULAWESI BARAT,MAMASA,TANDUK KALUA,KANAN,83,31,11,7,3,3,0,5,4,1,1,7,15,7,8,0,10,10,0,1,10,9,1,0,6,0,6,0,MEI
SULAWESI BARAT,MAMASA,TAWALIAN,TAWALIAN,55,69,64,27,18,16,9,42,8,0,3,20,1,1,0,1,16,15,1,2,11,0,11,0,30,12,18,8,MEI
SULAWESI BARAT,MAMASA,TAWALIAN,TAWALIAN TIMUR,69,56,20,16,3,3,3,13,4,0,19,1,4,2,2,2,29,9,20,3,14,11,3,3,0,0,0,0,MEI
SULAWESI BARAT,MAMASA,TAWALIAN,KARIANGO,72,36,24,8,1,0,0,10,6,2,12,0,3,3,0,3,10,8,2,8,5,2,3,2,25,25,0,25,MEI
SULAWESI BARAT,MAMASA,TAWALIAN,RANTETANGNGA,100,49,33,0,0,0,0,8,15,4,16,10,4,4,0,4,40,19,21,11,38,13,25,13,48,28,20,43,MEI
SULAWESI BARAT,POLEWALI MANDAR,ALLU,PETOOSANG,45,15,10,10,8,4,0,0,3,5,6,4,8,5,3,3,11,9,2,0,4,1,3,1,5,4,1,5,MEI
SULAWESI BARAT,POLEWALI MANDAR,ALLU,MOMBI,74,40,5,5,1,0,0,5,0,0,4,1,7,5,2,1,29,8,21,8,22,18,4,12,3,1,2,0,MEI
SULAWESI BARAT,POLEWALI MANDAR,ALLU,KALUMAMMANG,36,76,20,19,7,3,0,10,7,3,19,1,3,2,1,1,57,45,12,31,31,31,0,16,26,3,23,3,MEI
SULAWESI BARAT,POLEWALI MANDAR,ALLU,PAO-PAO,97,32,0,0,0,0,0,0,0,0,0,0,2,2,0,2,17,8,9,4,4,2,2,1,22,9,13,1,MEI
SULAWESI BARAT,POLEWALI MANDAR,ALLU,PUPPU URING,53,79,19,1,0,0,0,8,1,3,3,5,4,1,3,0,62,46,16,45,24,24,0,5,41,25,16,26,MEI
SULAWESI BARAT,POLEWALI MANDAR,ALLU,SARAGIAN,94,79,15,6,0,0,0,8,5,0,0,8,11,10,1,4,52,48,4,2,50,16,34,7,49,14,35,9,MEI
SULAWESI BARAT,POLEWALI MANDAR,ALLU,SAYOANG,79,80,33,18,7,4,2,29,1,1,12,14,14,12,2,0,66,37,29,35,39,16,23,2,70,35,35,59,MEI
SULAWESI BARAT,POLEWALI MANDAR,ALLU,ALU,82,52,4,3,0,0,0,2,1,0,4,0,12,5,7,0,29,16,13,13,25,10,15,0,18,12,6,14,MEI
SULAWESI BARAT,POLEWALI MANDAR,ANREAPI,ANREAPI,59,16,12,0,0,0,0,10,0,0,11,1,4,2,2,2,11,11,0,7,2,2,0,1,0,0,0,0,MEI
SULAWESI BARAT,POLEWALI MANDAR,ANREAPI,DUAMPANUA,64,14,10,5,2,2,1,8,1,0,4,4,11,3,8,1,12,5,7,0,4,1,3,0,7,3,4,2,MEI
SULAWESI BARAT,POLEWALI MANDAR,ANREAPI,KELAPA DUA,52,49,19,10,10,5,3,13,1,1,2,11,3,2,1,2,40,16,24,0,14,4,10,2,47,14,33,41,MEI
SULAWESI BARAT,POLEWALI MANDAR,ANREAPI,PAPPANDANGAN,68,69,22,15,0,0,0,0,0,15,20,1,2,1,1,0,11,9,2,2,8,5,3,0,22,18,4,16,MEI
SULAWESI BARAT,POLEWALI MANDAR,ANREAPI,KUNYI,69,46,9,6,1,1,1,1,2,1,7,1,4,1,3,1,39,12,27,6,18,12,6,11,35,6,29,32,MEI
SULAWESI BARAT,POLEWALI MANDAR,BALANIPA,BALANIPA,71,41,22,17,7,1,1,13,2,6,6,3,4,2,2,2,23,23,0,11,8,5,3,3,21,9,12,1,MEI
SULAWESI BARAT,POLEWALI MANDAR,BALANIPA,TAMMAJARRA,72,17,15,14,13,12,2,13,0,0,2,8,4,3,1,0,11,5,6,2,5,5,0,3,9,9,0,7,MEI
SULAWESI BARAT,POLEWALI MANDAR,BALANIPA,TAMANGGALLE,72,80,42,29,5,2,1,38,3,0,37,3,9,0,9,0,75,18,57,1,58,10,48,2,47,11,36,27,MEI
SULAWESI BARAT,POLEWALI MANDAR,BALANIPA,MOSSO,31,62,42,41,16,0,0,25,1,8,8,15,3,1,2,1,32,18,14,1,12,2,10,1,50,1,49,2,MEI
SULAWESI BARAT,POLEWALI MANDAR,BALANIPA,GALUNG TULUK,64,27,0,0,0,0,0,0,0,0,0,0,11,8,3,6,21,6,15,1,0,0,0,0,11,0,11,0,MEI
SULAWESI BARAT,POLEWALI MANDAR,BALANIPA,SABANG SUBIK,80,47,33,32,15,8,1,32,0,0,23,2,8,2,6,2,11,7,4,5,6,0,6,0,27,2,25,25,MEI
SULAWESI BARAT,POLEWALI MANDAR,BALANIPA,PAMBUSUANG,44,78,17,0,0,0,0,7,6,0,7,7,1,0,1,0,48,48,0,13,27,2,25,2,51,15,36,1,MEI
SULAWESI BARAT,POLEWALI MANDAR,BALANIPA,BALA,52,26,17,10,8,1,0,8,2,1,8,7,10,8,2,1,25,6,19,2,8,8,0,4,10,10,0,0,MEI
SULAWESI BARAT,POLEWALI MANDAR,BALANIPA,LAMBANAN,69,32,8,4,3,1,0,2,1,2,5,0,2,2,0,2,19,16,3,16,18,12,6,9,8,8,0,7,MEI
SULAWESI BARAT,POLEWALI MANDAR,BALANIPA,LEGO,88,77,33,26,22,11,4,19,6,0,12,17,10,0,10,0,64,37,27,8,45,38,7,9,20,7,13,16,MEI
SULAWESI BARAT,POLEWALI MANDAR,BALANIPA,PALLIS,56,51,48,15,7,6,3,8,8,12,37,5,0,0,0,0,28,5,23,5,18,0,18,0,41,34,7,20,MEI
SULAWESI BARAT,POLEWALI MANDAR,BINUANG,AMASSANGAN,63,17,12,1,1,0,0,12,0,0,10,1,12,0,12,0,11,7,4,5,8,2,6,0,9,5,4,2,MEI
SULAWESI BARAT,POLEWALI MANDAR,BINUANG,TONYAMAN,99,17,5,4,4,3,2,2,0,0,1,0,11,10,1,6,17,5,12,0,10,6,4,6,2,2,0,1,MEI
SULAWESI BARAT,POLEWALI MANDAR,BINUANG,KUAJANG,47,39,21,13,12,10,1,17,1,0,6,12,0,0,0,0,34,10,24,1,26,4,22,1,11,11,0,4,MEI
SULAWESI BARAT,POLEWALI MANDAR,BINUANG,PAKU,67,41,24,15,9,3,1,2,8,5,10,1,4,1,3,0,23,19,4,0,17,9,8,7,20,9,11,16,MEI
SULAWESI BARAT,POLEWALI MANDAR,BINUANG,MIRRING,95,26,13,8,7,4,3,7,3,0,8,4,1,0,1,0,19,17,2,9,11,5,6,5,5,3,2,5,MEI
SULAWESI BARAT,POLEWALI MANDAR,BINUANG,BATETANGNGA,99,19,6,3,0,0,0,6,0,0,0,3,7,1,6,0,14,5,9,0,13,10,3,3,13,6,7,11,MEI
SULAWESI BARAT,POLEWALI MANDAR,BINUANG,MAMMI,74,70,4,2,2,0,0,0,1,2,3,0,14,12,2,10,14,14,0,1,12,7,5,7,2,1,1,0,MEI
SULAWESI BARAT,POLEWALI MANDAR,BINUANG,KALEOK,92,47,39,29,18,3,2,5,0,28,26,10,6,4,2,3,29,15,14,10,19,4,15,2,23,14,9,11,MEI
SULAWESI BARAT,POLEWALI MANDAR,BINUANG,AMOLA,40,46,46,24,7,7,1,20,11,14,26,5,8,8,0,6,30,8,22,7,9,7,2,2,20,20,0,11,MEI
SULAWESI BARAT,POLEWALI MANDAR,BINUANG,REA,73,12,1,0,0,0,0,0,1,0,0,0,4,2,2,2,10,8,2,2,6,6,0,1,10,4,6,1,MEI
SULAWESI BARAT,POLEWALI MANDAR,BULO,BULO,61,28,6,6,0,0,0,4,0,1,4,1,6,6,0,6,14,14,0,0,8,4,4,1,17,12,5,12,MEI
SULAWESI BARAT,POLEWALI MANDAR,BULO,PULLIWA,89,80,26,20,10,8,0,9,2,1,10,5,0,0,0,0,30,25,5,12,24,4,20,0,53,10,43,29,MEI
SULAWESI BARAT,POLEWALI MANDAR,BULO,PATAMBANUA,40,48,30,24,7,6,6,21,3,0,22,7,6,4,2,3,18,8,10,1,15,0,15,0,28,11,17,1,MEI
SULAWESI BARAT,POLEWALI MANDAR,BULO,KAROMBANG,97,77,54,36,10,0,0,4,1,21,2,38,7,4,3,0,35,28,7,13,3,1,2,1,34,33,1,20,MEI
SULAWESI BARAT,POLEWALI MANDAR,BULO,DAALA TIMUR,76,26,17,11,3,2,2,10,5,0,4,5,9,1,8,1,18,6,12,1,14,2,12,1,20,0,20,7,MEI
SULAWESI BARAT,POLEWALI MANDAR,BULO,LENGGO,92,77,13,3,1,1,0,11,0,0,10,3,15,13,2,0,29,28,1,10,11,8,3,4,10,9,1,10,MEI
SULAWESI BARAT,POLEWALI MANDAR,BULO,SABURA,81,52,14,14,8,8,4,5,5,0,2,12,16,6,10,2,20,7,13,1,13,9,4,7,40,3,37,37,MEI
SULAWESI BARAT,POLEWALI MANDAR,BULO,SEPPORRAKI,66,48,16,8,3,0,0,16,0,0,16,0,13,11,2,10,11,6,5,6,11,3,8,0,5,4,1,5,MEI
SULAWESI BARAT,POLEWALI MANDAR,BULO,IHING,97,13,7,0,0,0,0,5,0,2,7,0,5,5,0,1,11,5,6,1,3,2,1,0,2,2,0,2,MEI
SULAWESI BARAT,POLEWALI MANDAR,CAMPALAGIAN,PAPPANG,76,35,30,26,3,1,0,16,12,0,3,5,3,1,2,1,13,5,8,0,1,1,0,1,24,6,18,14,MEI
SULAWESI BARAT,POLEWALI MANDAR,CAMPALAGIAN,LALIKO,70,35,26,25,2,2,1,17,8,0,21,4,4,2,2,1,20,6,14,3,14,7,7,1,22,12,10,21,MEI
SULAWESI BARAT,POLEWALI MANDAR,CAMPALAGIAN,BONDE,78,62,31,17,11,9,9,9,4,2,29,2,0,0,0,0,17,7,10,0,11,8,3,5,20,1,19,20,MEI
SULAWESI BARAT,POLEWALI MANDAR,CAMPALAGIAN,KATUMBANGAN LEMO,45,20,19,13,3,0,0,10,7,1,4,11,3,2,1,1,16,13,3,6,3,0,3,0,16,7,9,0,MEI
SULAWESI BARAT,POLEWALI MANDAR,CAMPALAGIAN,PANYAMPA,44,64,63,43,25,14,2,40,7,11,53,2,3,1,2,1,57,16,41,12,25,10,15,1,55,32,23,44,MEI
SULAWESI BARAT,POLEWALI MANDAR,CAMPALAGIAN,SURUANG,84,26,1,0,0,0,0,0,0,0,1,0,5,2,3,2,26,15,11,5,13,6,7,0,25,9,16,22,MEI
SULAWESI BARAT,POLEWALI MANDAR,CAMPALAGIAN,LAMPOKO,46,26,5,2,2,0,0,0,3,1,0,2,7,0,7,0,15,15,0,13,11,3,8,2,12,12,0,4,MEI
SULAWESI BARAT,POLEWALI MANDAR,CAMPALAGIAN,KATUMBANGAN,69,23,5,4,4,2,1,3,1,0,3,2,10,3,7,3,14,9,5,4,3,2,1,2,13,1,12,0,MEI
SULAWESI BARAT,POLEWALI MANDAR,CAMPALAGIAN,LAPEO,37,72,13,12,5,2,0,1,4,8,7,4,1,1,0,0,53,24,29,0,11,10,1,2,3,3,0,2,MEI
SULAWESI BARAT,POLEWALI MANDAR,CAMPALAGIAN,PARAPPE,75,47,32,16,5,1,1,2,27,0,14,3,5,1,4,1,30,5,25,5,14,9,5,4,22,10,12,14,MEI
SULAWESI BARAT,POLEWALI MANDAR,CAMPALAGIAN,ONGKO,37,78,29,5,1,0,0,23,2,2,11,8,3,2,1,0,15,13,2,5,12,9,3,6,60,16,44,18,MEI
SULAWESI BARAT,POLEWALI MANDAR,CAMPALAGIAN,KENJE,47,23,11,3,1,1,0,8,0,0,0,7,8,6,2,1,15,8,7,1,7,2,5,0,11,2,9,10,MEI
SULAWESI BARAT,POLEWALI MANDAR,CAMPALAGIAN,SUMARRANG,74,33,7,2,1,1,1,1,3,1,6,1,7,1,6,0,16,14,2,9,0,0,0,0,3,3,0,2,MEI
SULAWESI BARAT,POLEWALI MANDAR,CAMPALAGIAN,BOTTO,34,12,3,0,0,0,0,2,1,0,0,3,0,0,0,0,12,6,6,4,4,3,1,3,9,6,3,5,MEI
SULAWESI BARAT,POLEWALI MANDAR,CAMPALAGIAN,GATTUNGAN,95,70,15,5,0,0,0,15,0,0,12,0,5,4,1,2,13,13,0,2,1,1,0,0,24,0,24,15,MEI
SULAWESI BARAT,POLEWALI MANDAR,CAMPALAGIAN,PADANG TIMUR,98,21,17,16,9,6,6,2,8,0,14,1,19,11,8,11,21,6,15,0,11,8,3,5,0,0,0,0,MEI
SULAWESI BARAT,POLEWALI MANDAR,CAMPALAGIAN,PADANG,46,50,3,1,0,0,0,3,0,0,2,0,5,0,5,0,45,45,0,39,13,10,3,0,25,12,13,12,MEI
SULAWESI BARAT,POLEWALI MANDAR,CAMPALAGIAN,LAGI-AGI,46,44,7,0,0,0,0,4,3,0,7,0,8,1,7,1,14,10,4,1,1,0,1,0,28,17,11,9,MEI
SULAWESI BARAT,POLEWALI MANDAR,LIMBORO,LIMBORO,89,64,36,15,5,0,0,18,3,14,1,12,8,8,0,2,13,10,3,6,12,2,10,0,17,8,9,15,MEI
SULAWESI BARAT,POLEWALI MANDAR,LIMBORO,LEMBANG LEMBANG,53,16,3,0,0,0,0,1,2,0,0,2,3,3,0,0,10,10,0,8,6,0,6,0,3,1,2,2,MEI
SULAWESI BARAT,POLEWALI MANDAR,LIMBORO,TANDASURA,51,11,5,5,5,1,1,4,0,0,0,3,5,0,5,0,11,9,2,9,0,0,0,0,2,2,0,1,MEI
SULAWESI BARAT,POLEWALI MANDAR,LIMBORO,SAMASUNDU,57,64,60,13,5,4,3,23,25,1,10,18,10,10,0,10,10,6,4,5,4,1,3,0,0,0,0,0,MEI
SULAWESI BARAT,POLEWALI MANDAR,LIMBORO,NAPO,61,15,3,1,0,0,0,1,2,0,1,0,1,1,0,0,13,11,2,0,7,6,1,1,6,4,2,2,MEI
SULAWESI BARAT,POLEWALI MANDAR,LIMBORO,TODANG TODANG,77,75,28,24,0,0,0,15,4,7,18,4,12,0,12,0,51,21,30,3,38,13,25,11,54,1,53,46,MEI
SULAWESI BARAT,POLEWALI MANDAR,LIMBORO,PENDULANGAN,89,75,5,2,0,0,0,4,1,0,4,0,5,3,2,2,27,11,16,1,9,5,4,3,33,25,8,9,MEI
SULAWESI BARAT,POLEWALI MANDAR,LIMBORO,RENGGEANG,45,48,27,9,7,1,0,13,5,9,24,0,0,0,0,0,13,6,7,4,13,7,6,0,22,6,16,12,MEI
SULAWESI BARAT,POLEWALI MANDAR,LIMBORO,SALARRI,84,77,4,1,1,1,1,0,3,0,3,1,13,10,3,2,22,21,1,9,12,10,2,7,36,7,29,20,MEI
SULAWESI BARAT,POLEWALI MANDAR,LIMBORO,TANGAN BARU,54,68,37,21,15,14,1,21,6,3,3,2,0,0,0,0,62,46,16,34,12,8,4,6,50,17,33,46,MEI
SULAWESI BARAT,POLEWALI MANDAR,LIMBORO,PALECE,99,78,27,8,7,1,1,6,17,2,5,8,11,0,11,0,46,36,10,15,11,10,1,8,30,15,15,1,MEI
SULAWESI BARAT,POLEWALI MANDAR,LUYO,BATUPANGA,62,64,51,6,1,0,0,21,6,11,34,9,7,4,3,3,12,8,4,0,2,1,1,1,33,10,23,20,MEI
SULAWESI BARAT,POLEWALI MANDAR,LUYO,MAMBU,44,33,17,3,2,0,0,4,6,3,12,2,6,4,2,3,30,30,0,15,1,0,1,0,21,5,16,2,MEI
SULAWESI BARAT,POLEWALI MANDAR,LUYO,TENGGELANG,87,36,17,3,3,0,0,13,2,1,16,0,13,7,6,5,29,28,1,4,28,5,23,2,30,1,29,14,MEI
SULAWESI BARAT,POLEWALI MANDAR,LUYO,BARU,70,64,33,16,4,4,2,11,14,1,14,15,11,9,2,7,44,5,39,2,4,0,4,0,29,11,18,2,MEI
SULAWESI BARAT,POLEWALI MANDAR,LUYO,PUSSUI,63,45,39,31,17,3,0,10,7,19,10,13,0,0,0,0,25,20,5,2,23,8,15,7,38,5,33,26,MEI
SULAWESI BARAT,POLEWALI MANDAR,LUYO,MAPILI BARAT,31,73,0,0,0,0,0,0,0,0,0,0,0,0,0,0,13,5,8,0,11,11,0,7,21,21,0,10,MEI
SULAWESI BARAT,POLEWALI MANDAR,LUYO,SAMBALI WALI,64,53,0,0,0,0,0,0,0,0,0,0,7,0,7,0,49,35,14,5,3,1,2,0,16,2,14,0,MEI
SULAWESI BARAT,POLEWALI MANDAR,LUYO,BATUPANGA DAALA,39,73,62,4,3,3,3,57,2,0,23,23,7,4,3,1,46,29,17,20,10,7,3,4,34,3,31,0,MEI
SULAWESI BARAT,POLEWALI MANDAR,LUYO,LUYO,56,21,8,8,3,2,0,3,5,0,1,6,5,0,5,0,12,7,5,6,7,6,1,0,6,3,3,5,MEI
SULAWESI BARAT,POLEWALI MANDAR,LUYO,PUSSUI BARAT,32,76,19,12,0,0,0,4,2,9,9,0,5,4,1,3,71,46,25,5,10,3,7,0,1,0,1,0,MEI
SULAWESI BARAT,POLEWALI MANDAR,LUYO,PUCCADI,79,35,33,0,0,0,0,18,14,1,29,2,11,3,8,3,15,8,7,8,3,3,0,1,5,4,1,2,MEI
SULAWESI BARAT,POLEWALI MANDAR,MAPILLI,MAPILI,46,14,9,0,0,0,0,1,0,8,2,1,0,0,0,0,14,11,3,2,8,5,3,0,17,9,8,15,MEI
SULAWESI BARAT,POLEWALI MANDAR,MAPILLI,UGIBARU,31,56,50,32,14,9,3,9,5,18,10,0,5,3,2,3,50,5,45,2,10,1,9,0,43,18,25,22,MEI
SULAWESI BARAT,POLEWALI MANDAR,MAPILLI,RUMPA,93,24,23,3,2,2,0,19,0,1,8,14,2,0,2,0,17,16,1,1,7,5,2,3,15,14,1,13,MEI
SULAWESI BARAT,POLEWALI MANDAR,MAPILLI,KURMA,97,24,3,0,0,0,0,0,0,2,3,0,6,1,5,0,18,14,4,0,14,0,14,0,8,4,4,3,MEI
SULAWESI BARAT,POLEWALI MANDAR,MAPILLI,BUKU,33,27,22,14,7,2,2,8,6,4,8,13,6,4,2,4,17,9,8,5,3,3,0,3,13,8,5,11,MEI
SULAWESI BARAT,POLEWALI MANDAR,MAPILLI,BONNE BONNE,88,62,44,34,7,4,3,32,4,3,22,15,1,1,0,0,22,22,0,15,22,4,18,3,65,22,43,27,MEI
SULAWESI BARAT,POLEWALI MANDAR,MAPILLI,BEROANGIN,62,35,34,13,0,0,0,24,3,1,32,2,10,7,3,1,35,21,14,4,26,10,16,0,22,14,8,5,MEI
SULAWESI BARAT,POLEWALI MANDAR,MAPILLI,SEGERANG,75,62,7,3,2,2,0,7,0,0,2,5,0,0,0,0,48,26,22,21,43,33,10,5,68,48,20,42,MEI
SULAWESI BARAT,POLEWALI MANDAR,MAPILLI,BONRA,69,42,7,5,4,4,1,2,1,3,2,3,8,3,5,3,38,34,4,20,30,0,30,0,18,12,6,15,MEI
SULAWESI BARAT,POLEWALI MANDAR,MAPILLI,SATTOKO,60,10,10,0,0,0,0,2,6,1,8,2,8,4,4,0,10,7,3,0,10,6,4,4,10,9,1,4,MEI
SULAWESI BARAT,POLEWALI MANDAR,MAPILLI,RAPPANG BARAT,90,38,25,9,1,0,0,6,18,0,15,6,15,15,0,0,35,21,14,5,13,10,3,7,12,2,10,0,MEI
SULAWESI BARAT,POLEWALI MANDAR,MAPILLI,LANDI KANUSUANG,53,50,2,2,2,0,0,1,0,1,2,0,1,1,0,1,43,6,37,0,20,1,19,1,19,0,19,5,MEI
SULAWESI BARAT,POLEWALI MANDAR,MATAKALI,MATAKALI,42,47,19,15,1,0,0,6,0,4,16,2,5,3,2,1,41,11,30,6,26,26,0,1,42,34,8,36,MEI
SULAWESI BARAT,POLEWALI MANDAR,MATAKALI,PETAMPANUA,83,46,40,36,21,20,14,4,13,8,17,8,13,2,11,2,22,20,2,5,22,14,8,11,54,22,32,0,MEI
SULAWESI BARAT,POLEWALI MANDAR,MATAKALI,BARUMBUNG,35,25,2,0,0,0,0,1,0,1,0,2,1,0,1,0,23,11,12,7,10,5,5,3,20,2,18,15,MEI
SULAWESI BARAT,POLEWALI MANDAR,MATAKALI,PASIANG,95,52,29,4,3,3,2,26,1,0,16,2,0,0,0,0,32,29,3,13,29,4,25,3,63,48,15,45,MEI
SULAWESI BARAT,POLEWALI MANDAR,MATAKALI,TONROLIMA,99,70,70,28,19,15,11,7,39,11,27,28,7,1,6,0,21,10,11,2,16,8,8,1,63,0,63,30,MEI
SULAWESI BARAT,POLEWALI MANDAR,MATAKALI,INDOMAKKOMBONG,86,14,12,8,5,5,5,0,5,1,7,0,17,9,8,5,10,6,4,4,6,5,1,0,8,3,5,2,MEI
SULAWESI BARAT,POLEWALI MANDAR,MATAKALI,BUNGA-BUNGA,100,24,3,3,1,0,0,1,0,1,0,2,20,15,5,12,11,7,4,2,3,1,2,0,4,0,4,3,MEI
SULAWESI BARAT,POLEWALI MANDAR,MATANGNGA,MATANGNGA,69,57,3,3,0,0,0,3,0,0,3,0,13,9,4,3,33,12,21,2,33,11,22,8,51,39,12,12,MEI
SULAWESI BARAT,POLEWALI MANDAR,MATANGNGA,LILLI,59,27,16,13,0,0,0,2,1,3,0,6,11,7,4,1,26,5,21,2,13,10,3,2,3,1,2,2,MEI
SULAWESI BARAT,POLEWALI MANDAR,MATANGNGA,RANGOAN,55,38,17,7,7,3,3,3,11,0,9,7,10,8,2,2,17,14,3,13,11,4,7,2,5,5,0,1,MEI
SULAWESI BARAT,POLEWALI MANDAR,MATANGNGA,TAPUA,100,46,9,7,3,1,1,0,0,5,8,1,8,2,6,2,20,8,12,1,13,9,4,7,20,15,5,1,MEI
SULAWESI BARAT,POLEWALI MANDAR,MATANGNGA,MAMBU TAPUA,53,61,30,29,29,28,10,10,10,0,14,6,1,0,1,0,21,16,5,1,8,0,8,0,6,6,0,1,MEI
SULAWESI BARAT,POLEWALI MANDAR,MATANGNGA,BA'BA TAPUA,99,47,22,6,2,1,0,9,12,0,20,2,15,9,6,9,16,13,3,8,15,15,0,11,29,12,17,10,MEI
SULAWESI BARAT,POLEWALI MANDAR,MATANGNGA,KATIMBANG,71,47,34,11,1,0,0,18,0,0,12,14,7,6,1,6,15,10,5,6,15,3,12,3,40,31,9,30,MEI
SULAWESI BARAT,POLEWALI MANDAR,POLEWALI,POLEWALI,60,19,4,1,1,0,0,3,1,0,1,2,7,7,0,3,15,15,0,12,15,12,3,6,3,3,0,3,MEI
SULAWESI BARAT,POLEWALI MANDAR,POLEWALI,WATTANG,35,75,63,55,16,13,9,33,6,12,59,4,4,4,0,0,74,73,1,6,47,22,25,8,88,73,15,52,MEI
SULAWESI BARAT,POLEWALI MANDAR,POLEWALI,SULEWATANG,41,80,6,3,2,2,1,1,4,0,3,3,8,6,2,6,65,20,45,0,46,17,29,1,96,42,54,6,MEI
SULAWESI BARAT,POLEWALI MANDAR,POLEWALI,LANTORA,78,49,14,5,5,1,0,13,0,0,12,2,6,0,6,0,25,5,20,1,20,14,6,13,10,1,9,6,MEI
SULAWESI BARAT,POLEWALI MANDAR,POLEWALI,TAKATIDUNG,51,22,5,1,1,0,0,0,5,0,4,1,0,0,0,0,17,9,8,8,1,1,0,1,4,3,1,1,MEI
SULAWESI BARAT,POLEWALI MANDAR,POLEWALI,PEKKABATA,70,59,29,5,4,4,2,15,12,0,6,17,4,4,0,2,23,23,0,4,11,10,1,1,34,34,0,1,MEI
SULAWESI BARAT,POLEWALI MANDAR,POLEWALI,MADATE,47,33,3,0,0,0,0,0,3,0,1,2,2,2,0,1,14,13,1,3,8,6,2,5,9,0,9,1,MEI
SULAWESI BARAT,POLEWALI MANDAR,POLEWALI,MANDING,55,66,32,29,14,14,4,22,0,6,17,9,10,6,4,0,14,5,9,3,7,2,5,0,24,17,7,24,MEI
SULAWESI BARAT,POLEWALI MANDAR,POLEWALI,DARMA,61,48,12,3,0,0,0,8,3,0,3,4,6,6,0,4,27,17,10,11,7,4,3,3,37,1,36,0,MEI
SULAWESI BARAT,POLEWALI MANDAR,TAPANGO,PELITAKAN,59,53,33,19,6,6,3,27,1,0,10,19,10,0,10,0,29,15,14,7,21,2,19,0,0,0,0,0,MEI
SULAWESI BARAT,POLEWALI MANDAR,TAPANGO,TAPANGO,50,55,7,7,2,0,0,3,3,1,5,2,9,4,5,2,21,17,4,3,13,4,9,1,1,1,0,1,MEI
SULAWESI BARAT,POLEWALI MANDAR,TAPANGO,RAPPANG,92,34,15,7,4,1,1,3,7,4,10,2,5,5,0,2,15,7,8,6,5,2,3,1,20,9,11,9,MEI
SULAWESI BARAT,POLEWALI MANDAR,TAPANGO,DAKKA,55,66,4,1,1,1,0,1,1,2,2,0,7,6,1,3,59,45,14,39,10,9,1,3,28,9,19,6,MEI
SULAWESI BARAT,POLEWALI MANDAR,TAPANGO,BATU,46,35,35,18,6,6,0,22,5,0,1,3,4,1,3,1,21,14,7,9,1,1,0,0,25,21,4,3,MEI
SULAWESI BARAT,POLEWALI MANDAR,TAPANGO,RISO,80,12,3,3,3,0,0,0,0,3,0,0,9,0,9,0,12,11,1,5,2,2,0,2,3,0,3,2,MEI
SULAWESI BARAT,POLEWALI MANDAR,TAPANGO,PALATTA,50,17,11,11,8,3,2,8,0,1,0,2,0,0,0,0,10,10,0,1,3,1,2,0,12,5,7,0,MEI
SULAWESI BARAT,POLEWALI MANDAR,TAPANGO,TAPANGO BARAT,55,21,1,0,0,0,0,0,1,0,1,0,0,0,0,0,15,10,5,4,5,1,4,1,12,11,1,3,MEI
SULAWESI BARAT,POLEWALI MANDAR,TAPANGO,KURRAK,59,44,31,16,9,5,0,9,17,1,1,9,9,9,0,4,11,11,0,7,7,7,0,4,10,5,5,6,MEI
SULAWESI BARAT,POLEWALI MANDAR,TAPANGO,BUSSU,56,37,0,0,0,0,0,0,0,0,0,0,2,2,0,2,26,22,4,0,20,0,20,0,36,33,3,21,MEI
SULAWESI BARAT,POLEWALI MANDAR,TAPANGO,TUTTULA,48,77,40,25,8,5,1,19,18,1,36,1,9,2,7,1,11,5,6,5,2,2,0,1,0,0,0,0,MEI
SULAWESI BARAT,POLEWALI MANDAR,TAPANGO,JAMBU MALEA,47,29,19,1,0,0,0,13,4,2,4,5,2,0,2,0,25,14,11,14,9,3,6,0,21,13,8,18,MEI
SULAWESI BARAT,POLEWALI MANDAR,TAPANGO,KALIMBUA,62,55,44,35,1,1,0,10,25,5,14,12,7,3,4,2,45,43,2,41,20,8,12,1,31,4,27,10,MEI
SULAWESI BARAT,POLEWALI MANDAR,TAPANGO,BANATO REJO,96,20,19,14,7,6,0,0,15,2,0,6,1,0,1,0,16,11,5,11,6,0,6,0,2,0,2,1,MEI
SULAWESI BARAT,POLEWALI MANDAR,TINAMBUNG,TINAMBUNG,80,66,27,19,7,3,1,19,1,1,21,2,11,0,11,0,30,28,2,16,18,7,11,6,27,1,26,25,MEI
SULAWESI BARAT,POLEWALI MANDAR,TINAMBUNG,KARAMA,73,80,53,8,5,3,0,39,1,4,42,5,0,0,0,0,60,35,25,15,37,31,6,16,53,48,5,48,MEI
SULAWESI BARAT,POLEWALI MANDAR,TINAMBUNG,TANGNGA TANGNGA,81,79,61,28,20,13,8,7,3,42,33,7,9,7,2,3,21,12,9,5,15,5,10,0,0,0,0,0,MEI
SULAWESI BARAT,POLEWALI MANDAR,TINAMBUNG,LEKOPADIS,79,50,27,14,6,6,4,0,2,5,10,2,9,0,9,0,15,9,6,8,12,7,5,3,15,9,6,5,MEI
SULAWESI BARAT,POLEWALI MANDAR,TINAMBUNG,GALUNG LOMBOK,70,17,1,0,0,0,0,1,0,0,1,0,6,3,3,1,17,15,2,13,2,0,2,0,1,0,1,1,MEI
SULAWESI BARAT,POLEWALI MANDAR,TINAMBUNG,TANDUNG,63,57,23,9,4,3,1,20,1,0,5,4,1,0,1,0,18,14,4,13,4,4,0,0,28,19,9,3,MEI
SULAWESI BARAT,POLEWALI MANDAR,TINAMBUNG,BATULAYA,48,59,53,20,10,3,3,11,13,9,49,2,4,4,0,0,25,17,8,4,18,9,9,8,17,7,10,4,MEI
SULAWESI BARAT,POLEWALI MANDAR,TINAMBUNG,SEPABATU,81,33,17,11,9,3,2,13,1,1,1,7,0,0,0,0,16,13,3,12,14,0,14,0,14,2,12,2,MEI
SULAWESI BARAT,POLEWALI MANDAR,TUTAR,TARAMANU,51,60,57,55,32,16,7,36,3,4,47,4,3,0,3,0,55,50,5,11,26,17,9,16,34,20,14,18,MEI
SULAWESI BARAT,POLEWALI MANDAR,TUTAR,AMBOPADANG,61,74,70,35,27,10,6,37,23,0,35,32,6,4,2,3,18,17,1,1,9,1,8,1,36,0,36,2,MEI
SULAWESI BARAT,POLEWALI MANDAR,TUTAR,TUBBI,57,79,7,5,3,3,3,2,1,0,4,0,3,2,1,0,23,14,9,14,20,1,19,1,0,0,0,0,MEI
SULAWESI BARAT,POLEWALI MANDAR,TUTAR,RATTE,44,15,8,6,3,3,1,6,1,0,0,5,0,0,0,0,14,8,6,4,9,8,1,7,19,11,8,7,MEI
SULAWESI BARAT,POLEWALI MANDAR,TUTAR,BESOANGIN,99,31,17,8,0,0,0,2,1,9,1,14,18,18,0,8,25,23,2,16,24,3,21,3,45,30,15,36,MEI
SULAWESI BARAT,POLEWALI MANDAR,TUTAR,PIRIANG TAPIKO,38,47,18,0,0,0,0,18,0,0,1,9,6,4,2,0,23,12,11,6,2,1,1,1,8,1,7,8,MEI
SULAWESI BARAT,POLEWALI MANDAR,TUTAR,PEBURRU,44,16,10,7,1,1,1,3,1,2,3,2,7,2,5,2,12,12,0,11,2,2,0,2,8,1,7,5,MEI
SULAWESI BARAT,POLEWALI MANDAR,TUTAR,TALOBA,86,47,0,0,0,0,0,0,0,0,0,0,3,3,0,0,10,9,1,3,1,0,1,0,0,0,0,0,MEI
SULAWESI BARAT,POLEWALI MANDAR,TUTAR,POLLEWANI,74,23,18,0,0,0,0,18,0,0,11,7,8,8,0,1,21,21,0,0,14,9,5,0,28,0,28,5,MEI
SULAWESI BARAT,POLEWALI MANDAR,TUTAR,ARABUA,98,34,25,16,12,6,6,6,12,1,5,3,13,9,4,1,33,13,20,0,33,3,30,3,22,9,13,0,MEI
SULAWESI BARAT,POLEWALI MANDAR,TUTAR,BESOANGIN UTARA,80,28,13,1,0,0,0,10,1,2,7,3,16,13,3,3,14,10,4,5,12,6,6,1,29,18,11,19,MEI
SULAWESI BARAT,POLEWALI MANDAR,TUTAR,PODA,31,76,51,50,20,10,6,27,3,9,25,24,0,0,0,0,75,74,1,28,10,1,9,1,25,16,9,25,MEI
SULAWESI BARAT,POLEWALI MANDAR,TUTAR,TARAMANU TUA,91,64,17,13,11,8,3,0,11,3,5,3,0,0,0,0,10,9,1,3,0,0,0,0,2,1,1,1,MEI
SULAWESI BARAT,POLEWALI MANDAR,WONOMULYO,SIDODADI,78,35,11,5,4,1,1,5,5,0,7,0,7,4,3,3,33,25,8,20,8,3,5,3,16,13,3,12,MEI
SULAWESI BARAT,POLEWALI MANDAR,WONOMULYO,SIDOREJO,93,40,24,6,5,0,0,5,11,1,20,0,3,3,0,2,26,6,20,1,20,1,19,0,6,1,5,4,MEI
SULAWESI BARAT,POLEWALI MANDAR,WONOMULYO,SUMBEREJO,97,38,35,0,0,0,0,21,7,2,19,13,0,0,0,0,38,32,6,2,6,0,6,0,11,3,8,0,MEI
SULAWESI BARAT,POLEWALI MANDAR,WONOMULYO,BUMIAYU,30,73,21,0,0,0,0,9,2,8,16,0,2,2,0,1,60,18,42,1,4,0,4,0,27,2,25,15,MEI
SULAWESI BARAT,POLEWALI MANDAR,WONOMULYO,KEBUNSARI,93,19,5,5,3,1,1,0,0,3,0,1,18,8,10,4,10,5,5,4,5,1,4,1,9,1,8,4,MEI
SULAWESI BARAT,POLEWALI MANDAR,WONOMULYO,BANUA BARU,68,51,20,10,5,3,0,9,2,8,0,7,11,8,3,8,50,21,29,4,7,4,3,1,34,31,3,20,MEI
SULAWESI BARAT,POLEWALI MANDAR,WONOMULYO,NEPO,61,52,34,5,4,4,1,4,9,0,30,3,4,3,1,2,28,13,15,2,22,19,3,2,24,7,17,16,MEI
SULAWESI BARAT,POLEWALI MANDAR,WONOMULYO,SUGIHWARAS,62,70,45,2,0,0,0,24,5,9,30,2,3,3,0,1,31,7,24,5,27,0,27,0,52,17,35,52,MEI
SULAWESI BARAT,POLEWALI MANDAR,WONOMULYO,CAMPURJO,71,30,6,1,0,0,0,4,2,0,0,6,1,1,0,1,20,16,4,10,6,6,0,6,1,0,1,0,MEI
SULAWESI BARAT,POLEWALI MANDAR,WONOMULYO,BUMIMULYO,65,44,26,23,10,4,1,8,10,7,1,20,10,2,8,2,22,8,14,1,13,10,3,4,20,15,5,12,MEI
SULAWESI BARAT,POLEWALI MANDAR,WONOMULYO,TUMPILING,94,46,44,15,13,9,3,31,2,8,42,1,15,9,6,0,17,10,7,8,16,3,13,1,12,12,0,6,MEI
SULAWESI BARAT,POLEWALI MANDAR,WONOMULYO,BAKKA-BAKKA,37,24,17,3,3,1,1,6,8,1,13,3,3,1,2,1,14,6,8,0,3,2,1,0,4,3,1,4,MEI
SULAWESI BARAT,POLEWALI MANDAR,WONOMULYO,ARJO SARI,95,17,4,3,3,0,0,1,1,2,3,1,3,1,2,0,11,10,1,2,5,2,3,0,15,10,5,9,MEI
SULAWESI BARAT,POLEWALI MANDAR,WONOMULYO,GALESON,77,38,11,11,8,8,4,3,0,2,4,6,4,1,3,0,31,19,12,3,5,0,5,0,7,0,7,6,MEI
SULAWESI BARAT,MAMUJU,MAMUJU,BINANGA,69,51,50,20,0,0,0,47,2,1,32,6,13,8,5,8,18,16,2,2,5,2,3,1,16,6,10,4,MEI
SULAWESI BARAT,MAMUJU,MAMUJU,MAMUNYU,78,54,9,8,5,4,2,7,0,0,0,3,7,2,5,2,29,22,7,1,1,1,0,0,35,28,7,4,MEI
SULAWESI BARAT,MAMUJU,MAMUJU,KAREMA,97,66,16,6,1,1,1,1,9,4,8,0,10,6,4,3,19,13,6,7,2,1,1,1,37,24,13,7,MEI
SULAWESI BARAT,MAMUJU,MAMUJU,RIMUKU,51,12,6,6,1,1,1,4,0,1,3,1,1,1,0,1,10,5,5,3,1,1,0,0,4,2,2,2,MEI
SULAWESI BARAT,MAMUJU,MAMUJU,BAMBU,95,56,10,5,1,1,1,3,3,0,1,5,2,0,2,0,19,15,4,1,16,7,9,4,41,6,35,25,MEI
SULAWESI BARAT,MAMUJU,MAMUJU,KARAMPUANG,76,43,4,2,0,0,0,1,2,0,0,2,13,11,2,11,14,14,0,8,3,0,3,0,14,3,11,14,MEI
SULAWESI BARAT,MAMUJU,MAMUJU,TADUI,64,23,9,6,2,0,0,5,4,0,0,4,8,4,4,1,22,7,15,2,3,3,0,2,6,5,1,1,MEI
SULAWESI BARAT,MAMUJU,MAMUJU,BATU PANNU,44,57,11,3,1,1,0,7,3,1,5,4,0,0,0,0,31,13,18,10,14,5,9,4,42,0,42,25,MEI
SULAWESI BARAT,MAMUJU,TAPALANG,GALUNG,80,69,6,3,1,1,1,4,1,0,2,4,3,2,1,1,30,18,12,2,5,5,0,4,15,10,5,2,MEI
SULAWESI BARAT,MAMUJU,TAPALANG,KASAMBANG,95,72,7,4,2,0,0,1,3,3,1,0,13,12,1,3,54,30,24,13,12,9,3,1,57,1,56,11,MEI
SULAWESI BARAT,MAMUJU,TAPALANG,DAYANGINNA,35,18,13,3,0,0,0,5,7,0,1,7,2,2,0,1,12,5,7,4,1,0,1,0,5,3,2,5,MEI
SULAWESI BARAT,MAMUJU,TAPALANG,OROBATU,91,64,11,2,2,1,0,7,1,1,7,1,12,2,10,0,37,21,16,18,28,7,21,2,26,16,10,7,MEI
SULAWESI BARAT,MAMUJU,TAPALANG,TAKANDEANG,95,77,12,5,5,4,2,0,2,3,4,5,6,4,2,1,73,59,14,59,37,23,14,2,23,2,21,6,MEI
SULAWESI BARAT,MAMUJU,TAPALANG,BELA,39,79,13,8,7,3,1,11,0,1,11,2,7,7,0,5,75,58,17,48,42,3,39,1,45,0,45,18,MEI
SULAWESI BARAT,MAMUJU,TAPALANG,TAAN,87,11,5,4,3,1,0,3,2,0,2,0,14,14,0,1,11,6,5,0,1,0,1,0,3,0,3,0,MEI
SULAWESI BARAT,MAMUJU,TAPALANG,TAMPALANG,96,80,24,5,2,1,0,17,6,0,13,6,17,11,6,4,60,48,12,5,28,28,0,6,14,8,6,4,MEI
SULAWESI BARAT,MAMUJU,TAPALANG,RANTEDODA,70,76,74,69,9,3,2,10,53,1,51,20,8,3,5,2,36,21,15,6,15,4,11,3,48,2,46,46,MEI
SULAWESI BARAT,MAMUJU,TAPALANG,KOPEANG,78,62,59,36,14,10,7,4,21,25,41,13,15,9,6,2,54,9,45,4,40,9,31,0,44,19,25,32,MEI
SULAWESI BARAT,MAMUJU,KALUKKU,SINYONYOI,94,73,20,16,16,13,5,6,3,4,14,2,11,5,6,1,66,21,45,7,35,20,15,14,79,44,35,55,MEI
SULAWESI BARAT,MAMUJU,KALUKKU,BEBANGA,57,71,68,21,20,0,0,2,40,1,19,6,7,4,3,2,36,7,29,6,3,1,2,1,45,32,13,40,MEI
SULAWESI BARAT,MAMUJU,KALUKKU,KALUKKU,57,68,34,27,14,14,10,24,0,0,31,3,5,2,3,2,33,22,11,2,30,10,20,3,50,43,7,8,MEI
SULAWESI BARAT,MAMUJU,KALUKKU,SINYONYOI SELATAN,55,34,28,27,19,9,0,21,5,1,17,1,3,1,2,0,25,5,20,0,17,4,13,1,35,14,21,22,MEI
SULAWESI BARAT,MAMUJU,KALUKKU,SONDOANG,96,32,22,12,4,4,4,8,8,1,3,4,10,9,1,8,31,14,17,8,4,3,1,1,7,5,2,5,MEI
SULAWESI BARAT,MAMUJU,KALUKKU,BERU-BERU,31,28,26,26,6,1,0,20,1,2,12,2,3,1,2,0,21,8,13,8,11,2,9,0,28,20,8,25,MEI
SULAWESI BARAT,MAMUJU,KALUKKU,BELANG BELANG,74,64,48,25,20,3,1,44,2,1,23,11,13,10,3,0,59,59,0,43,54,27,27,27,61,7,54,21,MEI
SULAWESI BARAT,MAMUJU,KALUKKU,KABULOANG,96,70,54,15,0,0,0,45,2,3,14,3,1,0,1,0,57,28,29,13,30,13,17,6,33,8,25,8,MEI
SULAWESI BARAT,MAMUJU,KALUKKU,KEANG,40,79,22,9,0,0,0,5,7,0,4,2,6,2,4,1,31,11,20,10,8,4,4,3,22,11,11,0,MEI
SULAWESI BARAT,MAMUJU,KALUKKU,POKKANG,63,44,15,9,0,0,0,2,5,7,0,13,12,3,9,2,15,13,2,12,13,4,9,4,27,0,27,10,MEI
SULAWESI BARAT,MAMUJU,KALUKKU,GULILING,81,75,46,40,21,3,2,36,0,7,40,6,14,13,1,4,17,12,5,4,3,3,0,0,36,32,4,12,MEI
SULAWESI BARAT,MAMUJU,KALUKKU,UHAIMATE,56,17,1,1,0,0,0,1,0,0,0,0,0,0,0,0,12,10,2,1,9,1,8,1,0,0,0,0,MEI
SULAWESI BARAT,MAMUJU,KALUKKU,KALUKKU BARAT,65,54,5,0,0,0,0,2,0,1,4,1,3,0,3,0,34,19,15,10,7,4,3,0,3,0,3,1,MEI
SULAWESI BARAT,MAMUJU,KALUKKU,PAMMULUKANG,77,44,43,42,37,3,2,17,24,0,18,10,9,8,1,0,40,22,18,15,16,3,13,3,14,9,5,1,MEI
SULAWESI BARAT,MAMUJU,KALUMPANG,KALUMPANG,43,51,29,2,0,0,0,24,0,3,19,1,6,3,3,1,14,5,9,3,9,0,9,0,4,1,3,2,MEI
SULAWESI BARAT,MAMUJU,KALUMPANG,KARATAUN,37,44,31,29,25,14,12,4,6,1,30,1,2,2,0,2,25,14,11,7,20,9,11,3,15,15,0,2,MEI
SULAWESI BARAT,MAMUJU,KALUMPANG,KARAMA,39,44,12,11,7,4,1,6,0,3,6,3,2,0,2,0,39,11,28,6,20,6,14,6,22,13,9,20,MEI
SULAWESI BARAT,MAMUJU,KALUMPANG,SIRAUN,37,67,44,0,0,0,0,22,18,4,41,1,0,0,0,0,41,16,25,1,41,16,25,0,51,46,5,31,MEI
SULAWESI BARAT,MAMUJU,KALUMPANG,TUMOGA,65,41,25,17,7,2,1,7,14,2,6,14,12,2,10,0,11,9,2,6,10,7,3,3,19,7,12,13,MEI
SULAWESI BARAT,MAMUJU,KALUMPANG,SALUMAKKI,33,27,12,0,0,0,0,3,6,2,8,4,1,0,1,0,24,7,17,0,9,9,0,0,9,0,9,2,MEI
SULAWESI BARAT,MAMUJU,KALUMPANG,POLIO,53,16,10,2,0,0,0,9,0,0,5,3,6,4,2,0,11,11,0,10,7,7,0,7,4,0,4,1,MEI
SULAWESI BARAT,MAMUJU,KALUMPANG,LIMBONG,66,46,9,7,7,7,5,0,3,0,6,2,0,0,0,0,15,13,2,8,10,5,5,1,24,24,0,21,MEI
SULAWESI BARAT,MAMUJU,KALUMPANG,SANDAPANG,46,39,20,14,9,0,0,7,2,9,3,16,6,3,3,3,19,14,5,5,4,2,2,1,29,4,25,13,MEI
SULAWESI BARAT,MAMUJU,KALUMPANG,KONDO BULO,84,25,13,11,8,0,0,13,0,0,3,8,2,1,1,0,17,16,1,15,1,1,0,0,5,4,1,5,MEI
SULAWESI BARAT,MAMUJU,KALUMPANG,MAKKALIKI,54,52,12,6,1,1,1,9,2,0,11,0,8,0,8,0,17,11,6,8,16,12,4,10,9,2,7,9,MEI
SULAWESI BARAT,MAMUJU,KALUMPANG,BATU MAKKADA,76,56,6,5,2,1,0,0,6,0,4,2,6,0,6,0,55,54,1,8,45,36,9,0,23,11,12,9,MEI
SULAWESI BARAT,MAMUJU,KALUMPANG,LASA',91,67,51,44,30,11,9,40,1,1,40,8,16,10,6,10,25,7,18,4,21,0,21,0,43,34,9,13,MEI
SULAWESI BARAT,MAMUJU,PAPALANG,TOABO,43,26,2,2,1,0,0,2,0,0,1,0,0,0,0,0,15,6,9,5,13,10,3,2,28,21,7,8,MEI
SULAWESI BARAT,MAMUJU,PAPALANG,PAPALANG,40,36,15,5,1,0,0,6,3,4,2,1,7,2,5,0,19,9,10,1,16,5,11,2,5,1,4,3,MEI
SULAWESI BARAT,MAMUJU,PAPALANG,BONDA,89,60,20,0,0,0,0,20,0,0,8,0,4,4,0,1,20,10,10,4,7,2,5,1,2,1,1,2,MEI
SULAWESI BARAT,MAMUJU,PAPALANG,TOPORE,92,27,1,1,0,0,0,0,0,0,1,0,9,1,8,1,24,7,17,4,17,2,15,2,17,14,3,13,MEI
SULAWESI BARAT,MAMUJU,PAPALANG,SALUKAYU,61,12,12,7,3,3,3,1,8,0,7,3,1,1,0,1,10,9,1,9,2,1,1,1,5,4,1,4,MEI
SULAWESI BARAT,MAMUJU,PAPALANG,SUKADAMAI,48,52,19,11,1,1,1,10,6,1,1,15,8,0,8,0,30,12,18,12,4,1,3,1,4,2,2,2,MEI
SULAWESI BARAT,MAMUJU,PAPALANG,BODA-BODA,68,73,25,4,3,2,2,7,9,3,6,7,4,0,4,0,33,10,23,5,12,6,6,1,22,13,9,4,MEI
SULAWESI BARAT,MAMUJU,PAPALANG,SISANGO,40,26,24,17,0,0,0,0,3,4,0,6,6,5,1,0,20,11,9,1,17,12,5,9,31,1,30,22,MEI
SULAWESI BARAT,MAMUJU,PAPALANG,BATU AMPA,41,65,9,2,2,1,1,6,0,0,3,4,7,2,5,2,20,7,13,4,12,9,3,7,4,0,4,0,MEI
SULAWESI BARAT,MAMUJU,SAMPAGA,BUNDE,94,73,11,11,11,7,4,5,1,0,0,6,4,4,0,0,69,68,1,41,4,4,0,1,34,16,18,28,MEI
SULAWESI BARAT,MAMUJU,SAMPAGA,KALONDING,31,76,16,11,3,1,1,12,3,0,15,0,2,2,0,2,41,23,18,19,37,2,35,1,33,1,32,1,MEI
SULAWESI BARAT,MAMUJU,SAMPAGA,TARAILU,33,45,42,39,3,2,1,24,7,5,30,2,2,2,0,2,42,13,29,2,15,4,11,3,7,2,5,3,MEI
SULAWESI BARAT,MAMUJU,SAMPAGA,SAMPAGA,42,80,17,11,4,1,0,3,4,7,0,3,4,1,3,0,37,5,32,2,6,1,5,1,26,8,18,16,MEI
SULAWESI BARAT,MAMUJU,SAMPAGA,TANAMBUAH,35,26,3,2,0,0,0,2,0,0,1,1,3,2,1,0,23,7,16,4,7,2,5,1,5,2,3,2,MEI
SULAWESI BARAT,MAMUJU,SAMPAGA,SALUBARANA,48,69,15,3,3,0,0,5,10,0,12,2,3,2,1,1,39,26,13,10,38,19,19,12,27,9,18,7,MEI
SULAWESI BARAT,MAMUJU,SAMPAGA,LOSSO,51,66,39,15,0,0,0,15,14,0,32,3,5,5,0,2,10,5,5,4,6,2,4,0,27,9,18,6,MEI
SULAWESI BARAT,MAMUJU,TOMMO,TOMMO,61,25,10,2,1,0,0,2,7,0,2,7,8,4,4,4,18,12,6,2,1,1,0,0,8,4,4,6,MEI
SULAWESI BARAT,MAMUJU,TOMMO,CAMPALOGA,73,79,22,10,1,0,0,5,10,2,20,1,13,6,7,3,44,41,3,12,8,8,0,6,15,12,3,14,MEI
SULAWESI BARAT,MAMUJU,TOMMO,BUANA SAKTI,81,32,22,17,13,11,2,17,1,1,18,0,10,0,10,0,30,6,24,6,25,8,17,2,11,6,5,10,MEI
SULAWESI BARAT,MAMUJU,TOMMO,TAMEMONGGA,87,57,51,23,5,0,0,7,37,6,35,16,13,11,2,9,19,10,9,2,7,1,6,0,41,5,36,31,MEI
SULAWESI BARAT,MAMUJU,TOMMO,TAMEJARRA,82,68,57,22,22,3,3,9,33,3,17,5,3,3,0,3,58,47,11,38,15,2,13,1,47,6,41,13,MEI
SULAWESI BARAT,MAMUJU,TOMMO,RANTEMARIO,45,35,3,3,3,1,1,2,0,0,1,0,7,4,3,1,13,5,8,2,4,2,2,1,20,15,5,2,MEI
SULAWESI BARAT,MAMUJU,TOMMO,MALINO,57,52,2,1,1,1,1,0,1,0,0,2,5,2,3,1,42,36,6,14,39,38,1,5,33,14,19,13,MEI
SULAWESI BARAT,MAMUJU,TOMMO,KAKULLASANG,88,25,4,1,0,0,0,1,0,3,4,0,17,7,10,5,12,5,7,0,6,6,0,4,8,0,8,7,MEI
SULAWESI BARAT,MAMUJU,TOMMO,LELING,54,37,37,26,24,20,10,25,2,0,19,18,4,1,3,1,24,12,12,9,14,9,5,6,34,27,7,1,MEI
SULAWESI BARAT,MAMUJU,TOMMO,KALEPU,78,58,55,29,6,5,1,45,8,0,36,14,7,0,7,0,57,18,39,18,16,10,6,10,28,11,17,0,MEI
SULAWESI BARAT,MAMUJU,TOMMO,SANDANA,72,58,5,0,0,0,0,5,0,0,5,0,8,1,7,0,10,6,4,5,4,0,4,0,10,5,5,8,MEI
SULAWESI BARAT,MAMUJU,TOMMO,LELING BARAT,55,26,24,21,8,8,2,13,7,0,4,8,5,0,5,0,14,10,4,10,1,0,1,0,15,6,9,8,MEI
SULAWESI BARAT,MAMUJU,TOMMO,LELING UTARA,82,75,56,42,0,0,0,22,25,0,45,0,2,0,2,0,39,5,34,5,6,0,6,0,10,9,1,1,MEI
SULAWESI BARAT,MAMUJU,TOMMO,SALUDENGEN,99,37,18,6,4,1,1,13,0,0,6,9,12,6,6,1,30,19,11,12,4,3,1,1,1,1,0,1,MEI
SULAWESI BARAT,MAMUJU,SIMBORO DAN KEPULAUAN,SIMBORO,78,13,13,8,2,1,0,5,2,4,6,4,10,3,7,2,13,6,7,2,12,10,2,0,19,5,14,14,MEI
SULAWESI BARAT,MAMUJU,SIMBORO DAN KEPULAUAN,RANGAS,36,17,12,6,2,2,0,3,0,3,11,1,6,1,5,1,17,7,10,2,1,0,1,0,12,2,10,11,MEI
SULAWESI BARAT,MAMUJU,SIMBORO DAN KEPULAUAN,BOTTENG,93,35,15,8,7,7,6,5,3,0,5,10,1,0,1,0,26,10,16,4,13,2,11,2,32,1,31,19,MEI
SULAWESI BARAT,MAMUJU,SIMBORO DAN KEPULAUAN,SALETTO,30,28,20,2,0,0,0,18,2,0,18,2,6,4,2,1,23,7,16,4,17,5,12,2,25,21,4,24,MEI
SULAWESI BARAT,MAMUJU,SIMBORO DAN KEPULAUAN,SUMARE,85,54,43,39,26,2,0,2,25,0,28,7,14,10,4,7,51,31,20,15,23,5,18,1,27,7,20,11,MEI
SULAWESI BARAT,MAMUJU,SIMBORO DAN KEPULAUAN,BOTTENG UTARA,76,11,0,0,0,0,0,0,0,0,0,0,10,8,2,5,11,6,5,0,8,1,7,1,1,1,0,1,MEI
SULAWESI BARAT,MAMUJU,SIMBORO DAN KEPULAUAN,TAPANDULLU,84,74,35,9,0,0,0,21,7,6,1,31,7,3,4,1,59,29,30,28,3,2,1,1,6,2,4,5,MEI
SULAWESI BARAT,MAMUJU,SIMBORO DAN KEPULAUAN,PATI'DI,59,22,0,0,0,0,0,0,0,0,0,0,7,2,5,0,12,6,6,1,0,0,0,0,15,3,12,0,MEI
SULAWESI BARAT,MAMUJU,TAPALANG BARAT,DUNGKAIT,38,74,5,0,0,0,0,4,0,0,2,1,6,0,6,0,67,41,26,37,31,5,26,2,75,48,27,41,MEI
SULAWESI BARAT,MAMUJU,TAPALANG BARAT,LEBANI,72,63,34,27,7,2,1,6,24,3,11,23,9,3,6,0,11,7,4,7,2,1,1,0,31,24,7,24,MEI
SULAWESI BARAT,MAMUJU,TAPALANG BARAT,LABUANG RANO,90,41,38,8,1,1,1,34,2,0,36,0,16,4,12,3,41,32,9,31,41,1,40,1,37,30,7,12,MEI
SULAWESI BARAT,MAMUJU,TAPALANG BARAT,PASABU,67,53,14,4,2,0,0,12,1,1,8,6,7,5,2,3,43,13,30,5,2,2,0,0,7,7,0,1,MEI
SULAWESI BARAT,MAMUJU,TAPALANG BARAT,TANETE PAO,50,51,10,2,0,0,0,0,0,3,10,0,4,0,4,0,43,15,28,9,30,7,23,4,31,10,21,16,MEI
SULAWESI BARAT,MAMUJU,TAPALANG BARAT,PANGASAAN,46,69,30,6,6,5,0,15,11,4,12,16,2,0,2,0,59,32,27,14,34,26,8,8,31,23,8,24,MEI
SULAWESI BARAT,MAMUJU,TAPALANG BARAT,AHU,70,47,23,5,0,0,0,6,0,4,0,8,6,6,0,0,46,41,5,28,38,31,7,28,64,62,2,40,MEI
SULAWESI BARAT,MAMUJU,BONEHAU,BONEHAU,61,17,15,4,3,3,0,11,0,3,2,8,12,9,3,8,11,7,4,3,2,0,2,0,10,4,6,7,MEI
SULAWESI BARAT,MAMUJU,BONEHAU,SALUTIWO,94,73,5,0,0,0,0,5,0,0,3,1,14,9,5,1,37,9,28,0,35,31,4,24,23,17,6,1,MEI
SULAWESI BARAT,MAMUJU,BONEHAU,BUTTUADA,47,45,23,20,1,1,1,10,12,0,21,0,6,1,5,1,29,6,23,4,0,0,0,0,8,7,1,2,MEI
SULAWESI BARAT,MAMUJU,BONEHAU,TAMALEA,39,25,6,1,1,0,0,2,0,1,1,3,5,2,3,1,19,11,8,3,10,0,10,0,13,1,12,2,MEI
SULAWESI BARAT,MAMUJU,BONEHAU,LUMIKA,89,22,22,3,1,0,0,11,10,1,2,20,16,12,4,4,20,7,13,3,7,6,1,6,11,5,6,1,MEI
SULAWESI BARAT,MAMUJU,BONEHAU,MAPPU,35,36,5,4,3,3,3,0,1,1,2,0,7,2,5,0,10,8,2,7,7,3,4,2,15,8,7,0,MEI
SULAWESI BARAT,MAMUJU,BONEHAU,BANUADA,63,13,8,3,3,0,0,4,2,2,5,3,5,0,5,0,12,11,1,9,6,5,1,1,10,2,8,10,MEI
SULAWESI BARAT,MAMUJU,BONEHAU,HINUA,85,42,13,10,3,2,0,1,12,0,13,0,0,0,0,0,25,21,4,5,11,6,5,3,0,0,0,0,MEI
SULAWESI BARAT,MAMUJU,BONEHAU,KINATANG,32,60,2,2,1,0,0,0,0,0,1,1,6,1,5,1,41,12,29,1,25,0,25,0,3,2,1,1,MEI
SULAWESI BARAT,MAMUJU,KEP. BALA BALAKANG,BALA BALAKANG,64,20,4,1,1,0,0,2,1,1,2,0,8,5,3,2,12,10,2,5,3,3,0,1,12,4,8,4,MEI
SULAWESI BARAT,MAMUJU,KEP. BALA BALAKANG,BALA-BALAKANG TIMUR,77,25,24,19,19,15,5,6,9,1,23,0,7,6,1,6,19,19,0,14,8,8,0,4,21,7,14,8,MEI
SULAWESI BARAT,MAMUJU TENGAH,TOBADAK,MAHAHE,72,59,24,15,7,7,2,20,0,2,23,1,6,3,3,0,55,10,45,2,51,25,26,23,1,0,1,1,JUNI
SULAWESI BARAT,MAMUJU TENGAH,TOBADAK,SALOBAJA,84,59,40,10,6,6,6,25,7,1,1,18,0,0,0,0,41,26,15,25,16,0,16,0,41,13,28,37,JUNI
SULAWESI BARAT,MAMUJU TENGAH,TOBADAK,TOBADAK,87,23,19,4,4,4,3,3,2,11,6,4,1,0,1,0,17,7,10,4,17,10,7,7,20,20,0,8,JUNI
SULAWESI BARAT,MAMUJU TENGAH,TOBADAK,PALONGAAN,56,59,19,6,4,1,1,15,1,2,3,2,4,4,0,2,38,19,19,18,17,2,15,2,29,13,16,1,JUNI
SULAWESI BARAT,MAMUJU TENGAH,TOBADAK,BATU PARIGI,64,32,1,0,0,0,0,1,0,0,1,0,10,4,6,2,15,10,5,4,6,5,1,0,0,0,0,0,JUNI
SULAWESI BARAT,MAMUJU TENGAH,TOBADAK,BAMBADARU,35,30,5,2,2,2,1,1,2,0,1,1,3,2,1,1,25,8,17,0,21,6,15,1,16,15,1,16,JUNI
SULAWESI BARAT,MAMUJU TENGAH,TOBADAK,SEJATI,92,64,44,24,3,1,0,15,3,18,36,2,16,10,6,2,15,8,7,8,2,1,1,0,10,7,3,7,JUNI
SULAWESI BARAT,MAMUJU TENGAH,TOBADAK,SALOADAK,56,56,45,38,25,21,9,13,12,1,22,0,7,0,7,0,49,29,20,15,2,0,2,0,27,27,0,24,JUNI
SULAWESI BARAT,MAMUJU TENGAH,PANGALE,POLO PANGALE,49,64,20,3,1,1,0,3,2,3,8,5,1,1,0,1,33,33,0,24,26,0,26,0,13,10,3,3,JUNI
SULAWESI BARAT,MAMUJU TENGAH,PANGALE,PANGALE,79,56,55,22,21,15,7,34,11,3,2,42,6,4,2,3,18,12,6,10,8,3,5,1,18,18,0,13,JUNI
SULAWESI BARAT,MAMUJU TENGAH,PANGALE,SARTANAMAJU,56,19,12,9,8,6,1,6,3,0,9,2,9,3,6,2,12,11,1,1,7,0,7,0,16,9,7,7,JUNI
SULAWESI BARAT,MAMUJU TENGAH,PANGALE,POLO LERENG,31,41,26,19,12,1,0,26,0,0,8,14,4,4,0,0,25,15,10,13,1,1,0,1,18,1,17,18,JUNI
SULAWESI BARAT,MAMUJU TENGAH,PANGALE,KUO,70,15,10,3,2,0,0,1,1,0,1,7,14,8,6,3,10,6,4,2,0,0,0,0,8,4,4,0,JUNI
SULAWESI BARAT,MAMUJU TENGAH,PANGALE,POLO CAMBA,33,16,7,3,2,1,0,0,0,4,1,0,4,2,2,2,14,6,8,0,10,10,0,9,15,10,5,0,JUNI
SULAWESI BARAT,MAMUJU TENGAH,PANGALE,LAMBA-LAMBA,49,34,1,1,1,0,0,1,0,0,1,0,9,7,2,6,18,9,9,2,6,0,6,0,26,22,4,11,JUNI
SULAWESI BARAT,MAMUJU TENGAH,PANGALE,KOMBILING,97,47,13,0,0,0,0,8,0,5,1,1,15,11,4,10,22,7,15,3,6,0,6,0,36,33,3,20,JUNI
SULAWESI BARAT,MAMUJU TENGAH,PANGALE,LEMO-LEMO,61,70,30,7,7,6,1,0,7,21,17,2,11,8,3,7,10,8,2,4,6,2,4,1,21,12,9,13,JUNI
SULAWESI BARAT,MAMUJU TENGAH,BUDONG-BUDONG,BABANA,97,77,41,21,2,2,0,22,4,11,33,4,12,12,0,10,20,20,0,2,19,0,19,0,69,35,34,22,JUNI
SULAWESI BARAT,MAMUJU TENGAH,BUDONG-BUDONG,LUMU,64,74,68,64,62,0,0,24,38,6,1,66,0,0,0,0,56,39,17,27,23,20,3,2,26,0,26,14,JUNI
SULAWESI BARAT,MAMUJU TENGAH,BUDONG-BUDONG,PONTANAKAYANG,41,80,26,9,6,0,0,1,25,0,25,1,8,7,1,2,68,39,29,19,37,37,0,21,12,10,2,4,JUNI
SULAWESI BARAT,MAMUJU TENGAH,BUDONG-BUDONG,SALOGATTA,83,56,29,24,21,13,4,12,12,0,5,1,8,4,4,1,55,55,0,36,37,4,33,0,29,24,5,0,JUNI
SULAWESI BARAT,MAMUJU TENGAH,BUDONG-BUDONG,KIRE,99,26,18,6,3,2,1,5,6,6,8,1,12,6,6,0,11,6,5,2,5,1,4,1,14,13,1,10,JUNI
SULAWESI BARAT,MAMUJU TENGAH,BUDONG-BUDONG,TINALI,89,21,14,10,1,1,1,8,5,0,13,0,8,0,8,0,13,7,6,4,3,0,3,0,5,0,5,5,JUNI
SULAWESI BARAT,MAMUJU TENGAH,BUDONG-BUDONG,SALUMANURUNG,44,61,56,30,12,11,6,50,0,0,27,2,3,2,1,0,53,38,15,10,12,5,7,2,43,0,43,30,JUNI
SULAWESI BARAT,MAMUJU TENGAH,BUDONG-BUDONG,PASAPA,60,40,22,6,4,3,3,14,5,0,9,7,2,2,0,1,34,19,15,18,11,9,2,2,2,1,1,0,JUNI
SULAWESI BARAT,MAMUJU TENGAH,BUDONG-BUDONG,BOJO,46,48,7,4,1,0,0,0,7,0,0,0,7,7,0,0,39,20,19,11,17,8,9,8,46,0,46,18,JUNI
SULAWESI BARAT,MAMUJU TENGAH,BUDONG-BUDONG,BARAKKANG,48,20,0,0,0,0,0,0,0,0,0,0,3,2,1,0,16,8,8,7,1,1,0,0,4,1,3,4,JUNI
SULAWESI BARAT,MAMUJU TENGAH,BUDONG-BUDONG,LEMBAH HADA,63,68,33,22,3,0,0,6,15,4,14,10,5,3,2,3,24,8,16,5,23,7,16,5,5,1,4,0,JUNI
SULAWESI BARAT,MAMUJU TENGAH,TOPOYO,BUDONG-BUDONG,33,71,23,10,7,1,1,2,7,0,2,0,6,2,4,0,17,5,12,1,7,5,2,5,46,32,14,45,JUNI
SULAWESI BARAT,MAMUJU TENGAH,TOPOYO,TOPOYO,82,40,16,8,3,3,3,8,0,5,1,12,8,0,8,0,17,12,5,6,0,0,0,0,27,8,19,16,JUNI
SULAWESI BARAT,MAMUJU TENGAH,TOPOYO,TUMBU,51,13,5,2,1,0,0,4,0,1,0,5,6,2,4,1,10,6,4,0,0,0,0,0,2,0,2,1,JUNI
SULAWESI BARAT,MAMUJU TENGAH,TOPOYO,KABUBU,34,73,40,34,19,10,3,17,17,2,10,30,1,0,1,0,25,17,8,8,7,6,1,0,24,20,4,15,JUNI
SULAWESI BARAT,MAMUJU TENGAH,TOPOYO,WAEPUTEH,33,20,17,13,6,5,1,10,0,5,0,15,1,0,1,0,13,12,1,9,8,8,0,2,19,17,2,18,JUNI
SULAWESI BARAT,MAMUJU TENGAH,TOPOYO,TANGKOU,71,79,28,18,10,2,2,6,16,1,9,19,6,0,6,0,58,40,18,22,56,44,12,20,33,9,24,15,JUNI
SULAWESI BARAT,MAMUJU TENGAH,TOPOYO,TABOLANG,60,47,27,7,5,0,0,0,18,6,21,3,2,1,1,1,26,18,8,2,8,4,4,3,0,0,0,0,JUNI
SULAWESI BARAT,MAMUJU TENGAH,TOPOYO,PARAILI,84,37,14,10,1,0,0,4,10,0,2,1,13,7,6,5,23,14,9,6,19,4,15,1,33,9,24,15,JUNI
SULAWESI BARAT,MAMUJU TENGAH,TOPOYO,SALUPANGKANG,40,71,45,1,1,0,0,43,1,0,39,2,8,3,5,1,63,17,46,0,16,6,10,0,47,18,29,26,JUNI
SULAWESI BARAT,MAMUJU TENGAH,TOPOYO,SALUPANGKANG IV,80,78,58,20,19,15,8,44,1,3,57,1,4,3,1,3,28,27,1,2,18,2,16,0,23,5,18,7,JUNI
SULAWESI BARAT,MAMUJU TENGAH,TOPOYO,TAPPILINA,47,21,5,3,2,0,0,0,1,3,3,2,7,1,6,1,21,7,14,4,12,1,11,0,5,3,2,3,JUNI
SULAWESI BARAT,MAMUJU TENGAH,TOPOYO,BAMBAMANURUNG,39,56,24,10,2,2,2,17,4,1,3,3,2,2,0,0,31,10,21,1,17,5,12,4,32,20,12,17,JUNI
SULAWESI BARAT,MAMUJU TENGAH,TOPOYO,SALULEKBO,47,66,17,9,2,2,2,2,5,0,3,7,7,5,2,3,62,38,24,17,46,14,32,8,37,31,6,15,JUNI
SULAWESI BARAT,MAMUJU TENGAH,TOPOYO,PANGALLOANG,68,71,63,33,19,5,1,5,4,37,53,8,1,0,1,0,29,21,8,15,23,7,16,7,50,27,23,36,JUNI
SULAWESI BARAT,MAMUJU TENGAH,TOPOYO,SINABATTA,50,18,13,6,1,0,0,6,2,0,0,5,9,1,8,1,11,5,6,0,2,2,0,0,1,0,1,1,JUNI
SULAWESI BARAT,MAMUJU TENGAH,KAROSSA,KAROSSA,61,61,39,19,19,6,2,22,9,1,8,22,12,11,1,9,46,32,14,25,4,3,1,0,5,2,3,2,JUNI
SULAWESI BARAT,MAMUJU TENGAH,KAROSSA,TASOKKO,55,13,3,3,1,1,1,0,2,0,0,2,3,0,3,0,11,7,4,1,3,0,3,0,5,4,1,4,JUNI
SULAWESI BARAT,MAMUJU TENGAH,KAROSSA,LARA,38,12,2,0,0,0,0,1,0,1,2,0,5,3,2,1,10,7,3,2,1,0,1,0,9,4,5,0,JUNI
SULAWESI BARAT,MAMUJU TENGAH,KAROSSA,KADAILA,89,48,23,13,4,0,0,15,3,3,12,11,12,3,9,3,28,27,1,12,2,1,1,1,26,1,25,12,JUNI
SULAWESI BARAT,MAMUJU TENGAH,KAROSSA,KAYU CALLA,68,77,51,2,0,0,0,13,38,0,37,5,2,0,2,0,45,41,4,35,21,21,0,1,74,32,42,20,JUNI
SULAWESI BARAT,MAMUJU TENGAH,KAROSSA,LEMBAH HOPO,93,80,35,35,5,5,1,11,6,12,10,2,7,2,5,0,53,32,21,24,36,8,28,1,3,0,3,2,JUNI
SULAWESI BARAT,MAMUJU TENGAH,KAROSSA,BENGGAULU,76,52,40,36,18,4,2,26,6,2,8,17,7,7,0,0,28,6,22,4,19,17,2,12,16,5,11,4,JUNI
SULAWESI BARAT,MAMUJU TENGAH,KAROSSA,SUKA MAJU,69,35,4,2,2,1,1,0,3,0,3,0,11,5,6,3,26,13,13,8,19,7,12,7,8,2,6,2,JUNI
SULAWESI BARAT,MAMUJU TENGAH,KAROSSA,KAMBUNONG,44,68,25,19,5,2,0,19,3,3,21,0,8,8,0,2,42,14,28,0,21,21,0,6,7,3,4,1,JUNI
SULAWESI BARAT,MAMUJU TENGAH,KAROSSA,SALUBIRO,52,22,7,7,4,3,2,0,5,0,2,0,6,3,3,1,11,5,6,4,3,0,3,0,6,6,0,4,JUNI
SULAWESI BARAT,MAMUJU TENGAH,KAROSSA,SANJANGO,92,67,21,3,0,0,0,0,8,6,5,12,1,0,1,0,48,13,35,12,26,14,12,2,44,25,19,7,JUNI
SULAWESI BARAT,PASANGKAYU,BAMBAIRA,TAMPAURE,58,14,11,4,0,0,0,1,4,5,1,0,8,4,4,0,12,7,5,6,10,8,2,5,1,0,1,1,JUNI
SULAWESI BARAT,PASANGKAYU,BAMBAIRA,BAMBAIRA,89,49,30,2,0,0,0,19,8,2,27,2,6,0,6,0,14,14,0,3,5,3,2,2,8,2,6,6,JUNI
SULAWESI BARAT,PASANGKAYU,BAMBAIRA,KASOLOANG,32,56,35,3,2,2,1,31,3,0,35,0,1,1,0,0,17,6,11,3,7,6,1,0,27,26,1,10,JUNI
SULAWESI BARAT,PASANGKAYU,BAMBAIRA,KALUKU NANGKA,56,27,4,1,0,0,0,4,0,0,1,3,4,1,3,0,20,15,5,12,8,6,2,2,11,0,11,5,JUNI
SULAWESI BARAT,PASANGKAYU,BAMBALAMOTU,RANDOMAYANG,80,23,4,3,0,0,0,3,0,0,2,0,7,2,5,1,12,8,4,4,4,2,2,0,8,6,2,2,JUNI
SULAWESI BARAT,PASANGKAYU,BAMBALAMOTU,BAMBALAMOTU,80,29,4,0,0,0,0,2,2,0,0,1,10,4,6,1,29,8,21,0,25,4,21,2,17,16,1,1,JUNI
SULAWESI BARAT,PASANGKAYU,BAMBALAMOTU,POLEWALI,92,32,4,4,0,0,0,3,0,0,4,0,14,3,11,2,31,19,12,6,26,3,23,3,8,3,5,4,JUNI
SULAWESI BARAT,PASANGKAYU,BAMBALAMOTU,PANGIANG,55,73,32,0,0,0,0,3,27,0,31,0,2,1,1,0,36,14,22,4,21,21,0,1,42,8,34,14,JUNI
SULAWESI BARAT,PASANGKAYU,BAMBALAMOTU,KALOLA,60,68,46,44,27,11,1,32,1,10,7,32,12,8,4,0,19,18,1,2,14,14,0,12,42,4,38,30,JUNI
SULAWESI BARAT,PASANGKAYU,BAMBALAMOTU,WULAI,69,63,20,15,6,1,1,5,5,4,13,0,10,5,5,0,17,12,5,5,14,9,5,1,1,1,0,0,JUNI
SULAWESI BARAT,PASANGKAYU,BARAS,BARAS,92,43,2,0,0,0,0,1,0,1,1,1,1,1,0,0,41,40,1,2,33,31,2,0,0,0,0,0,JUNI
SULAWESI BARAT,PASANGKAYU,BARAS,BULU PARIGI,44,72,9,3,3,1,0,9,0,0,6,0,1,1,0,0,25,19,6,14,0,0,0,0,13,3,10,1,JUNI
SULAWESI BARAT,PASANGKAYU,BARAS,BALANTI,92,38,11,5,0,0,0,3,7,0,6,2,12,6,6,3,20,17,3,5,4,0,4,0,17,14,3,2,JUNI
SULAWESI BARAT,PASANGKAYU,BARAS,MOTU,41,62,51,13,13,0,0,8,1,3,40,0,5,1,4,0,36,5,31,1,31,6,25,1,62,6,56,62,JUNI
SULAWESI BARAT,PASANGKAYU,BARAS,TOWONI,98,15,12,1,1,0,0,12,0,0,1,4,7,6,1,6,13,10,3,4,9,4,5,3,0,0,0,0,JUNI
SULAWESI BARAT,PASANGKAYU,BARAS,KASANO,89,37,4,2,2,1,1,2,1,0,2,1,16,15,1,2,26,7,19,7,6,5,1,0,18,14,4,17,JUNI
SULAWESI BARAT,PASANGKAYU,BULU TABA,SUMBER SARI,54,55,15,2,2,2,2,7,6,0,9,4,3,1,2,0,32,18,14,5,30,15,15,7,18,0,18,4,JUNI
SULAWESI BARAT,PASANGKAYU,BULU TABA,LELEJAE,80,38,4,1,1,1,1,3,0,0,4,0,5,0,5,0,37,17,20,0,15,12,3,9,20,16,4,18,JUNI
SULAWESI BARAT,PASANGKAYU,BULU TABA,BUKIT HARAPAN,75,43,43,11,10,10,8,12,10,10,34,2,7,3,4,1,36,25,11,15,7,7,0,6,12,5,7,3,JUNI
SULAWESI BARAT,PASANGKAYU,BULU TABA,LILIMORI,99,23,0,0,0,0,0,0,0,0,0,0,0,0,0,0,21,9,12,7,16,12,4,8,4,4,0,2,JUNI
SULAWESI BARAT,PASANGKAYU,BULU TABA,KARAVE,36,17,15,5,4,2,1,9,4,0,7,7,1,0,1,0,13,8,5,5,11,0,11,0,15,9,6,10,JUNI
SULAWESI BARAT,PASANGKAYU,BULU TABA,KASTABUANA,33,26,23,7,3,2,0,13,2,1,20,1,0,0,0,0,22,20,2,13,15,9,6,0,1,1,0,0,JUNI
SULAWESI BARAT,PASANGKAYU,BULU TABA,OMPI,40,27,26,9,4,0,0,15,9,1,7,8,2,0,2,0,19,15,4,13,3,2,1,2,6,5,1,4,JUNI
SULAWESI BARAT,PASANGKAYU,DAPURANG,DAPURANG,84,32,27,5,0,0,0,18,5,3,27,0,12,11,1,9,10,8,2,8,3,0,3,0,20,2,18,20,JUNI
SULAWESI BARAT,PASANGKAYU,DAPURANG,BENGGAULU,94,23,18,0,0,0,0,9,2,4,14,4,6,3,3,1,20,8,12,0,2,2,0,1,8,2,6,5,JUNI
SULAWESI BARAT,PASANGKAYU,DAPURANG,TIRTABUANA,58,74,64,32,10,5,2,59,2,0,16,34,3,3,0,1,59,44,15,21,26,23,3,11,17,16,1,7,JUNI
SULAWESI BARAT,PASANGKAYU,DAPURANG,BULU BONGGU,33,43,22,10,8,6,5,10,2,0,21,1,2,0,2,0,17,5,12,2,16,15,1,2,21,16,5,4,JUNI
SULAWESI BARAT,PASANGKAYU,DAPURANG,SARASA,34,77,73,29,7,0,0,12,56,0,53,15,1,1,0,0,45,16,29,13,10,6,4,5,9,4,5,1,JUNI
SULAWESI BARAT,PASANGKAYU,DURIPOKU,TAMMARUNANG,76,70,17,11,11,9,1,13,0,1,11,2,15,0,15,0,13,7,6,5,0,0,0,0,41,7,34,13,JUNI
SULAWESI BARAT,PASANGKAYU,DURIPOKU,SAPTANAJAYA,39,32,4,1,1,0,0,4,0,0,3,1,7,3,4,0,20,8,12,4,6,5,1,0,18,6,12,12,JUNI
SULAWESI BARAT,PASANGKAYU,DURIPOKU,TARANGGI,61,69,19,0,0,0,0,0,2,7,15,3,3,0,3,0,33,20,13,20,24,17,7,13,7,5,2,3,JUNI
SULAWESI BARAT,PASANGKAYU,DURIPOKU,SIPAKAINGA,82,38,26,19,15,1,1,8,8,4,23,1,4,2,2,2,27,16,11,9,27,9,18,7,8,4,4,2,JUNI
SULAWESI BARAT,PASANGKAYU,LARIANG,KULU,45,70,51,25,12,6,1,17,26,3,12,21,2,1,1,1,42,36,6,6,4,2,2,1,47,21,26,43,JUNI
SULAWESI BARAT,PASANGKAYU,LARIANG,PARABU,33,79,40,28,9,1,1,20,17,0,32,6,3,2,1,1,64,9,55,6,55,36,19,35,70,20,50,3,JUNI
SULAWESI BARAT,PASANGKAYU,LARIANG,KENANGAN,44,69,35,15,10,3,1,27,1,0,26,4,5,1,4,0,32,32,0,18,5,5,0,1,3,3,0,0,JUNI
SULAWESI BARAT,PASANGKAYU,LARIANG,BAJAWALI,53,40,28,2,0,0,0,24,3,0,11,1,5,1,4,1,11,10,1,0,9,8,1,8,13,0,13,11,JUNI
SULAWESI BARAT,PASANGKAYU,LARIANG,SINGGANI,33,69,4,2,0,0,0,0,4,0,4,0,0,0,0,0,11,10,1,3,2,1,1,0,43,37,6,33,JUNI
SULAWESI BARAT,PASANGKAYU,LARIANG,BATU MATORU,100,49,41,31,21,17,9,28,3,1,41,0,3,2,1,2,34,21,13,17,21,21,0,14,50,43,7,13,JUNI
SULAWESI BARAT,PASANGKAYU,LARIANG,BAMBAKORO,69,13,9,6,6,1,0,1,5,0,7,0,4,3,1,1,10,6,4,2,2,0,2,0,7,0,7,7,JUNI
SULAWESI BARAT,PASANGKAYU,PASANGKAYU,KARYA BERSAMA,38,38,14,11,5,4,1,2,9,1,13,0,7,4,3,1,37,35,2,29,27,4,23,0,21,10,11,6,JUNI
SULAWESI BARAT,PASANGKAYU,PASANGKAYU,AKO,77,56,7,7,4,3,0,2,4,0,6,0,3,2,1,1,12,10,2,0,2,1,1,1,35,15,20,34,JUNI
SULAWESI BARAT,PASANGKAYU,PASANGKAYU,PASANGKAYU,40,11,0,0,0,0,0,0,0,0,0,0,4,4,0,2,11,7,4,5,5,1,4,1,1,1,0,1,JUNI
SULAWESI BARAT,PASANGKAYU,PASANGKAYU,MARTAJAYA,90,19,17,14,9,6,5,6,5,0,5,3,0,0,0,0,12,6,6,4,3,2,1,0,12,12,0,12,JUNI
SULAWESI BARAT,PASANGKAYU,PASANGKAYU,PAKAVA,36,37,4,1,1,1,0,3,1,0,4,0,6,6,0,0,27,5,22,5,27,10,17,6,29,11,18,2,JUNI
SULAWESI BARAT,PASANGKAYU,PASANGKAYU,GUNUNG SARI,56,31,16,6,0,0,0,14,1,0,2,0,3,0,3,0,20,14,6,3,7,1,6,0,15,7,8,6,JUNI
SULAWESI BARAT,PASANGKAYU,PEDONGGA,MALEI,46,12,8,0,0,0,0,1,3,1,7,0,1,0,1,0,10,6,4,1,10,2,8,1,5,3,2,0,JUNI
SULAWESI BARAT,PASANGKAYU,PEDONGGA,PEDANDA,49,76,70,6,4,1,0,46,9,10,70,0,6,5,1,3,22,19,3,5,2,0,2,0,14,14,0,7,JUNI
SULAWESI BARAT,PASANGKAYU,PEDONGGA,BATU OGE,73,36,35,6,0,0,0,4,13,10,21,12,3,3,0,0,21,11,10,10,11,11,0,4,19,5,14,11,JUNI
SULAWESI BARAT,PASANGKAYU,PEDONGGA,MARTASARI,43,50,49,5,5,2,1,11,2,16,47,1,0,0,0,0,19,6,13,2,6,4,2,4,14,14,0,8,JUNI
SULAWESI BARAT,PASANGKAYU,SARJO,SARJO,71,50,50,23,5,0,0,38,1,2,13,25,2,2,0,2,21,7,14,7,11,7,4,5,12,2,10,6,JUNI
SULAWESI BARAT,PASANGKAYU,SARJO,MAPONU,65,38,16,13,6,1,1,0,0,1,2,14,12,1,11,0,15,9,6,9,1,0,1,0,0,0,0,0,JUNI
SULAWESI BARAT,PASANGKAYU,SARJO,LETAWA,33,66,44,18,3,1,0,13,17,14,22,11,2,0,2,0,44,21,23,6,25,22,3,6,40,40,0,24,JUNI
SULAWESI BARAT,PASANGKAYU,SARJO,SARUDE,51,77,22,2,0,0,0,5,0,5,18,4,8,5,3,5,34,25,9,21,22,12,10,2,55,10,45,48,JUNI
SULAWESI BARAT,PASANGKAYU,SARUDU,DODA,61,47,22,3,2,1,1,10,7,1,16,0,3,1,2,0,20,12,8,3,1,1,0,0,18,11,7,7,JUNI
SULAWESI BARAT,PASANGKAYU,SARUDU,SARUDU,43,39,34,20,14,13,8,11,9,6,8,4,4,4,0,4,20,19,1,17,3,0,3,0,0,0,0,0,JUNI
SULAWESI BARAT,PASANGKAYU,SARUDU,BULU MARIO,42,64,59,18,12,8,6,28,2,11,42,8,6,6,0,2,12,9,3,8,1,1,0,1,6,2,4,2,JUNI
SULAWESI BARAT,PASANGKAYU,SARUDU,KUMASARI,92,78,42,42,36,5,5,32,0,5,38,1,16,11,5,1,69,63,6,5,13,13,0,9,26,22,4,16,JUNI
SULAWESI BARAT,PASANGKAYU,SARUDU,PATIKA,82,29,17,15,10,4,3,8,0,1,14,2,13,12,1,10,10,9,1,1,6,1,5,1,26,2,24,21,JUNI
SULAWESI BARAT,PASANGKAYU,TIKKE RAYA,MAKMUR JAYA,99,15,7,5,5,5,3,1,3,0,0,3,16,9,7,3,12,10,2,4,8,5,3,2,14,12,2,14,JUNI
SULAWESI BARAT,PASANGKAYU,TIKKE RAYA,LARIANG,59,40,24,15,10,0,0,23,0,0,22,2,3,2,1,1,31,29,2,13,3,2,1,2,12,1,11,2,JUNI
SULAWESI BARAT,PASANGKAYU,TIKKE RAYA,TIKKE,52,13,10,4,1,0,0,7,3,0,2,3,7,0,7,0,12,8,4,1,1,0,1,0,10,8,2,1,JUNI
SULAWESI BARAT,PASANGKAYU,TIKKE RAYA,PAJALELE,56,76,44,29,15,11,0,37,7,0,2,14,8,2,6,1,67,21,46,9,13,6,7,4,10,4,6,9,JUNI
SULAWESI BARAT,PASANGKAYU,TIKKE RAYA,JENGENG RAYA,83,17,14,0,0,0,0,0,12,2,9,0,15,6,9,6,15,15,0,5,14,11,3,2,2,2,0,2,JUNI
SULAWESI BARAT,MAJENE,BANGGAE,BANGGAE,37,12,0,0,0,0,0,0,0,0,0,0,0,0,0,0,12,12,0,12,3,1,2,1,1,0,1,0,JUNI
SULAWESI BARAT,MAJENE,BANGGAE,BARU,68,35,1,0,0,0,0,1,0,0,1,0,0,0,0,0,16,6,10,5,4,3,1,3,1,1,0,1,JUNI
SULAWESI BARAT,MAJENE,BANGGAE,PANGALI ALI,30,12,0,0,0,0,0,0,0,0,0,0,0,0,0,0,12,10,2,8,12,2,10,1,17,17,0,11,JUNI
SULAWESI BARAT,MAJENE,BANGGAE,TOTOLI,35,13,5,5,0,0,0,3,0,2,5,0,3,0,3,0,13,12,1,8,2,2,0,1,5,4,1,3,JUNI
SULAWESI BARAT,MAJENE,BANGGAE,RANGAS,60,36,14,6,1,1,1,8,5,0,4,10,9,1,8,1,32,29,3,23,0,0,0,0,17,7,10,11,JUNI
SULAWESI BARAT,MAJENE,BANGGAE,GALUNG,54,48,22,3,2,0,0,10,8,3,8,0,2,0,2,0,20,13,7,13,5,4,1,1,19,11,8,15,JUNI
SULAWESI BARAT,MAJENE,BANGGAE,PALIPI SOREANG,97,66,19,14,0,0,0,6,1,2,11,1,0,0,0,0,47,11,36,8,25,10,15,1,27,1,26,4,JUNI
SULAWESI BARAT,MAJENE,BANGGAE,PAMBOBORANG,37,25,1,1,1,0,0,0,0,1,1,0,7,0,7,0,16,7,9,4,8,1,7,0,16,10,6,4,JUNI
SULAWESI BARAT,MAJENE,BANGGAE TIMUR,BAURUNG,42,23,9,8,8,4,0,9,0,0,9,0,8,0,8,0,16,14,2,10,12,6,6,2,26,20,6,6,JUNI
SULAWESI BARAT,MAJENE,BANGGAE TIMUR,BARUGA,33,48,45,39,36,8,6,3,18,4,41,1,1,1,0,0,21,15,6,2,18,8,10,5,7,1,6,7,JUNI
SULAWESI BARAT,MAJENE,BANGGAE TIMUR,BARUGA DHUA,63,56,16,4,2,1,1,12,3,0,0,11,12,3,9,3,25,25,0,2,16,15,1,4,41,13,28,22,JUNI
SULAWESI BARAT,MAJENE,BANGGAE TIMUR,LABUANG,71,13,0,0,0,0,0,0,0,0,0,0,12,12,0,4,13,13,0,5,7,0,7,0,2,2,0,2,JUNI
SULAWESI BARAT,MAJENE,BANGGAE TIMUR,TANDE,100,50,42,19,13,9,8,1,31,1,18,20,5,1,4,0,15,10,5,7,9,6,3,3,29,28,1,11,JUNI
SULAWESI BARAT,MAJENE,BANGGAE TIMUR,LEMBANG,42,29,12,12,6,3,0,2,6,4,2,10,4,1,3,0,13,8,5,2,6,6,0,6,20,16,4,13,JUNI
SULAWESI BARAT,MAJENE,BANGGAE TIMUR,LABUANG UTARA,43,18,3,1,1,1,0,0,0,1,2,1,7,4,3,2,15,12,3,11,0,0,0,0,8,4,4,0,JUNI
SULAWESI BARAT,MAJENE,BANGGAE TIMUR,TANDE TIMUR,71,31,11,5,2,2,0,10,1,0,0,0,6,3,3,1,20,6,14,4,11,8,3,3,15,3,12,7,JUNI
SULAWESI BARAT,MAJENE,BANGGAE TIMUR,BUTTU BARUGA,45,58,9,3,3,0,0,4,2,0,7,2,6,1,5,1,15,15,0,4,13,5,8,0,3,3,0,2,JUNI
SULAWESI BARAT,MAJENE,MALUNDA,MALUNDA,52,48,1,1,1,1,0,0,1,0,1,0,5,2,3,2,29,12,17,2,21,21,0,2,54,34,20,35,JUNI
SULAWESI BARAT,MAJENE,MALUNDA,LAMUNGANG BATU,89,67,22,19,17,15,7,4,10,0,19,1,11,4,7,0,65,44,21,18,35,17,18,9,31,26,5,25,JUNI
SULAWESI BARAT,MAJENE,MALUNDA,BAMBANGAN,94,57,29,25,10,1,1,28,0,0,17,3,14,11,3,3,11,7,4,6,7,1,6,0,27,15,12,23,JUNI
SULAWESI BARAT,MAJENE,MALUNDA,LOMBANG,50,30,6,1,1,1,0,4,2,0,4,2,4,0,4,0,28,22,6,5,23,22,1,21,37,31,6,8,JUNI
SULAWESI BARAT,MAJENE,MALUNDA,LOMBONG,62,25,9,6,0,0,0,9,0,0,2,5,1,0,1,0,17,10,7,1,7,6,1,4,14,12,2,9,JUNI
SULAWESI BARAT,MAJENE,MALUNDA,MEKKATTA,95,75,36,36,3,0,0,25,1,5,18,4,18,6,12,0,29,29,0,27,17,9,8,7,40,40,0,16,JUNI
SULAWESI BARAT,MAJENE,MALUNDA,MALIAYA,76,49,16,16,13,8,6,9,1,0,13,2,14,13,1,10,10,10,0,2,9,7,2,6,0,0,0,0,JUNI
SULAWESI BARAT,MAJENE,MALUNDA,LOMBANG TIMUR,66,35,20,5,0,0,0,15,3,2,14,0,0,0,0,0,35,28,7,4,27,18,9,15,14,13,1,5,JUNI
SULAWESI BARAT,MAJENE,MALUNDA,SALUTAHONGAN,60,29,21,21,5,3,3,5,1,1,6,13,0,0,0,0,27,8,19,5,13,13,0,6,17,13,4,13,JUNI
SULAWESI BARAT,MAJENE,MALUNDA,LOMBONG TIMUR,94,32,11,7,1,0,0,11,0,0,5,5,12,2,10,2,21,16,5,0,15,2,13,2,29,25,4,2,JUNI
SULAWESI BARAT,MAJENE,MALUNDA,MEKKATTA SELATAN,97,43,5,4,3,2,1,3,1,0,4,1,0,0,0,0,26,10,16,2,19,18,1,18,7,7,0,3,JUNI
SULAWESI BARAT,MAJENE,MALUNDA,KAYUANGIN,53,20,13,0,0,0,0,0,0,2,4,7,8,3,5,1,14,6,8,2,7,4,3,3,20,10,10,3,JUNI
SULAWESI BARAT,MAJENE,PAMBOANG,LALAMPANUA,98,32,13,12,10,10,9,1,3,0,1,2,2,1,1,1,29,29,0,27,27,16,11,4,33,25,8,22,JUNI
SULAWESI BARAT,MAJENE,PAMBOANG,SIRINDU,41,79,40,15,12,11,3,2,7,26,15,14,8,4,4,1,11,6,5,6,6,3,3,2,22,8,14,5,JUNI
SULAWESI BARAT,MAJENE,PAMBOANG,ADOLANG,75,28,19,5,1,1,0,3,13,2,5,9,7,0,7,0,20,11,9,0,5,5,0,2,11,0,11,4,JUNI
SULAWESI BARAT,MAJENE,PAMBOANG,BABABULO,80,24,17,3,3,0,0,12,4,1,6,9,2,1,1,0,11,9,2,4,4,3,1,2,5,5,0,2,JUNI
SULAWESI BARAT,MAJENE,PAMBOANG,BONDE,40,77,35,20,16,14,14,21,0,0,12,9,4,1,3,1,30,20,10,8,11,7,4,7,30,16,14,23,JUNI
SULAWESI BARAT,MAJENE,PAMBOANG,BETTENG,40,21,7,1,1,0,0,4,2,0,3,3,8,3,5,0,12,6,6,4,5,4,1,4,10,2,8,4,JUNI
SULAWESI BARAT,MAJENE,PAMBOANG,SIMBANG,95,17,0,0,0,0,0,0,0,0,0,0,10,6,4,2,17,16,1,6,2,1,1,0,2,1,1,2,JUNI
SULAWESI BARAT,MAJENE,PAMBOANG,BONDE UTARA,33,62,51,16,11,5,4,19,27,0,22,7,1,1,0,0,15,12,3,5,13,8,5,7,6,1,5,1,JUNI
SULAWESI BARAT,MAJENE,PAMBOANG,BABABULO UTARA,59,32,10,10,9,5,5,5,0,0,8,2,8,6,2,3,25,25,0,13,17,7,10,3,17,5,12,13,JUNI
SULAWESI BARAT,MAJENE,PAMBOANG,BUTTU PAMBOANG,53,78,75,22,18,11,6,60,6,1,52,18,5,2,3,1,59,17,42,4,49,11,38,10,15,14,1,9,JUNI
SULAWESI BARAT,MAJENE,PAMBOANG,BANUA ADOLANG,64,34,21,18,13,0,0,19,1,0,11,1,9,4,5,2,12,5,7,5,8,1,7,1,11,4,7,9,JUNI
SULAWESI BARAT,MAJENE,PAMBOANG,ADOLANG DHUA,59,53,50,25,16,4,4,11,0,5,20,23,4,3,1,2,17,16,1,1,6,5,1,2,20,10,10,10,JUNI
SULAWESI BARAT,MAJENE,PAMBOANG,TINAMBUNG,89,18,3,0,0,0,0,1,0,1,3,0,10,9,1,3,17,5,12,1,5,4,1,0,12,1,11,7,JUNI
SULAWESI BARAT,MAJENE,PAMBOANG,PESULOANG,37,40,6,1,0,0,0,0,1,1,3,1,1,1,0,0,20,17,3,12,17,16,1,0,2,0,2,0,JUNI
SULAWESI BARAT,MAJENE,PAMBOANG,BALOMBONG,62,37,12,9,9,9,1,11,0,0,6,6,1,1,0,1,31,14,17,6,14,11,3,11,14,2,12,10,JUNI
SULAWESI BARAT,MAJENE,SENDANA,MOSSO,58,38,32,13,9,3,0,0,2,17,1,14,1,1,0,0,27,27,0,1,8,4,4,4,33,33,0,0,JUNI
SULAWESI BARAT,MAJENE,SENDANA,MOSSO DHUA,40,56,29,7,5,2,2,9,3,8,17,2,3,2,1,0,34,22,12,12,6,4,2,2,1,0,1,1,JUNI
SULAWESI BARAT,MAJENE,SENDANA,TOTOLISI SENDANA,77,59,8,1,1,0,0,5,2,0,0,4,12,1,11,0,21,15,6,0,19,7,12,0,28,12,16,1,JUNI
SULAWESI BARAT,MAJENE,SENDANA,TALLUBANUA,74,13,4,3,2,1,0,4,0,0,2,1,14,1,13,0,11,7,4,0,5,0,5,0,2,2,0,1,JUNI
SULAWESI BARAT,MAJENE,SENDANA,LALATEDZONG,66,78,73,49,46,9,5,29,16,12,53,13,12,1,11,1,45,39,6,35,34,30,4,7,79,33,46,12,JUNI
SULAWESI BARAT,MAJENE,SENDANA,BINANGA,75,29,4,2,1,0,0,1,1,1,4,0,8,4,4,3,17,16,1,6,3,3,0,3,19,11,8,14,JUNI
SULAWESI BARAT,MAJENE,SENDANA,PUTTADA,86,39,16,0,0,0,0,2,1,12,13,1,4,3,1,1,36,27,9,7,23,18,5,14,42,36,6,7,JUNI
SULAWESI BARAT,MAJENE,SENDANA,PAMINGGALAN,99,61,18,3,2,1,1,0,14,3,1,4,1,0,1,0,15,9,6,2,1,1,0,0,23,15,8,16,JUNI
SULAWESI BARAT,MAJENE,SENDANA,LEPPANGANG,55,48,36,4,4,0,0,18,16,1,25,7,9,2,7,0,18,12,6,2,15,0,15,0,29,25,4,11,JUNI
SULAWESI BARAT,MAJENE,SENDANA,PUNDAU,59,31,25,14,0,0,0,20,2,1,13,10,9,3,6,2,31,15,16,8,25,13,12,8,39,26,13,10,JUNI
SULAWESI BARAT,MAJENE,SENDANA,SENDANA,73,44,14,12,0,0,0,9,4,0,5,0,7,4,3,3,35,26,9,12,2,0,2,0,25,19,6,5,JUNI
SULAWESI BARAT,MAJENE,SENDANA,BANUA SENDANA,60,42,6,1,1,1,0,2,3,1,3,1,0,0,0,0,25,24,1,6,12,1,11,1,36,31,5,24,JUNI
SULAWESI BARAT,MAJENE,SENDANA,TALLUBANUA UTARA,87,72,38,20,18,14,4,15,0,5,23,8,7,4,3,1,43,42,1,42,33,22,11,3,15,12,3,14,JUNI
SULAWESI BARAT,MAJENE,SENDANA,LIMBORO RAMBU-RAMBU,48,42,12,6,6,2,2,8,1,0,0,3,0,0,0,0,31,9,22,0,7,5,2,5,9,5,4,8,JUNI
SULAWESI BARAT,MAJENE,SENDANA,LIMBUA,53,32,1,1,0,0,0,0,1,0,0,1,2,2,0,0,14,10,4,1,13,12,1,8,9,5,4,7,JUNI
SULAWESI BARAT,MAJENE,SENDANA,BUKIT SAMANG,48,31,26,6,6,0,0,18,7,0,16,5,2,1,1,1,21,6,15,3,17,14,3,3,28,6,22,12,JUNI
SULAWESI BARAT,MAJENE,TAMMERODO SENDANA,SEPPONG,88,35,17,16,8,2,1,3,7,1,4,12,16,6,10,2,29,26,3,1,17,9,8,6,35,31,4,4,JUNI
SULAWESI BARAT,MAJENE,TAMMERODO SENDANA,TAMMERODO,34,22,18,11,8,0,0,2,7,6,9,2,5,0,5,0,22,9,13,2,17,8,9,8,12,10,2,10,JUNI
SULAWESI BARAT,MAJENE,TAMMERODO SENDANA,ULIDANG,36,43,4,1,1,0,0,0,2,1,3,0,0,0,0,0,43,6,37,4,15,1,14,1,25,3,22,22,JUNI
SULAWESI BARAT,MAJENE,TAMMERODO SENDANA,TALLAMBALAO,99,21,8,7,7,2,0,6,0,1,8,0,2,1,1,1,13,8,5,8,4,3,1,1,5,4,1,2,JUNI
SULAWESI BARAT,MAJENE,TAMMERODO SENDANA,TAMMERODO UTARA,82,41,18,2,1,1,0,16,0,1,3,4,5,3,2,3,24,16,8,7,23,10,13,10,14,12,2,2,JUNI
SULAWESI BARAT,MAJENE,TAMMERODO SENDANA,MANYAMBA,92,80,64,7,1,1,1,46,4,4,30,18,10,4,6,1,54,9,45,6,10,1,9,0,20,19,1,10,JUNI
SULAWESI BARAT,MAJENE,TAMMERODO SENDANA,AWO,56,44,22,18,8,0,0,4,2,0,6,9,0,0,0,0,40,6,34,2,16,5,11,3,32,29,3,26,JUNI
SULAWESI BARAT,MAJENE,TUBO SENDANA,ONANG,83,16,3,2,0,0,0,1,2,0,2,0,8,0,8,0,11,8,3,3,2,1,1,1,9,3,6,1,JUNI
SULAWESI BARAT,MAJENE,TUBO SENDANA,TUBO,37,15,10,5,2,0,0,2,4,0,9,0,2,2,0,2,11,7,4,1,2,2,0,2,5,4,1,2,JUNI
SULAWESI BARAT,MAJENE,TUBO SENDANA,ONANG UTARA,86,43,18,6,1,0,0,13,1,2,2,5,3,1,2,0,10,6,4,3,2,0,2,0,31,15,16,19,JUNI
SULAWESI BARAT,MAJENE,TUBO SENDANA,TUBO SELATAN,85,54,11,2,2,1,1,7,1,0,10,0,3,0,3,0,11,8,3,6,6,4,2,2,32,10,22,23,JUNI
SULAWESI BARAT,MAJENE,TUBO SENDANA,BONDE BONDE,35,40,30,6,1,1,1,18,4,2,19,6,4,4,0,0,33,9,24,0,30,26,4,13,40,10,30,21,JUNI
SULAWESI BARAT,MAJENE,TUBO SENDANA,TUBO TENGAH,34,38,38,26,7,4,3,12,15,4,16,12,0,0,0,0,16,6,10,4,13,6,7,6,11,8,3,2,JUNI
SULAWESI BARAT,MAJENE,TUBO SENDANA,TUBO POANG,93,45,22,20,17,10,1,5,1,2,5,7,4,4,0,3,39,12,27,8,18,12,6,5,48,41,7,42,JUNI
SULAWESI BARAT,MAJENE,ULUMANDA,KABIRAAN,33,14,11,3,0,0,0,7,1,1,1,7,5,2,3,0,11,10,1,7,9,2,7,1,17,15,2,1,JUNI
SULAWESI BARAT,MAJENE,ULUMANDA,SAMBABO,99,37,30,17,11,0,0,5,14,1,26,3,10,4,6,0,12,5,7,4,2,0,2,0,9,6,3,8,JUNI
SULAWESI BARAT,MAJENE,ULUMANDA,TANDEALLO,44,21,14,6,3,3,2,5,5,1,2,7,4,1,3,1,20,20,0,20,10,3,7,0,13,0,13,9,JUNI
SULAWESI BARAT,MAJENE,ULUMANDA,ULUMANDA,62,12,11,2,1,1,0,1,4,4,2,7,11,2,9,2,12,7,5,7,9,0,9,0,13,4,9,13,JUNI
SULAWESI BARAT,MAJENE,ULUMANDA,SALUTAMBUNG,92,75,25,1,1,0,0,9,8,8,11,3,9,0,9,0,33,21,12,1,4,2,2,2,37,25,12,18,JUNI
SULAWESI BARAT,MAJENE,ULUMANDA,POPENGA,76,50,15,14,10,3,0,7,2,4,9,5,5,3,2,0,15,5,10,0,6,0,6,0,12,0,12,2,JUNI
SULAWESI BARAT,MAJENE,ULUMANDA,SULAI,88,67,16,11,2,1,1,14,1,0,11,1,5,5,0,5,13,7,6,7,9,4,5,0,42,8,34,12,JUNI
SULAWESI BARAT,MAJENE,ULUMANDA,PANGGALO,72,64,46,41,29,25,19,9,5,6,3,42,10,2,8,0,12,9,3,1,7,6,1,1,48,18,30,12,JUNI
SULAWESI BARAT,MAMASA,ARALLE,ARALLE,82,31,9,5,4,4,3,2,0,3,9,0,15,11,4,5,21,5,16,0,17,3,14,0,4,1,3,2,JUNI
SULAWESI BARAT,MAMASA,ARALLE,RALLE ANAK,34,40,19,10,0,0,0,4,6,8,1,18,1,1,0,0,27,10,17,2,21,1,20,1,1,0,1,0,JUNI
SULAWESI BARAT,MAMASA,ARALLE,PANETEAN,33,60,39,7,4,0,0,8,14,8,8,29,5,0,5,0,15,6,9,5,9,1,8,0,13,6,7,10,JUNI
SULAWESI BARAT,MAMASA,ARALLE,UHAILANU,94,57,53,27,2,1,1,38,2,4,44,6,16,3,13,1,35,30,5,24,1,1,0,0,40,0,40,11,JUNI
SULAWESI BARAT,MAMASA,ARALLE,ARALLE UTARA,96,48,33,9,3,3,0,16,13,1,20,1,3,3,0,3,32,28,4,18,13,13,0,11,35,26,9,35,JUNI
SULAWESI BARAT,MAMASA,ARALLE,UHAIDAHO,50,43,9,9,8,0,0,1,6,1,8,0,3,3,0,3,36,15,21,12,17,4,13,1,15,2,13,3,JUNI
SULAWESI BARAT,MAMASA,ARALLE,BARURU,37,71,11,4,3,3,2,3,0,6,2,8,0,0,0,0,15,8,7,7,15,15,0,15,12,9,3,9,JUNI
SULAWESI BARAT,MAMASA,ARALLE,RALLEANAK UTARA,31,23,6,3,1,0,0,6,0,0,5,1,0,0,0,0,15,14,1,0,10,2,8,1,2,0,2,2,JUNI
SULAWESI BARAT,MAMASA,ARALLE,PAMOSEANG PANGGA,66,30,21,3,0,0,0,0,0,15,5,15,9,5,4,2,11,9,2,7,5,5,0,1,21,7,14,5,JUNI
SULAWESI BARAT,MAMASA,ARALLE,KALABE,48,53,10,1,1,1,1,8,0,0,9,0,7,3,4,0,35,13,22,2,20,15,5,4,49,23,26,18,JUNI
SULAWESI BARAT,MAMASA,ARALLE,ARALLE SELATAN,75,37,34,13,5,1,0,31,3,0,1,9,12,6,6,6,15,6,9,0,14,7,7,0,30,7,23,15,JUNI
SULAWESI BARAT,MAMASA,ARALLE,HAHANGAN,62,71,3,1,1,1,0,0,3,0,2,1,8,1,7,1,24,9,15,8,23,16,7,15,15,10,5,6,JUNI
SULAWESI BARAT,MAMASA,BALLA,BALLA,87,33,16,12,10,9,8,6,0,0,15,0,12,12,0,9,19,8,11,8,5,2,3,2,3,0,3,0,JUNI
SULAWESI BARAT,MAMASA,BALLA,BALLA BARAT,35,35,15,14,11,11,7,7,1,0,3,12,5,0,5,0,26,16,10,14,20,12,8,12,19,5,14,12,JUNI
SULAWESI BARAT,MAMASA,BALLA,BALLA SATANETEAN,43,12,9,6,3,0,0,9,0,0,8,1,3,3,0,2,12,11,1,8,6,0,6,0,7,3,4,2,JUNI
SULAWESI BARAT,MAMASA,BALLA,BALLA TUMUKA,58,56,27,27,25,0,0,7,9,7,18,3,5,0,5,0,22,6,16,4,12,3,9,1,18,13,5,11,JUNI
SULAWESI BARAT,MAMASA,BALLA,SEPAKUAN,54,46,6,1,0,0,0,3,1,2,5,0,1,0,1,0,42,26,16,20,1,1,0,0,14,10,4,0,JUNI
SULAWESI BARAT,MAMASA,BALLA,PIDARA,38,11,0,0,0,0,0,0,0,0,0,0,2,2,0,1,10,10,0,4,6,5,1,4,6,3,3,0,JUNI
SULAWESI BARAT,MAMASA,BALLA,BAMBAPUANG,73,43,4,2,2,1,1,3,0,0,1,2,4,2,2,2,11,9,2,7,10,4,6,1,12,12,0,0,JUNI
SULAWESI BARAT,MAMASA,BALLA,BALLA TIMUR,91,45,19,1,1,0,0,0,11,8,16,2,15,12,3,3,25,18,7,1,19,5,14,4,30,24,6,20,JUNI
SULAWESI BARAT,MAMASA,BAMBANG,MOKALLANG,95,77,65,14,4,4,2,35,24,3,1,60,5,4,1,2,22,7,15,6,20,2,18,2,57,52,5,51,JUNI
SULAWESI BARAT,MAMASA,BAMBANG,MASOSO,57,35,12,8,0,0,0,11,0,1,8,4,7,1,6,1,14,10,4,0,3,0,3,0,18,4,14,10,JUNI
SULAWESI BARAT,MAMASA,BAMBANG,SALUASSING,52,26,3,0,0,0,0,1,0,1,2,0,4,4,0,3,10,9,1,5,10,4,6,0,25,13,12,23,JUNI
SULAWESI BARAT,MAMASA,BAMBANG,SALUBULO,44,34,15,1,0,0,0,9,4,2,8,3,1,1,0,1,13,6,7,6,0,0,0,0,19,12,7,8,JUNI
SULAWESI BARAT,MAMASA,BAMBANG,SALUKADI,61,51,13,8,0,0,0,5,6,2,12,1,9,0,9,0,37,15,22,7,3,0,3,0,1,0,1,1,JUNI
SULAWESI BARAT,MAMASA,BAMBANG,SALUKEPOPOK,59,31,6,2,2,0,0,4,0,1,4,1,2,1,1,0,26,26,0,6,3,2,1,2,10,6,4,3,JUNI
SULAWESI BARAT,MAMASA,BAMBANG,ULUMAMBI BARAT,71,63,12,5,5,1,1,0,0,8,1,7,5,0,5,0,56,13,43,1,33,6,27,3,13,1,12,2,JUNI
SULAWESI BARAT,MAMASA,BAMBANG,LIMBADEBATA,68,46,18,7,0,0,0,15,3,0,4,10,10,9,1,3,14,10,4,3,7,5,2,5,37,37,0,17,JUNI
SULAWESI BARAT,MAMASA,BAMBANG,TANETE TOMBA,99,16,3,2,2,0,0,2,1,0,0,2,19,3,16,0,13,9,4,8,1,0,1,0,2,2,0,2,JUNI
SULAWESI BARAT,MAMASA,BAMBANG,BAMBANG,33,36,15,0,0,0,0,12,1,1,7,2,4,0,4,0,10,7,3,0,6,3,3,3,15,10,5,4,JUNI
SULAWESI BARAT,MAMASA,BAMBANG,RANTELEMO,31,21,7,3,0,0,0,0,5,2,1,5,5,2,3,0,10,9,1,8,3,3,0,2,3,0,3,2,JUNI
SULAWESI BARAT,MAMASA,BAMBANG,SALUDENGEN,71,55,46,20,8,0,0,5,36,1,32,9,2,0,2,0,18,12,6,5,5,5,0,2,38,3,35,26,JUNI
SULAWESI BARAT,MAMASA,BAMBANG,ULUMAMBI,98,24,3,0,0,0,0,0,1,0,3,0,8,0,8,0,14,7,7,4,3,0,3,0,12,2,10,4,JUNI
SULAWESI BARAT,MAMASA,BAMBANG,BAMBANG TIMUR,45,40,0,0,0,0,0,0,0,0,0,0,3,3,0,1,25,14,11,7,13,1,12,0,24,6,18,7,JUNI
SULAWESI BARAT,MAMASA,BAMBANG,MINANGA,66,44,35,33,1,0,0,24,8,1,9,10,3,3,0,2,34,23,11,12,19,14,5,12,15,7,8,12,JUNI
SULAWESI BARAT,MAMASA,BAMBANG,SIKAMASE,54,38,21,4,1,0,0,20,0,0,0,18,1,1,0,1,23,16,7,12,6,4,2,3,31,11,20,24,JUNI
SULAWESI BARAT,MAMASA,BAMBANG,RANTETARIMA,50,19,12,7,2,0,0,5,3,4,8,3,8,0,8,0,11,7,4,4,4,0,4,0,12,2,10,8,JUNI
SULAWESI BARAT,MAMASA,BAMBANG,SALURURU,47,40,15,6,5,5,1,11,3,0,9,2,4,2,2,1,16,11,5,10,9,2,7,2,8,3,5,0,JUNI
SULAWESI BARAT,MAMASA,BAMBANG,SALUTABANG,87,71,68,15,13,2,2,12,28,26,30,33,15,2,13,0,66,8,58,3,21,15,6,4,69,33,36,54,JUNI
SULAWESI BARAT,MAMASA,BAMBANG,BALATANA,64,24,3,3,2,0,0,3,0,0,0,0,4,2,2,2,15,15,0,0,0,0,0,0,0,0,0,0,JUNI
SULAWESI BARAT,MAMASA,BUNTUMALANGKA,BUNTUMALANGKA,60,79,33,32,17,2,2,19,9,3,20,10,9,5,4,3,17,12,5,2,3,2,1,0,55,46,9,43,JUNI
SULAWESI BARAT,MAMASA,BUNTUMALANGKA,RANTEBERAN,78,45,9,9,1,0,0,6,1,1,0,8,1,0,1,0,19,11,8,1,8,1,7,0,18,8,10,16,JUNI
SULAWESI BARAT,MAMASA,BUNTUMALANGKA,KEBANGA,81,60,40,22,3,1,1,11,9,5,36,2,3,1,2,0,36,25,11,0,18,3,15,3,19,5,14,9,JUNI
SULAWESI BARAT,MAMASA,BUNTUMALANGKA,SALURINDU,31,23,17,1,0,0,0,14,3,0,10,5,5,0,5,0,12,12,0,1,5,4,1,3,11,8,3,7,JUNI
SULAWESI BARAT,MAMASA,BUNTUMALANGKA,TAORA,38,69,52,0,0,0,0,5,24,10,23,8,3,0,3,0,43,9,34,9,28,26,2,5,23,19,4,10,JUNI
SULAWESI BARAT,MAMASA,BUNTUMALANGKA,KABAE,89,35,5,1,1,1,0,2,3,0,0,5,10,4,6,3,31,6,25,1,21,15,6,6,8,4,4,4,JUNI
SULAWESI BARAT,MAMASA,BUNTUMALANGKA,SALUTAMBUN BARAT,74,80,74,68,5,0,0,13,48,9,59,0,14,14,0,0,31,19,12,0,24,2,22,2,21,4,17,17,JUNI
SULAWESI BARAT,MAMASA,BUNTUMALANGKA,PENATANGAN,43,76,12,4,0,0,0,11,1,0,8,2,4,4,0,3,39,32,7,9,30,19,11,15,35,10,25,8,JUNI
SULAWESI BARAT,MAMASA,BUNTUMALANGKA,SALUTAMBUN TIMUR,50,70,21,14,1,1,1,7,1,2,13,5,9,8,1,7,42,31,11,29,35,24,11,5,64,52,12,10,JUNI
SULAWESI BARAT,MAMASA,BUNTUMALANGKA,SALUTAMBUN,50,66,30,23,3,1,0,22,1,7,6,3,6,0,6,0,31,26,5,4,15,13,2,7,33,2,31,2,JUNI
SULAWESI BARAT,MAMASA,BUNTUMALANGKA,ARALLE TIMUR,64,39,18,0,0,0,0,14,2,0,8,3,8,8,0,3,39,34,5,1,25,10,15,4,51,42,9,46,JUNI
SULAWESI BARAT,MAMASA,MAMASA,MAMASA,53,29,4,2,1,0,0,3,0,0,0,1,8,1,7,0,15,14,1,0,13,1,12,0,16,4,12,14,JUNI
SULAWESI BARAT,MAMASA,MAMASA,RAMBUSARATU,74,73,58,50,19,9,9,21,21,7,19,7,12,0,12,0,10,6,4,5,5,5,0,2,2,2,0,1,JUNI
SULAWESI BARAT,MAMASA,MAMASA,OSANGO,36,46,0,0,0,0,0,0,0,0,0,0,3,1,2,1,27,21,6,18,18,16,2,9,10,2,8,6,JUNI
SULAWESI BARAT,MAMASA,MAMASA,LAMBANAN,62,49,24,6,5,0,0,18,0,1,9,13,6,5,1,0,24,6,18,2,1,0,1,0,14,10,4,0,JUNI
SULAWESI BARAT,MAMASA,MAMASA,LEMBANA SALULO,82,24,18,7,6,5,2,7,5,4,13,0,11,5,6,1,16,14,2,11,10,4,6,1,16,10,6,7,JUNI
SULAWESI BARAT,MAMASA,MAMASA,TAUPE,63,14,11,5,2,0,0,2,4,2,3,6,3,3,0,1,14,6,8,0,2,1,1,0,1,0,1,1,JUNI
SULAWESI BARAT,MAMASA,MAMASA,BUNTU BUDA,86,66,36,29,16,11,3,24,7,0,5,26,4,3,1,2,31,6,25,2,4,4,0,1,31,14,17,22,JUNI
SULAWESI BARAT,MAMASA,MAMASA,TONDOK BAKARU,47,47,42,38,24,6,4,11,10,10,33,3,4,1,3,0,37,32,5,5,13,0,13,0,20,18,2,10,JUNI
SULAWESI BARAT,MAMASA,MAMASA,PEBASSIAN,60,19,7,1,1,1,0,3,4,0,7,0,9,8,1,3,19,19,0,12,1,0,1,0,2,0,2,1,JUNI
SULAWESI BARAT,MAMASA,MAMASA,MAMBULILING,76,69,16,16,8,7,1,11,3,0,13,3,11,1,10,0,16,12,4,10,1,1,0,0,8,2,6,4,JUNI
SULAWESI BARAT,MAMASA,MAMASA,BOMBONG LAMBE,38,17,8,7,3,0,0,7,1,0,4,2,3,2,1,2,15,5,10,0,9,4,5,4,10,0,10,8,JUNI
SULAWESI BARAT,MAMASA,MAMASA,BUBUN BATU,91,78,59,20,2,2,2,17,26,6,53,4,10,2,8,2,38,26,12,15,22,16,6,0,26,19,7,6,JUNI
SULAWESI BARAT,MAMASA,MAMBI,MAMBI,67,64,37,28,3,3,2,15,2,17,32,0,6,6,0,2,48,25,23,10,24,7,17,7,43,39,4,27,JUNI
SULAWESI BARAT,MAMASA,MAMBI,TALIPUKKI,32,21,14,9,1,0,0,7,2,2,1,12,1,0,1,0,13,5,8,0,0,0,0,0,1,0,1,0,JUNI
SULAWESI BARAT,MAMASA,MAMBI,RANTEBULAHAN,99,62,13,10,1,0,0,8,3,2,8,4,19,18,1,15,60,36,24,11,12,1,11,0,54,18,36,30,JUNI
SULAWESI BARAT,MAMASA,MAMBI,SONDONGLAYU,84,61,43,17,14,7,4,22,16,1,16,2,6,2,4,0,49,37,12,5,5,5,0,1,43,37,6,43,JUNI
SULAWESI BARAT,MAMASA,MAMBI,SALUBANUA,92,79,55,31,12,9,6,10,28,6,35,7,9,7,2,0,20,14,6,1,8,0,8,0,13,7,6,7,JUNI
SULAWESI BARAT,MAMASA,MAMBI,TAPALINA,98,12,12,4,1,0,0,1,1,5,9,3,9,8,1,3,12,5,7,4,8,4,4,4,13,8,5,10,JUNI
SULAWESI BARAT,MAMASA,MAMBI,SENDANA,45,78,47,15,4,1,1,22,5,2,39,7,2,1,1,1,14,10,4,7,14,6,8,3,56,15,41,25,JUNI
SULAWESI BARAT,MAMASA,MAMBI,PAMOSEAN,56,64,13,5,1,1,1,1,0,9,13,0,6,3,3,2,43,7,36,5,1,1,0,1,35,23,12,11,JUNI
SULAWESI BARAT,MAMASA,MAMBI,SELUMAKA,36,26,10,0,0,0,0,7,3,0,3,1,4,1,3,1,25,17,8,10,8,6,2,0,16,7,9,11,JUNI
SULAWESI BARAT,MAMASA,MAMBI,BUJUNG MANURUNG,36,24,16,9,6,2,2,11,1,2,0,3,5,0,5,0,23,16,7,11,14,12,2,12,14,14,0,11,JUNI
SULAWESI BARAT,MAMASA,MAMBI,SALU ALO,37,11,4,3,2,0,0,4,0,0,4,0,1,1,0,0,10,7,3,5,3,3,0,2,9,6,3,1,JUNI
SULAWESI BARAT,MAMASA,MAMBI,INDOBANUA,37,30,21,6,2,2,1,1,8,9,4,5,3,2,1,0,22,22,0,6,17,0,17,0,6,3,3,5,JUNI
SULAWESI BARAT,MAMASA,MAMBI,SALUDURIAN,65,55,2,0,0,0,0,0,2,0,0,0,10,5,5,5,28,17,11,7,6,1,5,0,29,25,4,4,JUNI
SULAWESI BARAT,MAMASA,MEHALAAN,MEHALAAN,35,25,0,0,0,0,0,0,0,0,0,0,5,2,3,1,25,23,2,20,25,10,15,2,15,14,1,5,JUNI
SULAWESI BARAT,MAMASA,MEHALAAN,BOTTENG,46,22,10,3,0,0,0,5,2,2,0,2,9,7,2,5,12,7,5,7,1,1,0,0,8,8,0,4,JUNI
SULAWESI BARAT,MAMASA,MEHALAAN,SALUKONTA,40,38,24,22,4,3,1,2,5,13,1,14,6,6,0,3,37,15,22,14,0,0,0,0,13,10,3,8,JUNI
SULAWESI BARAT,MAMASA,MEHALAAN,MESAKADA,93,70,34,24,22,3,3,1,23,2,26,7,17,15,2,6,68,57,11,39,27,27,0,2,76,42,34,26,JUNI
SULAWESI BARAT,MAMASA,MEHALAAN,MEHALAAN BARAT,84,33,15,14,8,6,4,7,4,0,7,8,15,13,2,0,15,11,4,3,5,0,5,0,28,21,7,10,JUNI
SULAWESI BARAT,MAMASA,MEHALAAN,SALUAHOK,68,43,17,4,2,1,1,4,1,2,9,0,2,2,0,2,30,22,8,4,17,13,4,7,34,18,16,16,JUNI
SULAWESI BARAT,MAMASA,MEHALAAN,SALUBALO,84,10,1,0,0,0,0,1,0,0,0,1,12,11,1,10,10,10,0,4,7,0,7,0,8,0,8,3,JUNI
SULAWESI BARAT,MAMASA,MEHALAAN,PASSEMBUK,90,39,6,2,2,0,0,2,1,0,0,5,2,2,0,2,39,37,2,5,22,17,5,13,47,33,14,45,JUNI
SULAWESI BARAT,MAMASA,MEHALAAN,KONDO,76,64,6,2,0,0,0,1,4,1,3,1,3,3,0,3,14,8,6,2,5,3,2,3,42,7,35,28,JUNI
SULAWESI BARAT,MAMASA,MEHALAAN,LEKO SUKAMAJU,53,55,4,3,3,1,0,0,4,0,1,0,9,7,2,5,45,13,32,0,17,4,13,1,5,1,4,1,JUNI
SULAWESI BARAT,MAMASA,MEHALAAN,ULUMEA,36,58,0,0,0,0,0,0,0,0,0,0,7,5,2,5,58,7,51,2,24,20,4,5,43,43,0,32,JUNI
SULAWESI BARAT,MAMASA,MESSAWA,MESSAWA,69,15,5,1,0,0,0,1,2,0,0,5,12,11,1,11,10,5,5,5,3,0,3,0,0,0,0,0,JUNI
SULAWESI BARAT,MAMASA,MESSAWA,RIPPUNG,78,39,39,29,14,7,0,6,17,3,6,1,7,0,7,0,11,7,4,6,4,2,2,1,16,7,9,13,JUNI
SULAWESI BARAT,MAMASA,MESSAWA,MAKUANG,99,35,35,6,5,5,4,26,3,2,2,15,16,11,5,10,21,6,15,0,2,0,2,0,20,9,11,5,JUNI
SULAWESI BARAT,MAMASA,MESSAWA,SEPANG,84,27,18,16,9,9,4,1,0,3,17,1,15,9,6,7,14,5,9,5,12,12,0,2,8,3,5,3,JUNI
SULAWESI BARAT,MAMASA,MESSAWA,MALIMBONG,37,58,21,1,1,0,0,19,2,0,8,5,7,3,4,2,21,17,4,16,8,6,2,6,14,7,7,6,JUNI
SULAWESI BARAT,MAMASA,MESSAWA,MATANDE,30,31,25,24,0,0,0,22,1,1,24,1,2,2,0,1,30,12,18,12,2,2,0,0,18,5,13,14,JUNI
SULAWESI BARAT,MAMASA,MESSAWA,SIPAI,41,55,40,24,24,10,1,4,4,3,8,18,3,0,3,0,47,9,38,1,41,0,41,0,8,1,7,1,JUNI
SULAWESI BARAT,MAMASA,MESSAWA,PASMA MAMBU,69,11,2,0,0,0,0,1,1,0,1,0,13,0,13,0,11,9,2,9,6,5,1,3,13,4,9,9,JUNI
SULAWESI BARAT,MAMASA,MESSAWA,TANETE BATU,91,27,14,6,5,1,0,3,9,2,5,4,13,8,5,2,14,10,4,7,6,6,0,4,23,15,8,5,JUNI
SULAWESI BARAT,MAMASA,NOSU,NOSU,52,20,12,12,3,2,2,4,1,3,6,3,3,2,1,2,17,7,10,4,1,0,1,0,11,0,11,9,JUNI
SULAWESI BARAT,MAMASA,NOSU,MINANGA,49,48,37,32,15,15,0,16,20,1,8,10,9,9,0,6,17,6,11,5,6,6,0,5,12,2,10,8,JUNI
SULAWESI BARAT,MAMASA,NOSU,BATUPAPAN,59,17,2,2,0,0,0,0,0,2,2,0,0,0,0,0,10,10,0,4,9,5,4,1,11,9,2,3,JUNI
SULAWESI BARAT,MAMASA,NOSU,MASEWWE,78,37,31,20,12,4,1,29,0,1,26,3,4,0,4,0,37,33,4,18,0,0,0,0,24,17,7,6,JUNI
SULAWESI BARAT,MAMASA,NOSU,SIWI,53,62,50,3,0,0,0,20,7,17,50,0,6,5,1,4,42,32,10,5,19,2,17,2,38,16,22,0,JUNI
SULAWESI BARAT,MAMASA,NOSU,MINANGA TIMUR,94,80,15,9,0,0,0,7,7,0,11,2,14,1,13,0,70,5,65,1,52,27,25,23,38,12,26,21,JUNI
SULAWESI BARAT,MAMASA,NOSU,PARINDING,41,51,48,1,0,0,0,18,20,9,20,4,2,0,2,0,16,8,8,1,0,0,0,0,24,17,7,3,JUNI
SULAWESI BARAT,MAMASA,PANA,PANA,72,29,4,3,2,1,0,2,0,0,4,0,3,3,0,1,22,14,8,8,14,11,3,8,32,10,22,10,JUNI
SULAWESI BARAT,MAMASA,PANA,MANIPI,59,29,24,17,5,3,2,16,1,1,5,18,4,2,2,0,23,13,10,11,1,0,1,0,9,2,7,1,JUNI
SULAWESI BARAT,MAMASA,PANA,MAMULLU,85,33,13,13,4,3,1,4,5,2,8,0,7,7,0,4,17,10,7,8,17,17,0,17,27,3,24,6,JUNI
SULAWESI BARAT,MAMASA,PANA,SAPAN,90,23,8,7,4,2,1,7,0,0,0,3,7,0,7,0,17,7,10,5,12,6,6,0,28,26,2,3,JUNI
SULAWESI BARAT,MAMASA,PANA,DATUBARINGAN,75,65,31,12,4,2,1,23,1,4,8,10,0,0,0,0,27,7,20,2,9,2,7,0,52,9,43,43,JUNI
SULAWESI BARAT,MAMASA,PANA,PANURA,73,60,52,19,5,4,0,44,1,4,2,14,7,5,2,4,39,18,21,6,19,16,3,14,47,16,31,21,JUNI
SULAWESI BARAT,MAMASA,PANA,TALLANG BULAWAN,96,25,4,0,0,0,0,3,1,0,2,0,16,5,11,2,22,14,8,3,22,6,16,2,14,3,11,14,JUNI
SULAWESI BARAT,MAMASA,PANA,KARAKA,66,68,43,30,10,10,4,25,7,7,37,2,11,10,1,6,48,15,33,1,34,6,28,2,24,6,18,1,JUNI
SULAWESI BARAT,MAMASA,PANA,ULUSALU,84,14,4,4,0,0,0,3,0,1,0,0,8,0,8,0,12,11,1,10,3,3,0,1,2,1,1,0,JUNI
SULAWESI BARAT,MAMASA,PANA,WERI,94,37,30,3,2,2,0,7,15,3,21,3,12,6,6,0,30,14,16,14,18,3,15,3,0,0,0,0,JUNI
SULAWESI BARAT,MAMASA,PANA,SALUTAMBUN,83,59,56,15,1,1,0,56,0,0,48,2,8,6,2,0,16,11,5,6,16,9,7,3,30,25,5,13,JUNI
SULAWESI BARAT,MAMASA,PANA,SALOAN,89,32,23,12,6,4,0,15,4,4,14,7,11,0,11,0,10,6,4,3,4,2,2,0,14,13,1,6,JUNI
SULAWESI BARAT,MAMASA,PANA,ULUSALU INDAH,30,14,6,4,1,1,1,4,1,0,6,0,5,0,5,0,10,9,1,5,8,5,3,3,7,7,0,1,JUNI
SULAWESI BARAT,MAMASA,RANTEBULAHAN TIMUR,SALUMOKANAN,56,73,11,11,2,2,1,7,3,0,1,1,7,6,1,6,62,16,46,15,28,27,1,21,49,32,17,46,JUNI
SULAWESI BARAT,MAMASA,RANTEBULAHAN TIMUR,SALUMOKANAN BARAT,39,80,26,12,6,6,5,16,2,2,14,4,3,1,2,0,58,6,52,3,38,0,38,0,1,0,1,1,JUNI
SULAWESI BARAT,MAMASA,RANTEBULAHAN TIMUR,BUANGIN,73,13,0,0,0,0,0,0,0,0,0,0,5,0,5,0,10,10,0,9,4,0,4,0,1,1,0,0,JUNI
SULAWESI BARAT,MAMASA,RANTEBULAHAN TIMUR,BAMBANG BUDA,36,27,19,0,0,0,0,8,9,1,14,2,0,0,0,0,16,14,2,11,8,5,3,2,14,14,0,4,JUNI
SULAWESI BARAT,MAMASA,RANTEBULAHAN TIMUR,LEKO,56,50,31,28,18,14,6,0,8,0,31,0,3,0,3,0,39,35,4,28,13,13,0,2,37,2,35,20,JUNI
SULAWESI BARAT,MAMASA,RANTEBULAHAN TIMUR,KIRAK,37,21,0,0,0,0,0,0,0,0,0,0,2,1,1,1,21,10,11,4,13,12,1,4,7,7,0,2,JUNI
SULAWESI BARAT,MAMASA,RANTEBULAHAN TIMUR,SALUMOKANAN UTARA,51,26,21,11,9,0,0,20,1,0,17,1,8,5,3,5,14,5,9,5,1,0,1,0,12,10,2,0,JUNI
SULAWESI BARAT,MAMASA,RANTEBULAHAN TIMUR,SAMPALE,57,54,20,0,0,0,0,9,4,6,10,7,0,0,0,0,31,7,24,6,6,6,0,5,36,18,18,7,JUNI
SULAWESI BARAT,MAMASA,SESENAPADANG,OROBUA,81,65,7,4,4,0,0,6,0,1,4,0,8,8,0,4,48,7,41,6,10,8,2,5,53,44,9,43,JUNI
SULAWESI BARAT,MAMASA,SESENAPADANG,PALADAN,83,53,23,4,4,1,0,20,3,0,4,11,7,5,2,5,25,22,3,12,24,14,10,5,52,19,33,43,JUNI
SULAWESI BARAT,MAMASA,SESENAPADANG,OROBUA TIMUR,69,19,4,3,3,0,0,0,4,0,4,0,7,6,1,4,13,5,8,4,1,1,0,1,0,0,0,0,JUNI
SULAWESI BARAT,MAMASA,SESENAPADANG,RANTE PUANG,76,41,15,6,6,4,3,6,3,0,3,0,14,7,7,3,13,12,1,6,13,0,13,0,37,9,28,8,JUNI
SULAWESI BARAT,MAMASA,SESENAPADANG,SATENETEAN,87,20,0,0,0,0,0,0,0,0,0,0,2,0,2,0,16,10,6,1,2,2,0,2,13,7,6,12,JUNI
SULAWESI BARAT,MAMASA,SESENAPADANG,LISUAN ADA,77,35,12,8,0,0,0,11,1,0,1,1,7,2,5,1,17,13,4,11,10,5,5,3,18,6,12,1,JUNI
SULAWESI BARAT,MAMASA,SESENAPADANG,OROBUA SELATAN,71,30,25,16,13,8,5,12,8,0,16,1,3,2,1,0,16,11,5,1,11,11,0,6,4,0,4,0,JUNI
SULAWESI BARAT,MAMASA,SESENAPADANG,MALANGKENA PADANG,65,33,7,5,4,2,1,6,0,0,1,1,10,3,7,2,18,8,10,5,15,15,0,14,21,2,19,12,JUNI
SULAWESI BARAT,MAMASA,SESENAPADANG,MALIMBONG,52,75,30,6,1,0,0,17,11,0,30,0,5,3,2,2,32,15,17,5,20,19,1,14,70,2,68,33,JUNI
SULAWESI BARAT,MAMASA,SESENAPADANG,MARAMPAN OROBUA,91,38,21,1,1,0,0,6,14,0,0,10,12,10,2,2,37,16,21,16,26,2,24,2,45,34,11,38,JUNI
SULAWESI BARAT,MAMASA,SUMARORONG,SUMARORONG,72,36,1,0,0,0,0,0,0,1,1,0,12,3,9,3,19,13,6,6,9,5,4,3,18,15,3,4,JUNI
SULAWESI BARAT,MAMASA,SUMARORONG,TABONE,33,74,41,36,8,4,2,11,16,5,30,1,1,0,1,0,26,12,14,12,5,5,0,4,4,3,1,1,JUNI
SULAWESI BARAT,MAMASA,SUMARORONG,BATANG URU,49,72,59,28,9,3,1,34,14,8,27,22,7,2,5,0,30,29,1,23,18,1,17,1,35,21,14,33,JUNI
SULAWESI BARAT,MAMASA,SUMARORONG,SASAKAN,77,16,10,7,1,1,0,6,0,0,10,0,8,4,4,2,13,12,1,12,2,2,0,1,0,0,0,0,JUNI
SULAWESI BARAT,MAMASA,SUMARORONG,TADISI,61,40,3,3,0,0,0,2,0,1,3,0,2,0,2,0,26,16,10,15,20,18,2,18,37,3,34,1,JUNI
SULAWESI BARAT,MAMASA,SUMARORONG,SIBANAWA,66,66,20,16,15,14,12,4,4,0,20,0,12,0,12,0,64,19,45,6,46,15,31,7,14,10,4,10,JUNI
SULAWESI BARAT,MAMASA,SUMARORONG,BATANGNGURU TIMUR,47,53,2,2,1,1,0,2,0,0,1,1,1,0,1,0,33,23,10,21,5,3,2,1,33,14,19,32,JUNI
SULAWESI BARAT,MAMASA,SUMARORONG,SALUBALO,56,27,6,5,1,0,0,1,3,2,3,2,11,11,0,5,23,6,17,4,18,17,1,14,11,10,1,1,JUNI
SULAWESI BARAT,MAMASA,SUMARORONG,BANEA,77,19,14,4,0,0,0,1,8,4,4,6,8,0,8,0,15,12,3,2,12,12,0,5,1,0,1,1,JUNI
SULAWESI BARAT,MAMASA,SUMARORONG,RANTE KAMASE,65,46,0,0,0,0,0,0,0,0,0,0,12,1,11,0,21,11,10,7,12,0,12,0,0,0,0,0,JUNI
SULAWESI BARAT,MAMASA,TABANG,TABANG,85,49,44,27,4,0,0,16,28,0,2,24,14,9,5,9,38,29,9,29,34,20,14,14,4,0,4,3,JUNI
SULAWESI BARAT,MAMASA,TABANG,TADOKALUA,52,38,8,1,1,0,0,4,4,0,5,2,9,0,9,0,35,17,18,13,12,6,6,1,8,5,3,2,JUNI
SULAWESI BARAT,MAMASA,TABANG,TABANG BARAT,41,17,4,4,3,0,0,3,0,0,2,1,2,1,1,1,14,6,8,0,13,7,6,1,2,2,0,2,JUNI
SULAWESI BARAT,MAMASA,TABANG,MASUPU,60,55,25,18,2,2,0,25,0,0,4,1,2,0,2,0,43,22,21,0,14,12,2,10,21,10,11,9,JUNI
SULAWESI BARAT,MAMASA,TABANG,KALAMA,93,56,7,5,1,0,0,2,0,5,3,0,11,0,11,0,27,27,0,25,9,3,6,1,39,24,15,39,JUNI
SULAWESI BARAT,MAMASA,TABANG,BAKADISURA,44,56,23,5,2,1,0,10,5,6,8,3,0,0,0,0,32,23,9,2,7,7,0,6,2,2,0,0,JUNI
SULAWESI BARAT,MAMASA,TABANG,SALUKONA,33,70,10,0,0,0,0,1,1,8,6,1,2,0,2,0,58,33,25,29,56,20,36,20,9,1,8,3,JUNI
SULAWESI BARAT,MAMASA,TABULAHAN,LAKAHANG,85,35,27,11,10,1,0,1,25,0,11,15,11,9,2,0,26,26,0,18,24,19,5,1,25,23,2,24,JUNI
SULAWESI BARAT,MAMASA,TABULAHAN,PERIANGAN,53,75,33,2,1,0,0,24,6,1,25,4,4,2,2,1,65,31,34,25,25,23,2,13,70,1,69,53,JUNI
SULAWESI BARAT,MAMASA,TABULAHAN,MALATIRO,51,12,10,3,1,0,0,2,5,2,4,4,2,2,0,1,11,8,3,3,0,0,0,0,7,6,1,5,JUNI
SULAWESI BARAT,MAMASA,TABULAHAN,TABULAHAN,66,77,8,5,1,0,0,0,2,5,6,0,11,4,7,0,22,16,6,5,10,0,10,0,31,11,20,16,JUNI
SULAWESI BARAT,MAMASA,TABULAHAN,SALULEANG,87,33,33,28,26,1,0,7,18,0,16,0,17,15,2,12,29,14,15,1,23,0,23,0,0,0,0,0,JUNI
SULAWESI BARAT,MAMASA,TABULAHAN,TAMPAK KURRA,56,43,28,28,24,21,2,23,3,0,1,4,4,1,3,1,29,7,22,5,2,0,2,0,22,18,4,12,JUNI
SULAWESI BARAT,MAMASA,TABULAHAN,GANDANG DEWATA,57,12,2,2,1,0,0,1,1,0,1,0,11,10,1,4,10,6,4,5,0,0,0,0,4,3,1,0,JUNI
SULAWESI BARAT,MAMASA,TABULAHAN,BURANA,79,43,23,22,6,2,0,4,12,3,13,8,1,1,0,0,23,7,16,0,5,5,0,0,7,6,1,2,JUNI
SULAWESI BARAT,MAMASA,TABULAHAN,SALUBAKKA,96,41,5,1,1,0,0,2,1,1,5,0,18,10,8,0,22,22,0,7,13,10,3,2,29,15,14,20,JUNI
SULAWESI BARAT,MAMASA,TABULAHAN,PANGANDARAN,34,27,5,2,0,0,0,3,0,1,3,2,0,0,0,0,24,6,18,6,15,12,3,2,14,0,14,6,JUNI
SULAWESI BARAT,MAMASA,TABULAHAN,TALOPAK,90,33,6,4,3,1,0,2,3,0,0,2,10,1,9,1,12,5,7,1,5,4,1,4,0,0,0,0,JUNI
SULAWESI BARAT,MAMASA,TABULAHAN,PEU',46,17,8,0,0,0,0,1,0,5,5,1,7,0,7,0,14,7,7,5,5,5,0,4,5,2,3,4,JUNI
SULAWESI BARAT,MAMASA,TABULAHAN,TIMORO,63,67,45,14,12,1,0,35,6,3,44,0,10,5,5,5,15,15,0,8,11,8,3,4,17,0,17,17,JUNI
SULAWESI BARAT,MAMASA,TABULAHAN,LAKAHANG UTAMA,31,78,24,17,17,7,3,19,1,0,23,0,0,0,0,0,48,23,25,5,40,35,5,32,61,60,1,57,JUNI
SULAWESI BARAT,MAMASA,TANDUK KALUA,MINAKE,98,20,19,1,0,0,0,16,0,2,8,5,9,9,0,7,13,8,5,8,2,2,0,0,3,1,2,2,JUNI
SULAWESI BARAT,MAMASA,TANDUK KALUA,MALABO,67,37,28,7,5,0,0,28,0,0,24,1,5,3,2,1,19,15,4,2,19,18,1,0,29,19,10,17,JUNI
SULAWESI BARAT,MAMASA,TANDUK KALUA,SINDAGAMANIK,98,20,16,14,11,11,10,6,0,0,15,0,3,2,1,0,18,10,8,6,12,2,10,1,21,16,5,1,JUNI
SULAWESI BARAT,MAMASA,TANDUK KALUA,PARONDOBULAWAN,90,80,22,7,2,0,0,7,1,0,11,6,15,5,10,2,20,10,10,4,1,0,1,0,44,2,42,16,JUNI
SULAWESI BARAT,MAMASA,TANDUK KALUA,TAMALANTIK,82,20,9,4,1,0,0,7,0,1,1,6,11,4,7,0,19,8,11,8,6,5,1,2,0,0,0,0,JUNI
SULAWESI BARAT,MAMASA,TANDUK KALUA,MANNABABA,47,13,3,3,1,0,0,0,1,0,2,1,7,5,2,0,12,6,6,5,4,1,3,1,6,1,5,6,JUNI
SULAWESI BARAT,MAMASA,TANDUK KALUA,MESAKADA,42,36,25,22,13,11,10,14,0,1,23,1,0,0,0,0,28,18,10,1,18,9,9,4,35,4,31,22,JUNI
SULAWESI BARAT,MAMASA,TANDUK KALUA,BALLABATU,31,66,22,6,1,0,0,2,3,13,11,1,3,2,1,2,48,12,36,0,30,17,13,4,15,3,12,15,JUNI
SULAWESI BARAT,MAMASA,TANDUK KALUA,PAMBE,86,63,45,2,0,0,0,22,4,8,3,8,12,9,3,1,32,16,16,4,6,6,0,6,20,12,8,17,JUNI
SULAWESI BARAT,MAMASA,TANDUK KALUA,SALURANO,58,43,4,1,1,1,0,4,0,0,0,0,2,2,0,2,10,5,5,0,4,4,0,2,23,6,17,2,JUNI
SULAWESI BARAT,MAMASA,TANDUK KALUA,TALIMBUNG,42,48,8,5,2,1,1,1,4,2,6,0,3,0,3,0,32,19,13,13,15,3,12,1,34,30,4,29,JUNI
SULAWESI BARAT,MAMASA,TANDUK KALUA,KANAN,33,35,13,3,3,0,0,5,5,1,9,3,2,2,0,0,32,30,2,28,28,14,14,7,37,8,29,3,JUNI
SULAWESI BARAT,MAMASA,TAWALIAN,TAWALIAN,41,67,57,31,22,6,0,5,45,3,4,25,3,1,2,1,49,13,36,0,25,22,3,15,71,37,34,55,JUNI
SULAWESI BARAT,MAMASA,TAWALIAN,TAWALIAN TIMUR,33,61,14,1,0,0,0,9,3,1,0,3,4,0,4,0,11,7,4,4,7,6,1,1,18,11,7,8,JUNI
SULAWESI BARAT,MAMASA,TAWALIAN,KARIANGO,49,23,12,7,7,7,1,8,2,1,8,2,9,2,7,1,10,9,1,4,10,9,1,3,26,15,11,0,JUNI
SULAWESI BARAT,MAMASA,TAWALIAN,RANTETANGNGA,52,59,46,1,1,1,0,45,1,0,41,4,10,4,6,2,22,16,6,15,9,0,9,0,46,29,17,44,JUNI
SULAWESI BARAT,POLEWALI MANDAR,ALLU,PETOOSANG,97,24,6,6,4,4,3,1,1,1,2,3,13,2,11,0,17,5,12,1,16,11,5,5,13,7,6,1,JUNI
SULAWESI BARAT,POLEWALI MANDAR,ALLU,MOMBI,100,67,12,10,7,5,3,1,7,1,4,5,0,0,0,0,26,20,6,3,18,6,12,3,31,23,8,5,JUNI
SULAWESI BARAT,POLEWALI MANDAR,ALLU,KALUMAMMANG,92,60,44,17,0,0,0,8,30,3,36,7,7,0,7,0,57,31,26,20,46,30,16,4,41,8,33,15,JUNI
SULAWESI BARAT,POLEWALI MANDAR,ALLU,PAO-PAO,88,74,12,4,0,0,0,12,0,0,7,4,8,8,0,6,66,63,3,48,52,2,50,0,50,29,21,41,JUNI
SULAWESI BARAT,POLEWALI MANDAR,ALLU,PUPPU URING,65,66,64,0,0,0,0,4,43,16,16,32,12,2,10,1,22,12,10,4,14,0,14,0,43,40,3,5,JUNI
SULAWESI BARAT,POLEWALI MANDAR,ALLU,SARAGIAN,81,54,24,1,0,0,0,10,0,9,13,8,15,5,10,4,37,24,13,2,2,1,1,0,2,2,0,2,JUNI
SULAWESI BARAT,POLEWALI MANDAR,ALLU,SAYOANG,93,52,9,5,1,1,1,2,2,2,6,1,6,3,3,3,52,12,40,10,46,45,1,35,77,64,13,48,JUNI
SULAWESI BARAT,POLEWALI MANDAR,ALLU,ALU,35,49,28,11,0,0,0,12,3,7,3,8,2,0,2,0,41,10,31,3,36,5,31,4,29,22,7,4,JUNI
SULAWESI BARAT,POLEWALI MANDAR,ANREAPI,ANREAPI,48,28,27,27,14,12,3,13,9,2,17,3,0,0,0,0,24,22,2,15,1,1,0,1,9,7,2,4,JUNI
SULAWESI BARAT,POLEWALI MANDAR,ANREAPI,DUAMPANUA,65,26,0,0,0,0,0,0,0,0,0,0,9,0,9,0,23,6,17,2,2,2,0,2,14,14,0,11,JUNI
SULAWESI BARAT,POLEWALI MANDAR,ANREAPI,KELAPA DUA,60,53,8,4,0,0,0,1,6,0,4,2,2,1,1,1,42,38,4,26,11,0,11,0,39,0,39,14,JUNI
SULAWESI BARAT,POLEWALI MANDAR,ANREAPI,PAPPANDANGAN,69,23,4,0,0,0,0,3,1,0,0,3,0,0,0,0,13,5,8,1,10,0,10,0,26,12,14,18,JUNI
SULAWESI BARAT,POLEWALI MANDAR,ANREAPI,KUNYI,55,66,7,1,0,0,0,3,3,1,5,0,9,2,7,0,57,14,43,8,18,12,6,12,27,16,11,3,JUNI
SULAWESI BARAT,POLEWALI MANDAR,BALANIPA,BALANIPA,70,23,3,1,1,0,0,0,2,1,3,0,0,0,0,0,19,6,13,3,0,0,0,0,15,0,15,10,JUNI
SULAWESI BARAT,POLEWALI MANDAR,BALANIPA,TAMMAJARRA,43,77,24,9,9,0,0,20,0,4,18,1,5,2,3,1,35,30,5,15,13,4,9,0,28,8,20,18,JUNI
SULAWESI BARAT,POLEWALI MANDAR,BALANIPA,TAMANGGALLE,78,75,51,49,12,4,3,43,5,0,46,5,2,1,1,0,36,12,24,0,21,6,15,2,1,0,1,0,JUNI
SULAWESI BARAT,POLEWALI MANDAR,BALANIPA,MOSSO,99,38,22,21,19,13,0,13,6,0,18,1,12,0,12,0,29,24,5,23,14,4,10,4,13,9,4,12,JUNI
SULAWESI BARAT,POLEWALI MANDAR,BALANIPA,GALUNG TULUK,92,51,17,11,11,9,2,3,1,5,15,2,2,0,2,0,43,30,13,16,17,1,16,1,6,0,6,6,JUNI
SULAWESI BARAT,POLEWALI MANDAR,BALANIPA,SABANG SUBIK,88,29,24,16,3,0,0,15,0,8,9,7,8,2,6,0,25,10,15,1,9,6,3,5,8,2,6,3,JUNI
SULAWESI BARAT,POLEWALI MANDAR,BALANIPA,PAMBUSUANG,49,26,19,3,0,0,0,5,14,0,13,6,9,2,7,1,12,10,2,10,9,2,7,2,12,3,9,5,JUNI
SULAWESI BARAT,POLEWALI MANDAR,BALANIPA,BALA,62,39,10,8,6,5,1,3,0,2,1,6,11,1,10,0,17,15,2,0,8,1,7,1,14,5,9,8,JUNI
SULAWESI BARAT,POLEWALI MANDAR,BALANIPA,LAMBANAN,56,45,4,4,3,0,0,0,4,0,2,1,5,5,0,1,21,18,3,1,4,4,0,0,33,16,17,27,JUNI
SULAWESI BARAT,POLEWALI MANDAR,BALANIPA,LEGO,66,67,53,23,4,0,0,25,10,8,53,0,6,2,4,2,38,22,16,2,13,11,2,3,6,6,0,4,JUNI
SULAWESI BARAT,POLEWALI MANDAR,BALANIPA,PALLIS,91,31,23,20,17,4,0,20,3,0,16,5,5,1,4,1,26,25,1,9,26,21,5,16,24,18,6,10,JUNI
SULAWESI BARAT,POLEWALI MANDAR,BINUANG,AMASSANGAN,87,44,12,9,7,4,1,1,4,1,4,4,14,2,12,1,26,22,4,20,12,10,2,1,11,3,8,2,JUNI
SULAWESI BARAT,POLEWALI MANDAR,BINUANG,TONYAMAN,54,46,31,12,2,1,0,11,8,2,16,0,2,2,0,0,14,5,9,0,0,0,0,0,32,7,25,7,JUNI
SULAWESI BARAT,POLEWALI MANDAR,BINUANG,KUAJANG,72,17,7,5,3,1,1,1,0,0,0,7,6,0,6,0,11,5,6,1,9,2,7,1,9,4,5,1,JUNI
SULAWESI BARAT,POLEWALI MANDAR,BINUANG,PAKU,91,38,6,5,3,1,0,4,2,0,4,2,1,1,0,0,26,22,4,13,23,10,13,6,48,16,32,14,JUNI
SULAWESI BARAT,POLEWALI MANDAR,BINUANG,MIRRING,39,56,23,21,14,4,0,11,12,0,16,0,5,5,0,0,37,5,32,5,31,27,4,15,38,16,22,0,JUNI
SULAWESI BARAT,POLEWALI MANDAR,BINUANG,BATETANGNGA,85,26,2,0,0,0,0,1,0,1,2,0,8,3,5,1,24,8,16,4,4,4,0,3,9,9,0,6,JUNI
SULAWESI BARAT,POLEWALI MANDAR,BINUANG,MAMMI,91,57,9,3,3,1,1,6,2,0,0,5,5,5,0,2,28,5,23,4,22,6,16,5,19,4,15,18,JUNI
SULAWESI BARAT,POLEWALI MANDAR,BINUANG,KALEOK,54,41,12,7,2,0,0,9,1,0,10,1,8,3,5,1,33,18,15,15,19,19,0,4,44,21,23,22,JUNI
SULAWESI BARAT,POLEWALI MANDAR,BINUANG,AMOLA,80,50,37,33,7,3,3,7,10,5,35,2,5,3,2,0,41,11,30,1,18,0,18,0,12,8,4,8,JUNI
SULAWESI BARAT,POLEWALI MANDAR,BINUANG,REA,97,27,14,3,2,2,2,9,0,2,5,0,0,0,0,0,20,12,8,7,2,0,2,0,10,10,0,8,JUNI
SULAWESI BARAT,POLEWALI MANDAR,BULO,BULO,68,72,16,2,0,0,0,14,1,0,11,2,9,9,0,0,15,14,1,14,12,1,11,0,36,1,35,21,JUNI
SULAWESI BARAT,POLEWALI MANDAR,BULO,PULLIWA,83,76,16,5,0,0,0,3,7,3,16,0,3,2,1,1,72,5,67,0,41,36,5,22,18,7,11,3,JUNI
SULAWESI BARAT,POLEWALI MANDAR,BULO,PATAMBANUA,75,63,9,5,0,0,0,2,6,1,0,1,8,1,7,0,63,46,17,33,12,3,9,3,40,25,15,26,JUNI
SULAWESI BARAT,POLEWALI MANDAR,BULO,KAROMBANG,51,31,12,10,5,3,0,12,0,0,6,2,2,2,0,2,19,11,8,0,8,7,1,7,6,6,0,6,JUNI
SULAWESI BARAT,POLEWALI MANDAR,BULO,DAALA TIMUR,77,33,0,0,0,0,0,0,0,0,0,0,13,7,6,0,24,20,4,3,21,15,6,13,40,6,34,9,JUNI
SULAWESI BARAT,POLEWALI MANDAR,BULO,LENGGO,57,43,24,23,3,2,0,2,11,3,9,11,11,6,5,3,30,27,3,15,24,1,23,0,37,26,11,8,JUNI
SULAWESI BARAT,POLEWALI MANDAR,BULO,SABURA,49,21,16,1,1,0,0,11,3,0,9,2,5,3,2,1,13,6,7,0,10,4,6,3,9,6,3,6,JUNI
SULAWESI BARAT,POLEWALI MANDAR,BULO,SEPPORRAKI,80,42,35,15,2,0,0,0,23,4,25,7,13,1,12,1,33,10,23,1,28,4,24,2,25,10,15,3,JUNI
SULAWESI BARAT,POLEWALI MANDAR,BULO,IHING,58,53,45,9,2,2,2,16,27,0,26,4,11,3,8,1,50,10,40,2,6,4,2,4,10,5,5,10,JUNI
SULAWESI BARAT,POLEWALI MANDAR,CAMPALAGIAN,PAPPANG,44,10,5,5,0,0,0,3,0,2,3,1,5,2,3,1,10,8,2,3,0,0,0,0,6,6,0,0,JUNI
SULAWESI BARAT,POLEWALI MANDAR,CAMPALAGIAN,LALIKO,66,22,16,10,0,0,0,6,5,5,13,2,11,3,8,0,15,10,5,6,3,3,0,2,17,8,9,7,JUNI
SULAWESI BARAT,POLEWALI MANDAR,CAMPALAGIAN,BONDE,86,56,30,20,9,9,3,9,9,6,9,6,11,9,2,9,33,28,5,8,27,18,9,3,50,10,40,9,JUNI
SULAWESI BARAT,POLEWALI MANDAR,CAMPALAGIAN,KATUMBANGAN LEMO,97,80,67,27,21,3,3,19,16,3,23,41,5,3,2,1,65,29,36,2,15,15,0,15,15,7,8,8,JUNI
SULAWESI BARAT,POLEWALI MANDAR,CAMPALAGIAN,PANYAMPA,94,48,42,15,4,4,4,37,0,0,11,8,2,0,2,0,41,30,11,1,21,21,0,6,4,0,4,4,JUNI
SULAWESI BARAT,POLEWALI MANDAR,CAMPALAGIAN,SURUANG,60,19,1,0,0,0,0,1,0,0,0,1,6,2,4,0,17,12,5,6,0,0,0,0,13,8,5,1,JUNI
SULAWESI BARAT,POLEWALI MANDAR,CAMPALAGIAN,LAMPOKO,70,27,26,18,5,4,4,5,6,0,13,6,8,7,1,5,18,9,9,3,9,7,2,3,7,6,1,2,JUNI
SULAWESI BARAT,POLEWALI MANDAR,CAMPALAGIAN,KATUMBANGAN,86,15,1,1,0,0,0,1,0,0,0,1,14,5,9,4,14,13,1,12,14,11,3,3,9,1,8,0,JUNI
SULAWESI BARAT,POLEWALI MANDAR,CAMPALAGIAN,LAPEO,58,33,33,29,5,2,1,26,5,1,2,11,8,5,3,1,31,11,20,4,0,0,0,0,2,2,0,2,JUNI
SULAWESI BARAT,POLEWALI MANDAR,CAMPALAGIAN,PARAPPE,73,10,1,1,1,1,1,0,0,0,0,1,12,7,5,3,10,5,5,4,4,4,0,1,7,6,1,0,JUNI
SULAWESI BARAT,POLEWALI MANDAR,CAMPALAGIAN,ONGKO,77,23,6,6,6,3,0,0,6,0,2,1,4,4,0,0,13,11,2,6,4,2,2,1,17,16,1,3,JUNI
SULAWESI BARAT,POLEWALI MANDAR,CAMPALAGIAN,KENJE,57,38,13,12,7,7,3,8,0,0,6,7,3,3,0,2,31,17,14,5,24,22,2,21,47,0,47,29,JUNI
SULAWESI BARAT,POLEWALI MANDAR,CAMPALAGIAN,SUMARRANG,97,36,31,4,3,2,0,2,8,8,1,26,13,3,10,1,26,12,14,11,24,23,1,6,3,1,2,0,JUNI
SULAWESI BARAT,POLEWALI MANDAR,CAMPALAGIAN,BOTTO,30,30,25,18,1,1,1,1,1,8,1,5,0,0,0,0,10,6,4,0,1,0,1,0,10,1,9,7,JUNI
SULAWESI BARAT,POLEWALI MANDAR,CAMPALAGIAN,GATTUNGAN,36,79,72,60,39,9,6,19,30,2,28,1,0,0,0,0,62,51,11,47,27,2,25,2,49,1,48,25,JUNI
SULAWESI BARAT,POLEWALI MANDAR,CAMPALAGIAN,PADANG TIMUR,86,28,16,2,0,0,0,7,8,0,7,6,5,5,0,5,15,8,7,5,15,3,12,0,16,7,9,15,JUNI
SULAWESI BARAT,POLEWALI MANDAR,CAMPALAGIAN,PADANG,35,57,39,22,13,9,2,19,10,1,37,2,5,4,1,1,38,24,14,4,13,5,8,4,45,9,36,40,JUNI
SULAWESI BARAT,POLEWALI MANDAR,CAMPALAGIAN,LAGI-AGI,73,50,18,3,2,0,0,6,5,7,4,3,12,0,12,0,25,17,8,14,15,0,15,0,42,3,39,34,JUNI
SULAWESI BARAT,POLEWALI MANDAR,LIMBORO,LIMBORO,31,70,40,20,5,5,0,3,18,7,23,10,0,0,0,0,25,7,18,0,10,9,1,0,33,0,33,12,JUNI
SULAWESI BARAT,POLEWALI MANDAR,LIMBORO,LEMBANG LEMBANG,75,57,4,2,0,0,0,0,3,1,0,2,12,8,4,1,57,8,49,1,55,37,18,21,44,9,35,40,JUNI
SULAWESI BARAT,POLEWALI MANDAR,LIMBORO,TANDASURA,32,70,48,3,3,0,0,7,39,2,42,1,2,0,2,0,52,48,4,4,15,13,2,8,57,5,52,19,JUNI
SULAWESI BARAT,POLEWALI MANDAR,LIMBORO,SAMASUNDU,51,21,18,7,2,2,2,6,5,4,7,0,9,5,4,0,15,8,7,7,8,4,4,3,20,6,14,1,JUNI
SULAWESI BARAT,POLEWALI MANDAR,LIMBORO,NAPO,83,40,24,5,1,0,0,15,1,0,24,0,11,7,4,7,37,9,28,6,16,0,16,0,29,26,3,0,JUNI
SULAWESI BARAT,POLEWALI MANDAR,LIMBORO,TODANG TODANG,39,48,37,25,2,0,0,22,8,0,29,3,2,0,2,0,27,8,19,0,5,5,0,4,16,16,0,15,JUNI
SULAWESI BARAT,POLEWALI MANDAR,LIMBORO,PENDULANGAN,44,46,40,23,10,5,2,35,0,1,0,16,4,2,2,0,10,8,2,1,10,9,1,3,25,22,3,20,JUNI
SULAWESI BARAT,POLEWALI MANDAR,LIMBORO,RENGGEANG,39,41,20,17,8,1,1,8,11,0,19,1,2,2,0,2,41,19,22,1,31,6,25,5,4,4,0,0,JUNI
SULAWESI BARAT,POLEWALI MANDAR,LIMBORO,SALARRI,59,11,2,0,0,0,0,2,0,0,0,0,9,8,1,2,11,11,0,7,5,2,3,1,3,1,2,1,JUNI
SULAWESI BARAT,POLEWALI MANDAR,LIMBORO,TANGAN BARU,57,50,38,12,9,8,7,10,14,4,1,11,2,2,0,1,21,5,16,5,5,5,0,4,7,1,6,3,JUNI
SULAWESI BARAT,POLEWALI MANDAR,LIMBORO,PALECE,56,45,37,22,20,17,14,1,9,7,23,3,4,0,4,0,19,14,5,3,1,0,1,0,1,1,0,0,JUNI
SULAWESI BARAT,POLEWALI MANDAR,LUYO,BATUPANGA,62,48,16,1,1,1,1,8,0,5,3,1,12,11,1,8,42,22,20,14,4,4,0,0,17,15,2,8,JUNI
SULAWESI BARAT,POLEWALI MANDAR,LUYO,MAMBU,40,25,21,17,6,1,1,4,11,3,17,1,1,1,0,1,25,21,4,7,9,1,8,1,12,3,9,5,JUNI
SULAWESI BARAT,POLEWALI MANDAR,LUYO,TENGGELANG,88,37,9,1,1,1,1,2,4,1,9,0,13,9,4,9,20,5,15,5,17,8,9,6,1,1,0,1,JUNI
SULAWESI BARAT,POLEWALI MANDAR,LUYO,BARU,36,10,1,0,0,0,0,0,0,0,1,0,6,0,6,0,10,6,4,4,10,1,9,1,6,2,4,3,JUNI
SULAWESI BARAT,POLEWALI MANDAR,LUYO,PUSSUI,80,16,13,4,1,1,1,6,0,5,5,8,2,2,0,1,14,9,5,6,9,5,4,4,10,9,1,0,JUNI
SULAWESI BARAT,POLEWALI MANDAR,LUYO,MAPILI BARAT,40,25,0,0,0,0,0,0,0,0,0,0,3,2,1,1,10,9,1,2,3,1,2,1,15,2,13,0,JUNI
SULAWESI BARAT,POLEWALI MANDAR,LUYO,SAMBALI WALI,56,52,46,15,13,11,7,5,4,3,41,5,10,10,0,10,36,30,6,5,25,4,21,4,36,22,14,33,JUNI
SULAWESI BARAT,POLEWALI MANDAR,LUYO,BATUPANGA DAALA,31,57,18,9,9,3,2,3,6,3,5,7,3,3,0,0,51,25,26,8,48,32,16,22,54,50,4,15,JUNI
SULAWESI BARAT,POLEWALI MANDAR,LUYO,LUYO,87,65,65,14,7,7,4,12,3,29,10,14,8,6,2,3,44,35,9,31,16,8,8,6,11,4,7,6,JUNI
SULAWESI BARAT,POLEWALI MANDAR,LUYO,PUSSUI BARAT,70,80,66,64,53,23,19,43,0,1,34,29,11,10,1,6,67,11,56,0,39,5,34,1,19,17,2,18,JUNI
SULAWESI BARAT,POLEWALI MANDAR,LUYO,PUCCADI,74,35,20,14,3,0,0,4,11,1,4,3,13,6,7,5,31,16,15,0,19,16,3,15,40,3,37,25,JUNI
SULAWESI BARAT,POLEWALI MANDAR,MAPILLI,MAPILI,95,76,10,3,1,0,0,1,2,2,10,0,1,1,0,1,51,33,18,28,23,20,3,14,2,1,1,2,JUNI
SULAWESI BARAT,POLEWALI MANDAR,MAPILLI,UGIBARU,56,59,39,21,11,0,0,27,10,0,23,14,9,0,9,0,48,35,13,35,37,8,29,3,78,68,10,54,JUNI
SULAWESI BARAT,POLEWALI MANDAR,MAPILLI,RUMPA,34,39,10,0,0,0,0,7,3,0,0,9,6,1,5,0,29,21,8,18,0,0,0,0,0,0,0,0,JUNI
SULAWESI BARAT,POLEWALI MANDAR,MAPILLI,KURMA,94,80,24,19,15,6,3,11,1,4,11,7,13,4,9,1,14,6,8,2,9,7,2,4,9,9,0,3,JUNI
SULAWESI BARAT,POLEWALI MANDAR,MAPILLI,BUKU,71,47,27,9,0,0,0,26,0,1,0,0,2,0,2,0,21,13,8,11,1,0,1,0,23,16,7,20,JUNI
SULAWESI BARAT,POLEWALI MANDAR,MAPILLI,BONNE BONNE,99,19,9,6,2,2,2,4,2,1,3,4,18,15,3,12,16,6,10,6,2,1,1,0,3,1,2,0,JUNI
SULAWESI BARAT,POLEWALI MANDAR,MAPILLI,BEROANGIN,80,39,33,30,0,0,0,32,1,0,14,6,0,0,0,0,13,12,1,10,6,3,3,1,30,28,2,29,JUNI
SULAWESI BARAT,POLEWALI MANDAR,MAPILLI,SEGERANG,85,10,10,7,6,1,1,0,6,3,8,2,1,0,1,0,10,5,5,5,4,1,3,0,11,7,4,3,JUNI
SULAWESI BARAT,POLEWALI MANDAR,MAPILLI,BONRA,69,18,7,1,1,0,0,3,3,0,7,0,12,3,9,0,10,5,5,4,9,9,0,1,21,19,2,16,JUNI
SULAWESI BARAT,POLEWALI MANDAR,MAPILLI,SATTOKO,55,74,2,2,1,1,1,0,1,0,0,2,7,5,2,4,69,10,59,2,48,31,17,12,7,4,3,4,JUNI
SULAWESI BARAT,POLEWALI MANDAR,MAPILLI,RAPPANG BARAT,53,51,8,1,0,0,0,1,6,0,3,3,0,0,0,0,43,22,21,9,1,1,0,0,10,2,8,8,JUNI
SULAWESI BARAT,POLEWALI MANDAR,MAPILLI,LANDI KANUSUANG,53,33,0,0,0,0,0,0,0,0,0,0,2,2,0,0,18,13,5,1,11,2,9,1,21,7,14,11,JUNI
SULAWESI BARAT,POLEWALI MANDAR,MATAKALI,MATAKALI,95,32,2,0,0,0,0,1,1,0,1,1,2,1,1,1,12,10,2,2,9,6,3,0,23,15,8,11,JUNI
SULAWESI BARAT,POLEWALI MANDAR,MATAKALI,PETAMPANUA,78,27,18,5,2,1,0,18,0,0,12,2,0,0,0,0,18,8,10,3,3,1,2,1,8,5,3,4,JUNI
SULAWESI BARAT,POLEWALI MANDAR,MATAKALI,BARUMBUNG,58,17,16,16,16,16,6,4,6,0,7,2,8,3,5,3,14,13,1,2,13,5,8,0,5,1,4,3,JUNI
SULAWESI BARAT,POLEWALI MANDAR,MATAKALI,PASIANG,91,43,19,12,8,2,2,16,1,0,9,7,17,11,6,9,13,10,3,10,8,8,0,0,0,0,0,0,JUNI
SULAWESI BARAT,POLEWALI MANDAR,MATAKALI,TONROLIMA,36,56,36,1,0,0,0,19,9,7,12,7,0,0,0,0,25,6,19,5,3,2,1,0,6,1,5,0,JUNI
SULAWESI BARAT,POLEWALI MANDAR,MATAKALI,INDOMAKKOMBONG,60,61,51,26,20,19,17,9,12,6,35,0,6,6,0,2,41,23,18,13,20,9,11,7,14,0,14,1,JUNI
SULAWESI BARAT,POLEWALI MANDAR,MATAKALI,BUNGA-BUNGA,91,31,2,2,2,2,2,0,0,0,0,1,14,14,0,5,22,17,5,9,10,1,9,0,27,26,1,13,JUNI
SULAWESI BARAT,POLEWALI MANDAR,MATANGNGA,MATANGNGA,63,59,17,4,4,1,0,10,1,3,17,0,1,0,1,0,11,5,6,1,4,1,3,0,40,8,32,26,JUNI
SULAWESI BARAT,POLEWALI MANDAR,MATANGNGA,LILLI,30,48,19,0,0,0,0,3,15,0,17,1,6,4,2,2,43,23,20,21,33,13,20,6,21,6,15,20,JUNI
SULAWESI BARAT,POLEWALI MANDAR,MATANGNGA,RANGOAN,64,70,31,30,5,2,0,19,8,4,12,1,6,6,0,2,67,34,33,29,56,53,3,15,32,31,1,24,JUNI
SULAWESI BARAT,POLEWALI MANDAR,MATANGNGA,TAPUA,87,10,10,4,3,0,0,10,0,0,6,2,4,0,4,0,10,7,3,5,5,2,3,2,6,1,5,1,JUNI
SULAWESI BARAT,POLEWALI MANDAR,MATANGNGA,MAMBU TAPUA,84,59,8,4,2,2,0,3,3,2,4,1,16,7,9,2,36,23,13,18,19,9,10,5,14,5,9,2,JUNI
SULAWESI BARAT,POLEWALI MANDAR,MATANGNGA,BA'BA TAPUA,68,12,7,4,4,3,2,1,4,0,1,3,11,1,10,0,10,5,5,4,7,4,3,2,11,9,2,10,JUNI
SULAWESI BARAT,POLEWALI MANDAR,MATANGNGA,KATIMBANG,88,51,2,1,0,0,0,1,0,1,0,1,13,4,9,0,22,13,9,7,0,0,0,0,23,9,14,2,JUNI
SULAWESI BARAT,POLEWALI MANDAR,POLEWALI,POLEWALI,32,40,23,23,18,13,10,11,0,0,18,5,3,3,0,1,31,23,8,7,28,23,5,4,4,1,3,1,JUNI
SULAWESI BARAT,POLEWALI MANDAR,POLEWALI,WATTANG,41,40,27,8,6,3,3,22,1,1,19,1,0,0,0,0,21,19,2,9,19,11,8,3,36,1,35,13,JUNI
SULAWESI BARAT,POLEWALI MANDAR,POLEWALI,SULEWATANG,86,72,43,31,9,1,0,18,2,18,42,0,7,1,6,0,53,35,18,2,41,28,13,12,71,48,23,69,JUNI
SULAWESI BARAT,POLEWALI MANDAR,POLEWALI,LANTORA,91,34,23,19,0,0,0,14,0,3,7,12,14,14,0,13,17,7,10,7,17,7,10,2,31,9,22,0,JUNI
SULAWESI BARAT,POLEWALI MANDAR,POLEWALI,TAKATIDUNG,58,75,60,11,2,1,1,30,17,11,19,34,0,0,0,0,13,6,7,3,3,3,0,0,52,15,37,40,JUNI
SULAWESI BARAT,POLEWALI MANDAR,POLEWALI,PEKKABATA,95,46,10,4,4,4,3,4,0,0,8,0,11,7,4,1,21,7,14,2,17,6,11,6,17,0,17,2,JUNI
SULAWESI BARAT,POLEWALI MANDAR,POLEWALI,MADATE,81,53,18,14,4,1,0,17,1,0,13,5,16,15,1,7,24,21,3,15,22,21,1,1,56,30,26,4,JUNI
SULAWESI BARAT,POLEWALI MANDAR,POLEWALI,MANDING,63,44,27,25,21,13,4,20,1,0,26,1,10,9,1,2,32,20,12,10,4,2,2,2,0,0,0,0,JUNI
SULAWESI BARAT,POLEWALI MANDAR,POLEWALI,DARMA,32,36,9,7,4,2,1,3,2,0,1,4,3,0,3,0,10,10,0,4,2,1,1,1,6,5,1,5,JUNI
SULAWESI BARAT,POLEWALI MANDAR,TAPANGO,PELITAKAN,41,70,57,26,21,12,7,41,9,0,39,18,2,2,0,2,41,8,33,5,37,27,10,23,7,1,6,4,JUNI
SULAWESI BARAT,POLEWALI MANDAR,TAPANGO,TAPANGO,36,13,0,0,0,0,0,0,0,0,0,0,4,0,4,0,12,10,2,3,10,2,8,0,8,2,6,7,JUNI
SULAWESI BARAT,POLEWALI MANDAR,TAPANGO,RAPPANG,60,41,26,7,6,4,4,7,3,0,6,10,1,0,1,0,21,6,15,6,4,3,1,0,2,0,2,2,JUNI
SULAWESI BARAT,POLEWALI MANDAR,TAPANGO,DAKKA,60,20,5,0,0,0,0,5,0,0,1,0,1,1,0,0,17,11,6,5,7,6,1,0,3,0,3,3,JUNI
SULAWESI BARAT,POLEWALI MANDAR,TAPANGO,BATU,70,25,25,2,1,1,0,25,0,0,5,3,4,0,4,0,13,6,7,4,9,0,9,0,19,14,5,17,JUNI
SULAWESI BARAT,POLEWALI MANDAR,TAPANGO,RISO,92,46,33,7,0,0,0,28,1,3,15,9,5,1,4,1,15,5,10,0,13,2,11,2,26,8,18,8,JUNI
SULAWESI BARAT,POLEWALI MANDAR,TAPANGO,PALATTA,68,55,0,0,0,0,0,0,0,0,0,0,3,0,3,0,48,38,10,38,25,10,15,9,4,4,0,1,JUNI
SULAWESI BARAT,POLEWALI MANDAR,TAPANGO,TAPANGO BARAT,37,23,14,9,9,7,2,4,0,7,8,6,4,2,2,0,11,8,3,6,11,0,11,0,25,1,24,22,JUNI
SULAWESI BARAT,POLEWALI MANDAR,TAPANGO,KURRAK,56,45,7,0,0,0,0,0,4,3,4,3,5,0,5,0,36,31,5,5,26,22,4,18,14,5,9,4,JUNI
SULAWESI BARAT,POLEWALI MANDAR,TAPANGO,BUSSU,51,11,7,4,2,1,1,6,0,0,5,1,2,1,1,1,10,6,4,1,3,0,3,0,5,1,4,0,JUNI
SULAWESI BARAT,POLEWALI MANDAR,TAPANGO,TUTTULA,34,49,2,2,0,0,0,0,0,1,1,0,2,1,1,0,25,6,19,4,12,12,0,9,45,44,1,45,JUNI
SULAWESI BARAT,POLEWALI MANDAR,TAPANGO,JAMBU MALEA,32,33,25,14,5,5,5,10,3,1,7,7,5,2,3,0,28,5,23,0,10,3,7,2,21,15,6,4,JUNI
SULAWESI BARAT,POLEWALI MANDAR,TAPANGO,KALIMBUA,72,78,70,42,6,1,0,23,35,11,55,0,11,0,11,0,31,28,3,16,21,11,10,7,0,0,0,0,JUNI
SULAWESI BARAT,POLEWALI MANDAR,TAPANGO,BANATO REJO,39,49,47,36,10,4,4,2,6,26,32,11,1,1,0,1,44,22,22,16,35,3,32,0,32,8,24,4,JUNI
SULAWESI BARAT,POLEWALI MANDAR,TINAMBUNG,TINAMBUNG,31,12,5,4,1,0,0,3,1,1,3,1,4,1,3,1,12,7,5,2,1,0,1,0,8,7,1,6,JUNI
SULAWESI BARAT,POLEWALI MANDAR,TINAMBUNG,KARAMA,51,73,39,15,0,0,0,35,4,0,32,6,2,0,2,0,16,13,3,3,0,0,0,0,15,11,4,11,JUNI
SULAWESI BARAT,POLEWALI MANDAR,TINAMBUNG,TANGNGA TANGNGA,90,74,47,0,0,0,0,34,4,5,13,1,7,2,5,0,20,20,0,6,6,1,5,0,2,1,1,2,JUNI
SULAWESI BARAT,POLEWALI MANDAR,TINAMBUNG,LEKOPADIS,86,22,16,6,1,0,0,16,0,0,14,0,15,10,5,9,10,10,0,7,2,2,0,1,15,6,9,9,JUNI
SULAWESI BARAT,POLEWALI MANDAR,TINAMBUNG,GALUNG LOMBOK,64,20,16,0,0,0,0,15,0,0,6,4,10,10,0,6,18,9,9,3,10,7,3,2,18,6,12,14,JUNI
SULAWESI BARAT,POLEWALI MANDAR,TINAMBUNG,TANDUNG,41,32,16,0,0,0,0,9,2,1,0,13,5,0,5,0,10,5,5,4,2,2,0,1,22,17,5,20,JUNI
SULAWESI BARAT,POLEWALI MANDAR,TINAMBUNG,BATULAYA,31,53,9,9,8,4,4,2,3,0,3,3,6,6,0,4,20,5,15,1,17,5,12,5,46,17,29,20,JUNI
SULAWESI BARAT,POLEWALI MANDAR,TINAMBUNG,SEPABATU,59,66,27,25,15,13,9,15,1,0,25,0,2,1,1,1,63,52,11,49,48,10,38,7,85,65,20,58,JUNI
SULAWESI BARAT,POLEWALI MANDAR,TUTAR,TARAMANU,97,70,7,5,0,0,0,1,2,0,7,0,6,4,2,1,45,39,6,32,14,0,14,0,24,22,2,11,JUNI
SULAWESI BARAT,POLEWALI MANDAR,TUTAR,AMBOPADANG,71,30,29,29,8,2,2,15,6,1,23,2,11,0,11,0,29,20,9,0,16,3,13,1,28,26,2,14,JUNI
SULAWESI BARAT,POLEWALI MANDAR,TUTAR,TUBBI,39,74,69,48,45,15,2,56,1,4,66,0,2,2,0,1,11,5,6,1,1,0,1,0,12,7,5,8,JUNI
SULAWESI BARAT,POLEWALI MANDAR,TUTAR,RATTE,60,31,26,21,15,15,4,1,12,7,4,2,1,1,0,1,25,5,20,2,14,6,8,4,25,1,24,16,JUNI
SULAWESI BARAT,POLEWALI MANDAR,TUTAR,BESOANGIN,51,45,19,1,0,0,0,2,6,0,4,11,1,0,1,0,43,13,30,11,22,3,19,2,10,1,9,4,JUNI
SULAWESI BARAT,POLEWALI MANDAR,TUTAR,PIRIANG TAPIKO,77,15,13,13,8,0,0,4,1,5,11,1,12,10,2,3,10,7,3,3,7,6,1,2,7,7,0,7,JUNI
SULAWESI BARAT,POLEWALI MANDAR,TUTAR,PEBURRU,69,53,22,10,9,2,1,13,2,6,18,1,0,0,0,0,21,16,5,16,21,18,3,9,39,28,11,34,JUNI
SULAWESI BARAT,POLEWALI MANDAR,TUTAR,TALOBA,61,18,3,0,0,0,0,1,0,1,0,0,5,4,1,1,18,12,6,12,1,1,0,0,10,1,9,1,JUNI
SULAWESI BARAT,POLEWALI MANDAR,TUTAR,POLLEWANI,93,52,31,14,5,3,1,25,0,2,30,0,0,0,0,0,17,8,9,8,9,9,0,8,13,2,11,13,JUNI
SULAWESI BARAT,POLEWALI MANDAR,TUTAR,ARABUA,65,48,14,0,0,0,0,4,1,6,10,3,1,0,1,0,12,7,5,4,0,0,0,0,31,20,11,23,JUNI
SULAWESI BARAT,POLEWALI MANDAR,TUTAR,BESOANGIN UTARA,100,67,31,27,10,7,5,23,3,0,22,7,16,15,1,3,16,11,5,9,0,0,0,0,19,10,9,12,JUNI
SULAWESI BARAT,POLEWALI MANDAR,TUTAR,PODA,39,55,31,27,16,10,2,10,10,9,29,1,2,1,1,1,41,14,27,14,41,15,26,5,59,21,38,11,JUNI
SULAWESI BARAT,POLEWALI MANDAR,TUTAR,TARAMANU TUA,77,56,30,0,0,0,0,21,6,1,22,0,0,0,0,0,21,21,0,2,1,0,1,0,6,5,1,0,JUNI
SULAWESI BARAT,POLEWALI MANDAR,WONOMULYO,SIDODADI,71,47,10,9,7,6,5,1,0,2,6,0,8,7,1,3,47,26,21,19,19,5,14,2,14,14,0,2,JUNI
SULAWESI BARAT,POLEWALI MANDAR,WONOMULYO,SIDOREJO,65,76,17,2,1,0,0,3,7,7,13,1,1,0,1,0,12,7,5,7,8,2,6,1,48,17,31,24,JUNI
SULAWESI BARAT,POLEWALI MANDAR,WONOMULYO,SUMBEREJO,49,47,2,2,1,1,0,2,0,0,2,0,5,0,5,0,10,6,4,5,2,2,0,0,23,7,16,0,JUNI
SULAWESI BARAT,POLEWALI MANDAR,WONOMULYO,BUMIAYU,45,52,34,12,7,3,1,28,1,1,10,0,7,0,7,0,52,27,25,14,11,11,0,6,31,2,29,7,JUNI
SULAWESI BARAT,POLEWALI MANDAR,WONOMULYO,KEBUNSARI,75,31,26,0,0,0,0,9,0,17,4,16,10,5,5,2,28,23,5,19,12,11,1,2,28,7,21,9,JUNI
SULAWESI BARAT,POLEWALI MANDAR,WONOMULYO,BANUA BARU,71,23,14,1,1,0,0,8,6,0,10,2,7,5,2,0,17,10,7,7,16,11,5,11,31,2,29,31,JUNI
SULAWESI BARAT,POLEWALI MANDAR,WONOMULYO,NEPO,83,35,8,1,1,0,0,6,0,1,5,3,4,1,3,0,27,12,15,0,7,0,7,0,14,8,6,2,JUNI
SULAWESI BARAT,POLEWALI MANDAR,WONOMULYO,SUGIHWARAS,36,19,6,4,0,0,0,4,1,1,1,1,0,0,0,0,14,13,1,11,1,0,1,0,0,0,0,0,JUNI
SULAWESI BARAT,POLEWALI MANDAR,WONOMULYO,CAMPURJO,46,50,40,23,11,8,3,31,5,0,33,0,6,1,5,1,16,10,6,6,0,0,0,0,18,5,13,11,JUNI
SULAWESI BARAT,POLEWALI MANDAR,WONOMULYO,BUMIMULYO,93,35,15,10,2,1,1,5,1,0,10,5,8,3,5,1,26,5,21,4,1,0,1,0,6,1,5,6,JUNI
SULAWESI BARAT,POLEWALI MANDAR,WONOMULYO,TUMPILING,39,40,38,26,14,10,2,28,4,0,24,11,7,2,5,2,28,27,1,19,16,0,16,0,36,7,29,7,JUNI
SULAWESI BARAT,POLEWALI MANDAR,WONOMULYO,BAKKA-BAKKA,65,75,60,22,8,2,2,34,1,3,55,3,4,4,0,2,69,13,56,7,17,16,1,10,10,1,9,7,JUNI
SULAWESI BARAT,POLEWALI MANDAR,WONOMULYO,ARJO SARI,73,57,7,4,2,0,0,6,1,0,6,1,11,3,8,0,47,18,29,14,9,4,5,3,40,8,32,0,JUNI
SULAWESI BARAT,POLEWALI MANDAR,WONOMULYO,GALESON,54,80,62,34,1,1,1,17,16,28,59,2,8,4,4,0,50,26,24,24,5,1,4,1,9,2,7,3,JUNI
SULAWESI BARAT,MAMUJU,MAMUJU,BINANGA,76,78,25,24,16,2,1,14,1,8,9,6,0,0,0,0,16,16,0,16,6,0,6,0,21,10,11,9,JUNI
SULAWESI BARAT,MAMUJU,MAMUJU,MAMUNYU,37,23,23,6,4,0,0,18,5,0,17,2,3,1,2,1,11,6,5,5,9,8,1,8,9,5,4,4,JUNI
SULAWESI BARAT,MAMUJU,MAMUJU,KAREMA,79,47,36,23,10,3,0,11,4,17,18,12,1,0,1,0,45,36,9,10,16,7,9,0,30,12,18,21,JUNI
SULAWESI BARAT,MAMUJU,MAMUJU,RIMUKU,32,46,24,12,2,1,0,12,0,1,17,6,0,0,0,0,40,8,32,2,17,14,3,11,8,7,1,4,JUNI
SULAWESI BARAT,MAMUJU,MAMUJU,BAMBU,69,62,55,28,15,9,2,38,9,5,31,14,13,6,7,2,28,19,9,7,24,24,0,10,51,34,17,33,JUNI
SULAWESI BARAT,MAMUJU,MAMUJU,KARAMPUANG,60,79,46,39,28,28,28,1,12,1,10,10,12,6,6,3,55,23,32,15,41,12,29,4,12,8,4,4,JUNI
SULAWESI BARAT,MAMUJU,MAMUJU,TADUI,53,73,20,11,7,0,0,15,5,0,11,9,10,8,2,0,68,15,53,12,61,37,24,32,42,41,1,9,JUNI
SULAWESI BARAT,MAMUJU,MAMUJU,BATU PANNU,71,28,1,0,0,0,0,1,0,0,1,0,3,2,1,2,23,18,5,1,1,1,0,1,1,1,0,0,JUNI
SULAWESI BARAT,MAMUJU,TAPALANG,GALUNG,74,63,11,6,0,0,0,6,5,0,10,1,11,11,0,4,55,11,44,10,43,32,11,25,52,48,4,5,JUNI
SULAWESI BARAT,MAMUJU,TAPALANG,KASAMBANG,73,25,19,18,11,6,4,7,3,1,12,7,11,6,5,1,23,16,7,14,9,2,7,1,11,2,9,3,JUNI
SULAWESI BARAT,MAMUJU,TAPALANG,DAYANGINNA,31,20,3,0,0,0,0,0,2,0,0,0,4,1,3,1,17,13,4,2,2,1,1,1,16,16,0,9,JUNI
SULAWESI BARAT,MAMUJU,TAPALANG,OROBATU,58,43,33,13,3,1,0,0,15,18,23,3,0,0,0,0,19,9,10,9,5,3,2,1,18,5,13,13,JUNI
SULAWESI BARAT,MAMUJU,TAPALANG,TAKANDEANG,55,74,12,6,4,4,4,0,1,0,4,1,7,2,5,0,67,60,7,14,20,19,1,3,55,52,3,7,JUNI
SULAWESI BARAT,MAMUJU,TAPALANG,BELA,67,51,18,13,0,0,0,2,1,12,11,0,12,12,0,10,50,40,10,36,30,30,0,27,24,20,4,16,JUNI
SULAWESI BARAT,MAMUJU,TAPALANG,TAAN,84,33,17,0,0,0,0,10,5,2,6,1,16,2,14,1,18,16,2,3,11,4,7,1,6,2,4,4,JUNI
SULAWESI BARAT,MAMUJU,TAPALANG,TAMPALANG,43,51,36,34,18,7,7,19,2,3,7,7,7,4,3,4,44,32,12,27,13,10,3,2,5,4,1,1,JUNI
SULAWESI BARAT,MAMUJU,TAPALANG,RANTEDODA,39,35,16,9,9,3,2,0,10,4,3,7,5,3,2,3,11,10,1,6,2,2,0,1,14,0,14,10,JUNI
SULAWESI BARAT,MAMUJU,TAPALANG,KOPEANG,49,80,62,34,20,2,2,24,20,10,40,10,7,4,3,1,41,6,35,0,24,6,18,3,46,27,19,0,JUNI
SULAWESI BARAT,MAMUJU,KALUKKU,SINYONYOI,89,48,36,33,9,4,2,22,0,0,1,21,8,6,2,0,28,27,1,20,6,6,0,3,9,8,1,9,JUNI
SULAWESI BARAT,MAMUJU,KALUKKU,BEBANGA,75,73,29,0,0,0,0,23,3,3,10,11,6,3,3,1,11,9,2,1,1,1,0,1,19,19,0,7,JUNI
SULAWESI BARAT,MAMUJU,KALUKKU,KALUKKU,81,13,1,0,0,0,0,0,1,0,0,1,0,0,0,0,10,9,1,9,9,7,2,2,10,7,3,8,JUNI
SULAWESI BARAT,MAMUJU,KALUKKU,SINYONYOI SELATAN,85,75,2,0,0,0,0,0,0,2,2,0,7,5,2,0,55,55,0,47,5,2,3,1,33,25,8,22,JUNI
SULAWESI BARAT,MAMUJU,KALUKKU,SONDOANG,63,68,8,4,2,0,0,1,2,1,3,3,4,0,4,0,56,18,38,14,51,25,26,2,91,82,9,0,JUNI
SULAWESI BARAT,MAMUJU,KALUKKU,BERU-BERU,36,22,1,1,0,0,0,1,0,0,0,0,2,0,2,0,22,6,16,1,13,3,10,2,1,0,1,1,JUNI
SULAWESI BARAT,MAMUJU,KALUKKU,BELANG BELANG,100,57,4,1,1,1,0,4,0,0,2,1,18,10,8,4,26,14,12,5,20,14,6,6,58,0,58,10,JUNI
SULAWESI BARAT,MAMUJU,KALUKKU,KABULOANG,58,49,10,10,9,8,3,1,0,2,6,1,11,7,4,7,38,33,5,13,27,6,21,3,29,18,11,28,JUNI
SULAWESI BARAT,MAMUJU,KALUKKU,KEANG,64,78,36,0,0,0,0,3,7,25,15,7,1,0,1,0,69,30,39,30,32,26,6,10,37,28,9,28,JUNI
SULAWESI BARAT,MAMUJU,KALUKKU,POKKANG,58,74,38,11,6,3,0,32,0,6,16,5,2,2,0,1,42,25,17,19,37,6,31,4,40,1,39,4,JUNI
SULAWESI BARAT,MAMUJU,KALUKKU,GULILING,54,56,37,33,26,7,5,19,3,8,29,0,5,3,2,2,19,14,5,14,5,1,4,1,41,13,28,34,JUNI
SULAWESI BARAT,MAMUJU,KALUKKU,UHAIMATE,35,64,56,12,6,1,1,32,20,3,7,41,5,2,3,1,19,14,5,3,5,3,2,3,27,15,12,1,JUNI
SULAWESI BARAT,MAMUJU,KALUKKU,KALUKKU BARAT,75,77,38,22,17,2,1,4,10,13,22,13,14,8,6,8,71,56,15,33,53,16,37,14,59,4,55,31,JUNI
SULAWESI BARAT,MAMUJU,KALUKKU,PAMMULUKANG,65,28,23,22,20,0,0,16,6,1,6,3,7,0,7,0,14,9,5,3,3,3,0,1,17,7,10,3,JUNI
SULAWESI BARAT,MAMUJU,KALUMPANG,KALUMPANG,30,80,80,18,8,2,0,30,21,17,41,18,2,0,2,0,80,7,73,2,61,18,43,8,82,36,46,28,JUNI
SULAWESI BARAT,MAMUJU,KALUMPANG,KARATAUN,91,77,72,12,8,6,4,55,5,5,28,40,1,1,0,1,68,58,10,55,24,4,20,3,42,33,9,31,JUNI
SULAWESI BARAT,MAMUJU,KALUMPANG,KARAMA,87,17,12,3,0,0,0,3,8,1,7,2,2,1,1,1,15,7,8,1,6,4,2,0,13,0,13,5,JUNI
SULAWESI BARAT,MAMUJU,KALUMPANG,SIRAUN,32,24,11,8,7,2,2,5,0,0,6,5,2,2,0,1,12,9,3,9,5,0,5,0,8,5,3,4,JUNI
SULAWESI BARAT,MAMUJU,KALUMPANG,TUMOGA,76,70,70,13,9,8,8,41,0,5,40,13,1,1,0,0,34,11,23,10,1,0,1,0,6,4,2,1,JUNI
SULAWESI BARAT,MAMUJU,KALUMPANG,SALUMAKKI,30,16,10,9,6,3,1,7,0,1,8,1,0,0,0,0,15,9,6,3,13,0,13,0,7,7,0,3,JUNI
SULAWESI BARAT,MAMUJU,KALUMPANG,POLIO,48,54,49,21,12,2,2,5,20,14,19,3,0,0,0,0,42,18,24,5,21,3,18,0,15,4,11,2,JUNI
SULAWESI BARAT,MAMUJU,KALUMPANG,LIMBONG,86,68,31,10,7,5,1,1,11,3,7,11,3,0,3,0,42,29,13,18,41,7,34,5,16,8,8,1,JUNI
SULAWESI BARAT,MAMUJU,KALUMPANG,SANDAPANG,39,20,17,6,2,1,1,4,8,4,16,1,1,1,0,0,10,8,2,1,5,0,5,0,18,13,5,8,JUNI
SULAWESI BARAT,MAMUJU,KALUMPANG,KONDO BULO,45,43,5,2,2,0,0,3,0,1,5,0,7,5,2,2,29,25,4,0,7,4,3,4,20,13,7,9,JUNI
SULAWESI BARAT,MAMUJU,KALUMPANG,MAKKALIKI,46,35,7,2,0,0,0,4,1,0,5,1,7,4,3,1,31,18,13,14,12,1,11,0,5,4,1,3,JUNI
SULAWESI BARAT,MAMUJU,KALUMPANG,BATU MAKKADA,49,27,5,3,1,0,0,4,1,0,2,0,1,0,1,0,10,8,2,5,1,1,0,0,10,7,3,4,JUNI
SULAWESI BARAT,MAMUJU,KALUMPANG,LASA',60,76,34,11,9,4,3,16,9,0,9,21,5,0,5,0,65,16,49,8,30,9,21,8,8,3,5,4,JUNI
SULAWESI BARAT,MAMUJU,PAPALANG,TOABO,50,62,38,14,4,1,1,31,5,0,26,8,2,2,0,1,15,7,8,2,2,0,2,0,0,0,0,0,JUNI
SULAWESI BARAT,MAMUJU,PAPALANG,PAPALANG,93,67,51,33,29,15,14,2,16,4,8,26,14,12,2,1,12,6,6,1,0,0,0,0,13,6,7,4,JUNI
SULAWESI BARAT,MAMUJU,PAPALANG,BONDA,83,36,22,4,2,1,0,19,2,1,7,10,9,8,1,0,24,18,6,12,8,5,3,2,24,17,7,23,JUNI
SULAWESI BARAT,MAMUJU,PAPALANG,TOPORE,38,66,22,4,3,0,0,18,1,0,0,20,4,4,0,0,52,44,8,26,1,0,1,0,43,11,32,6,JUNI
SULAWESI BARAT,MAMUJU,PAPALANG,SALUKAYU,35,52,19,6,2,2,0,3,7,3,14,4,7,0,7,0,46,36,10,0,22,8,14,7,51,21,30,30,JUNI
SULAWESI BARAT,MAMUJU,PAPALANG,SUKADAMAI,70,40,37,9,0,0,0,10,4,11,2,20,7,1,6,0,21,7,14,3,0,0,0,0,9,2,7,4,JUNI
SULAWESI BARAT,MAMUJU,PAPALANG,BODA-BODA,79,30,20,19,3,3,0,3,12,3,17,2,12,9,3,9,12,5,7,4,4,1,3,1,1,1,0,1,JUNI
SULAWESI BARAT,MAMUJU,PAPALANG,SISANGO,55,64,22,16,8,7,7,7,1,3,18,3,6,1,5,0,30,28,2,6,7,1,6,0,23,9,14,16,JUNI
SULAWESI BARAT,MAMUJU,PAPALANG,BATU AMPA,96,66,56,44,5,0,0,55,1,0,35,11,13,11,2,0,60,41,19,23,16,13,3,5,21,4,17,5,JUNI
SULAWESI BARAT,MAMUJU,SAMPAGA,BUNDE,34,53,30,11,11,3,2,5,17,3,19,9,4,1,3,1,24,5,19,0,15,1,14,0,9,5,4,0,JUNI
SULAWESI BARAT,MAMUJU,SAMPAGA,KALONDING,67,80,6,4,1,0,0,5,0,0,6,0,0,0,0,0,47,20,27,3,20,11,9,2,71,10,61,64,JUNI
SULAWESI BARAT,MAMUJU,SAMPAGA,TARAILU,97,29,26,10,7,7,1,7,13,0,16,2,5,4,1,2,23,15,8,3,0,0,0,0,5,1,4,1,JUNI
SULAWESI BARAT,MAMUJU,SAMPAGA,SAMPAGA,52,21,0,0,0,0,0,0,0,0,0,0,2,0,2,0,11,10,1,4,0,0,0,0,13,4,9,6,JUNI
SULAWESI BARAT,MAMUJU,SAMPAGA,TANAMBUAH,98,73,62,31,30,6,0,7,48,0,51,6,18,17,1,10,69,11,58,6,68,46,22,46,58,6,52,36,JUNI
SULAWESI BARAT,MAMUJU,SAMPAGA,SALUBARANA,61,63,25,17,6,1,1,20,3,0,21,4,11,3,8,3,49,30,19,2,8,8,0,0,19,17,2,16,JUNI
SULAWESI BARAT,MAMUJU,SAMPAGA,LOSSO,49,28,10,4,3,0,0,0,1,9,10,0,5,5,0,1,27,19,8,6,10,9,1,9,27,27,0,12,JUNI
SULAWESI BARAT,MAMUJU,TOMMO,TOMMO,43,75,27,5,1,0,0,12,13,1,15,7,7,5,2,3,55,18,37,12,15,1,14,0,32,24,8,16,JUNI
SULAWESI BARAT,MAMUJU,TOMMO,CAMPALOGA,32,76,35,35,0,0,0,7,19,3,4,0,2,0,2,0,70,27,43,9,18,16,2,6,20,11,9,1,JUNI
SULAWESI BARAT,MAMUJU,TOMMO,BUANA SAKTI,65,64,16,13,0,0,0,4,9,2,7,6,6,4,2,4,37,22,15,7,11,6,5,1,18,16,2,16,JUNI
SULAWESI BARAT,MAMUJU,TOMMO,TAMEMONGGA,44,58,56,8,7,0,0,11,25,7,33,5,4,1,3,1,40,26,14,23,12,7,5,0,8,6,2,8,JUNI
SULAWESI BARAT,MAMUJU,TOMMO,TAMEJARRA,78,30,7,1,1,0,0,2,5,0,5,1,10,5,5,2,12,11,1,3,0,0,0,0,17,14,3,12,JUNI
SULAWESI BARAT,MAMUJU,TOMMO,RANTEMARIO,91,71,37,11,6,4,3,34,0,0,11,24,18,16,2,14,47,22,25,13,31,26,5,13,5,2,3,5,JUNI
SULAWESI BARAT,MAMUJU,TOMMO,MALINO,59,27,15,15,15,4,4,9,0,0,6,2,6,3,3,2,10,7,3,5,3,0,3,0,7,4,3,2,JUNI
SULAWESI BARAT,MAMUJU,TOMMO,KAKULLASANG,47,80,46,27,15,5,1,45,0,0,13,26,1,0,1,0,63,38,25,26,16,6,10,4,9,0,9,6,JUNI
SULAWESI BARAT,MAMUJU,TOMMO,LELING,54,57,40,29,9,5,3,15,17,3,36,2,2,2,0,2,23,10,13,0,18,13,5,11,56,0,56,41,JUNI
SULAWESI BARAT,MAMUJU,TOMMO,KALEPU,98,34,8,7,0,0,0,6,0,1,3,2,16,3,13,1,15,7,8,7,2,1,1,1,15,0,15,3,JUNI
SULAWESI BARAT,MAMUJU,TOMMO,SANDANA,90,50,15,9,8,7,1,6,3,3,10,5,15,0,15,0,13,13,0,5,5,1,4,1,14,3,11,7,JUNI
SULAWESI BARAT,MAMUJU,TOMMO,LELING BARAT,54,80,0,0,0,0,0,0,0,0,0,0,0,0,0,0,41,12,29,2,10,2,8,1,55,30,25,12,JUNI
SULAWESI BARAT,MAMUJU,TOMMO,LELING UTARA,92,23,16,6,1,1,1,5,9,1,4,4,10,9,1,0,12,8,4,2,2,1,1,0,17,13,4,8,JUNI
SULAWESI BARAT,MAMUJU,TOMMO,SALUDENGEN,75,63,7,2,0,0,0,1,3,2,2,3,10,8,2,1,49,19,30,6,43,4,39,3,40,40,0,39,JUNI
SULAWESI BARAT,MAMUJU,SIMBORO DAN KEPULAUAN,SIMBORO,41,79,24,15,2,1,0,12,4,6,15,3,2,2,0,2,60,53,7,44,48,17,31,4,100,61,39,35,JUNI
SULAWESI BARAT,MAMUJU,SIMBORO DAN KEPULAUAN,RANGAS,79,56,49,10,9,7,2,6,37,4,17,18,2,0,2,0,29,13,16,5,7,6,1,3,12,10,2,3,JUNI
SULAWESI BARAT,MAMUJU,SIMBORO DAN KEPULAUAN,BOTTENG,53,61,61,17,2,0,0,31,30,0,48,4,3,2,1,2,24,8,16,6,15,0,15,0,30,5,25,9,JUNI
SULAWESI BARAT,MAMUJU,SIMBORO DAN KEPULAUAN,SALETTO,45,77,36,28,24,16,8,26,0,1,25,8,9,4,5,3,64,49,15,39,2,0,2,0,9,6,3,5,JUNI
SULAWESI BARAT,MAMUJU,SIMBORO DAN KEPULAUAN,SUMARE,74,63,52,29,9,1,0,10,33,1,25,5,14,1,13,1,47,29,18,22,41,15,26,12,84,52,32,26,JUNI
SULAWESI BARAT,MAMUJU,SIMBORO DAN KEPULAUAN,BOTTENG UTARA,76,42,6,3,2,2,2,3,1,0,1,2,6,1,5,0,40,13,27,4,36,7,29,7,59,43,16,27,JUNI
SULAWESI BARAT,MAMUJU,SIMBORO DAN KEPULAUAN,TAPANDULLU,52,65,51,27,21,19,3,20,9,7,6,14,9,1,8,0,20,11,9,3,17,9,8,8,1,0,1,1,JUNI
SULAWESI BARAT,MAMUJU,SIMBORO DAN KEPULAUAN,PATI'DI,75,66,63,10,0,0,0,28,20,7,42,4,13,12,1,12,23,13,10,8,0,0,0,0,14,14,0,0,JUNI
SULAWESI BARAT,MAMUJU,TAPALANG BARAT,DUNGKAIT,97,62,26,12,2,0,0,23,2,0,8,18,14,5,9,3,29,5,24,4,2,1,1,1,14,4,10,10,JUNI
SULAWESI BARAT,MAMUJU,TAPALANG BARAT,LEBANI,42,12,1,0,0,0,0,0,1,0,0,0,1,1,0,1,11,11,0,4,6,3,3,1,6,3,3,4,JUNI
SULAWESI BARAT,MAMUJU,TAPALANG BARAT,LABUANG RANO,82,38,34,15,9,3,3,1,13,13,25,2,15,1,14,0,27,15,12,15,17,2,15,1,30,22,8,8,JUNI
SULAWESI BARAT,MAMUJU,TAPALANG BARAT,PASABU,68,40,24,12,1,1,1,5,9,4,10,14,8,0,8,0,27,19,8,0,6,2,4,0,22,15,7,21,JUNI
SULAWESI BARAT,MAMUJU,TAPALANG BARAT,TANETE PAO,62,12,2,0,0,0,0,0,1,1,2,0,7,6,1,1,11,6,5,1,10,8,2,6,2,0,2,1,JUNI
SULAWESI BARAT,MAMUJU,TAPALANG BARAT,PANGASAAN,31,57,39,39,30,4,1,1,23,4,39,0,2,0,2,0,22,6,16,5,16,12,4,7,21,5,16,10,JUNI
SULAWESI BARAT,MAMUJU,TAPALANG BARAT,AHU,94,66,17,12,7,2,2,13,0,1,13,3,0,0,0,0,39,29,10,12,32,31,1,29,43,17,26,33,JUNI
SULAWESI BARAT,MAMUJU,BONEHAU,BONEHAU,70,72,49,4,0,0,0,41,7,0,33,9,0,0,0,0,27,13,14,2,2,1,1,1,38,16,22,2,JUNI
SULAWESI BARAT,MAMUJU,BONEHAU,SALUTIWO,84,37,3,3,0,0,0,0,0,2,2,1,2,1,1,0,26,18,8,9,18,15,3,3,37,5,32,36,JUNI
SULAWESI BARAT,MAMUJU,BONEHAU,BUTTUADA,73,43,10,7,4,1,0,0,6,3,2,0,2,1,1,0,28,6,22,5,4,1,3,1,24,7,17,3,JUNI
SULAWESI BARAT,MAMUJU,BONEHAU,TAMALEA,57,71,31,7,5,0,0,23,1,5,9,7,10,1,9,1,24,11,13,2,5,4,1,2,22,18,4,0,JUNI
SULAWESI BARAT,MAMUJU,BONEHAU,LUMIKA,65,38,21,4,2,0,0,2,2,12,20,0,12,1,11,1,16,7,9,0,9,7,2,1,28,11,17,5,JUNI
SULAWESI BARAT,MAMUJU,BONEHAU,MAPPU,61,70,47,3,0,0,0,27,16,4,38,6,3,1,2,0,12,6,6,5,12,6,6,1,34,12,22,0,JUNI
SULAWESI BARAT,MAMUJU,BONEHAU,BANUADA,35,71,32,32,16,0,0,5,20,4,26,6,7,2,5,2,58,50,8,44,44,19,25,10,73,6,67,35,JUNI
SULAWESI BARAT,MAMUJU,BONEHAU,HINUA,80,71,9,2,0,0,0,8,0,1,4,3,14,1,13,1,15,13,2,7,10,9,1,7,4,2,2,1,JUNI
SULAWESI BARAT,MAMUJU,BONEHAU,KINATANG,61,60,26,6,0,0,0,18,0,6,11,5,5,1,4,1,11,5,6,3,4,3,1,3,43,27,16,36,JUNI
SULAWESI BARAT,MAMUJU,KEP. BALA BALAKANG,BALA BALAKANG,57,56,39,30,18,1,1,0,8,30,38,1,11,2,9,2,42,21,21,5,8,7,1,6,32,30,2,30,JUNI
SULAWESI BARAT,MAMUJU,KEP. BALA BALAKANG,BALA-BALAKANG TIMUR,99,28,21,12,10,5,2,6,6,3,5,16,13,3,10,2,27,24,3,20,26,13,13,3,31,0,31,10,JUNI
SULAWESI BARAT,MAMUJU TENGAH,TOBADAK,MAHAHE,50,23,9,6,3,2,0,5,4,0,3,0,4,2,2,0,15,12,3,10,11,8,3,3,16,1,15,6,JULI
SULAWESI BARAT,MAMUJU TENGAH,TOBADAK,SALOBAJA,47,25,24,14,9,1,0,6,6,11,20,2,2,2,0,0,10,7,3,5,10,5,5,0,16,15,1,7,JULI
SULAWESI BARAT,MAMUJU TENGAH,TOBADAK,TOBADAK,62,31,18,9,5,0,0,0,13,2,1,9,9,2,7,1,30,6,24,1,0,0,0,0,0,0,0,0,JULI
SULAWESI BARAT,MAMUJU TENGAH,TOBADAK,PALONGAAN,91,61,34,20,15,4,0,29,4,1,27,3,16,15,1,10,19,17,2,15,7,5,2,3,48,46,2,35,JULI
SULAWESI BARAT,MAMUJU TENGAH,TOBADAK,BATU PARIGI,55,64,4,0,0,0,0,1,0,1,3,1,11,0,11,0,34,24,10,20,30,25,5,6,0,0,0,0,JULI
SULAWESI BARAT,MAMUJU TENGAH,TOBADAK,BAMBADARU,98,11,3,3,0,0,0,2,0,1,1,0,12,12,0,2,11,10,1,4,10,3,7,0,9,6,3,7,JULI
SULAWESI BARAT,MAMUJU TENGAH,TOBADAK,SEJATI,87,34,26,4,2,1,1,3,5,8,19,0,5,5,0,5,29,12,17,6,19,14,5,4,28,28,0,27,JULI
SULAWESI BARAT,MAMUJU TENGAH,TOBADAK,SALOADAK,89,15,7,4,0,0,0,7,0,0,6,1,2,0,2,0,15,10,5,6,9,4,5,2,14,9,5,5,JULI
SULAWESI BARAT,MAMUJU TENGAH,PANGALE,POLO PANGALE,31,59,35,34,17,5,0,29,4,1,13,14,4,0,4,0,22,5,17,4,15,4,11,4,5,4,1,5,JULI
SULAWESI BARAT,MAMUJU TENGAH,PANGALE,PANGALE,84,66,64,51,0,0,0,30,27,0,10,25,11,4,7,0,18,5,13,0,18,17,1,16,43,28,15,36,JULI
SULAWESI BARAT,MAMUJU TENGAH,PANGALE,SARTANAMAJU,50,17,15,6,6,5,1,6,6,0,6,4,4,3,1,2,15,5,10,1,0,0,0,0,3,2,1,1,JULI
SULAWESI BARAT,MAMUJU TENGAH,PANGALE,POLO LERENG,75,52,17,7,2,0,0,12,5,0,15,2,4,2,2,1,18,10,8,8,0,0,0,0,21,12,9,0,JULI
SULAWESI BARAT,MAMUJU TENGAH,PANGALE,KUO,50,26,12,4,1,0,0,8,4,0,8,3,7,3,4,3,15,9,6,4,12,12,0,10,16,0,16,3,JULI
SULAWESI BARAT,MAMUJU TENGAH,PANGALE,POLO CAMBA,47,27,1,0,0,0,0,0,1,0,0,1,2,2,0,2,13,12,1,12,7,4,3,4,13,1,12,7,JULI
SULAWESI BARAT,MAMUJU TENGAH,PANGALE,LAMBA-LAMBA,43,62,19,11,3,1,1,11,1,2,11,1,2,1,1,0,27,20,7,0,11,7,4,4,46,30,16,2,JULI
SULAWESI BARAT,MAMUJU TENGAH,PANGALE,KOMBILING,58,74,2,2,0,0,0,2,0,0,2,0,8,5,3,1,68,62,6,9,62,42,20,40,0,0,0,0,JULI
SULAWESI BARAT,MAMUJU TENGAH,PANGALE,LEMO-LEMO,86,66,28,14,8,6,2,14,4,5,18,3,17,15,2,4,11,11,0,8,2,0,2,0,38,1,37,9,JULI
SULAWESI BARAT,MAMUJU TENGAH,BUDONG-BUDONG,BABANA,99,71,49,31,7,1,0,5,40,2,15,8,10,6,4,4,46,31,15,30,4,0,4,0,51,29,22,37,JULI
SULAWESI BARAT,MAMUJU TENGAH,BUDONG-BUDONG,LUMU,31,31,27,20,20,16,10,2,5,10,21,2,1,0,1,0,27,24,3,18,14,3,11,1,17,6,11,13,JULI
SULAWESI BARAT,MAMUJU TENGAH,BUDONG-BUDONG,PONTANAKAYANG,61,38,7,2,2,1,1,1,0,3,1,3,9,0,9,0,34,19,15,1,6,3,3,0,5,2,3,4,JULI
SULAWESI BARAT,MAMUJU TENGAH,BUDONG-BUDONG,SALOGATTA,84,42,40,5,1,1,1,31,1,0,14,14,15,7,8,0,19,8,11,4,16,9,7,2,38,23,15,13,JULI
SULAWESI BARAT,MAMUJU TENGAH,BUDONG-BUDONG,KIRE,31,39,20,16,15,1,1,17,0,0,0,10,0,0,0,0,36,5,31,1,6,3,3,1,30,7,23,3,JULI
SULAWESI BARAT,MAMUJU TENGAH,BUDONG-BUDONG,TINALI,35,76,20,2,2,2,0,16,2,0,0,0,6,0,6,0,69,24,45,3,18,0,18,0,70,36,34,8,JULI
SULAWESI BARAT,MAMUJU TENGAH,BUDONG-BUDONG,SALUMANURUNG,99,49,31,17,3,2,0,20,5,2,30,1,19,12,7,1,14,5,9,1,14,0,14,0,24,14,10,0,JULI
SULAWESI BARAT,MAMUJU TENGAH,BUDONG-BUDONG,PASAPA,83,25,2,2,0,0,0,1,0,1,1,1,16,12,4,4,11,11,0,5,6,1,5,0,6,4,2,2,JULI
SULAWESI BARAT,MAMUJU TENGAH,BUDONG-BUDONG,BOJO,73,11,4,4,0,0,0,0,3,0,1,1,10,0,10,0,10,7,3,3,6,6,0,5,3,3,0,1,JULI
SULAWESI BARAT,MAMUJU TENGAH,BUDONG-BUDONG,BARAKKANG,60,27,4,1,1,1,1,1,2,0,1,3,0,0,0,0,21,8,13,4,10,7,3,5,6,0,6,4,JULI
SULAWESI BARAT,MAMUJU TENGAH,BUDONG-BUDONG,LEMBAH HADA,51,30,22,22,1,0,0,13,5,2,5,11,6,1,5,1,23,10,13,4,0,0,0,0,13,8,5,9,JULI
SULAWESI BARAT,MAMUJU TENGAH,TOPOYO,BUDONG-BUDONG,77,19,11,5,0,0,0,7,3,1,1,6,12,4,8,4,12,7,5,1,2,2,0,0,1,0,1,1,JULI
SULAWESI BARAT,MAMUJU TENGAH,TOPOYO,TOPOYO,100,14,12,0,0,0,0,10,1,1,8,1,3,3,0,1,10,6,4,0,8,0,8,0,12,11,1,9,JULI
SULAWESI BARAT,MAMUJU TENGAH,TOPOYO,TUMBU,47,41,22,20,17,12,9,10,2,0,20,0,9,7,2,2,28,9,19,2,23,19,4,4,16,4,12,0,JULI
SULAWESI BARAT,MAMUJU TENGAH,TOPOYO,KABUBU,71,44,37,33,5,0,0,28,3,4,0,32,6,1,5,0,33,25,8,10,29,9,20,4,6,3,3,0,JULI
SULAWESI BARAT,MAMUJU TENGAH,TOPOYO,WAEPUTEH,63,38,31,5,2,0,0,15,4,6,3,28,0,0,0,0,28,16,12,0,26,22,4,6,21,1,20,19,JULI
SULAWESI BARAT,MAMUJU TENGAH,TOPOYO,TANGKOU,79,58,11,9,1,0,0,7,4,0,10,1,1,0,1,0,26,25,1,19,23,5,18,3,20,10,10,8,JULI
SULAWESI BARAT,MAMUJU TENGAH,TOPOYO,TABOLANG,77,52,9,8,1,0,0,6,1,1,6,1,2,2,0,2,47,32,15,20,3,0,3,0,17,5,12,0,JULI
SULAWESI BARAT,MAMUJU TENGAH,TOPOYO,PARAILI,73,28,2,1,0,0,0,1,1,0,0,1,8,0,8,0,10,7,3,6,3,2,1,0,7,2,5,4,JULI
SULAWESI BARAT,MAMUJU TENGAH,TOPOYO,SALUPANGKANG,71,79,43,2,2,1,0,0,28,5,36,5,10,6,4,6,14,8,6,1,1,1,0,1,31,28,3,16,JULI
SULAWESI BARAT,MAMUJU TENGAH,TOPOYO,SALUPANGKANG IV,52,23,13,10,9,4,3,4,5,1,0,3,3,2,1,1,20,10,10,0,18,0,18,0,9,5,4,4,JULI
SULAWESI BARAT,MAMUJU TENGAH,TOPOYO,TAPPILINA,69,38,28,0,0,0,0,11,0,16,12,7,3,3,0,3,17,14,3,7,15,6,9,5,8,8,0,0,JULI
SULAWESI BARAT,MAMUJU TENGAH,TOPOYO,BAMBAMANURUNG,82,62,20,18,15,0,0,5,15,0,2,6,10,3,7,2,61,45,16,45,32,19,13,3,23,19,4,7,JULI
SULAWESI BARAT,MAMUJU TENGAH,TOPOYO,SALULEKBO,97,19,18,2,1,1,0,5,4,9,8,6,8,0,8,0,12,6,6,3,10,5,5,0,20,2,18,16,JULI
SULAWESI BARAT,MAMUJU TENGAH,TOPOYO,PANGALLOANG,50,29,16,7,6,6,5,3,3,4,10,2,9,2,7,0,10,7,3,7,9,8,1,5,13,2,11,0,JULI
SULAWESI BARAT,MAMUJU TENGAH,TOPOYO,SINABATTA,60,58,23,17,14,14,2,8,13,0,1,21,11,1,10,1,45,11,34,4,20,4,16,4,40,5,35,16,JULI
SULAWESI BARAT,MAMUJU TENGAH,KAROSSA,KAROSSA,65,14,11,6,5,4,3,3,4,1,3,7,6,5,1,5,14,11,3,5,4,1,3,1,1,1,0,0,JULI
SULAWESI BARAT,MAMUJU TENGAH,KAROSSA,TASOKKO,89,72,44,23,21,3,0,36,4,2,20,17,16,13,3,12,60,30,30,19,28,7,21,6,3,2,1,3,JULI
SULAWESI BARAT,MAMUJU TENGAH,KAROSSA,LARA,63,77,70,41,16,13,0,5,25,14,24,41,10,3,7,0,59,51,8,20,2,0,2,0,37,26,11,8,JULI
SULAWESI BARAT,MAMUJU TENGAH,KAROSSA,KADAILA,64,27,3,2,2,2,1,1,1,0,2,1,12,9,3,8,17,16,1,11,11,9,2,9,12,11,1,6,JULI
SULAWESI BARAT,MAMUJU TENGAH,KAROSSA,KAYU CALLA,36,62,53,46,6,0,0,45,4,4,4,19,1,0,1,0,45,26,19,2,30,18,12,13,40,15,25,17,JULI
SULAWESI BARAT,MAMUJU TENGAH,KAROSSA,LEMBAH HOPO,54,74,46,20,15,2,2,43,1,0,1,26,4,3,1,0,58,7,51,7,3,0,3,0,12,6,6,0,JULI
SULAWESI BARAT,MAMUJU TENGAH,KAROSSA,BENGGAULU,65,10,9,5,2,0,0,5,4,0,4,3,13,9,4,9,10,6,4,4,9,6,3,0,15,14,1,6,JULI
SULAWESI BARAT,MAMUJU TENGAH,KAROSSA,SUKA MAJU,56,59,34,32,5,2,0,17,17,0,15,10,3,2,1,1,27,23,4,7,19,2,17,1,34,7,27,27,JULI
SULAWESI BARAT,MAMUJU TENGAH,KAROSSA,KAMBUNONG,47,22,14,7,5,0,0,4,6,0,3,11,1,1,0,1,11,5,6,0,4,4,0,3,5,5,0,3,JULI
SULAWESI BARAT,MAMUJU TENGAH,KAROSSA,SALUBIRO,67,47,15,14,2,1,0,6,1,8,6,9,12,12,0,8,10,10,0,5,5,5,0,0,35,16,19,17,JULI
SULAWESI BARAT,MAMUJU TENGAH,KAROSSA,SANJANGO,57,13,4,1,1,1,0,2,0,1,4,0,3,2,1,0,13,9,4,2,1,1,0,0,1,0,1,1,JULI
SULAWESI BARAT,PASANGKAYU,BAMBAIRA,TAMPAURE,75,68,23,23,10,6,1,16,4,0,18,3,6,2,4,0,61,17,44,7,6,1,5,1,50,49,1,45,JULI
SULAWESI BARAT,PASANGKAYU,BAMBAIRA,BAMBAIRA,92,20,8,3,3,3,2,3,3,0,0,0,5,5,0,0,15,14,1,9,8,5,3,4,6,2,4,0,JULI
SULAWESI BARAT,PASANGKAYU,BAMBAIRA,KASOLOANG,85,41,14,4,2,0,0,9,5,0,8,1,6,1,5,1,12,12,0,3,9,2,7,2,29,6,23,6,JULI
SULAWESI BARAT,PASANGKAYU,BAMBAIRA,KALUKU NANGKA,70,34,1,1,1,0,0,0,0,1,0,1,2,0,2,0,28,10,18,6,3,0,3,0,26,2,24,25,JULI
SULAWESI BARAT,PASANGKAYU,BAMBALAMOTU,RANDOMAYANG,32,13,8,1,1,0,0,5,3,0,5,1,0,0,0,0,10,8,2,7,8,5,3,0,16,13,3,16,JULI
SULAWESI BARAT,PASANGKAYU,BAMBALAMOTU,BAMBALAMOTU,97,73,50,47,15,2,1,39,9,1,45,4,0,0,0,0,49,45,4,16,11,3,8,3,54,4,50,12,JULI
SULAWESI BARAT,PASANGKAYU,BAMBALAMOTU,POLEWALI,74,16,15,1,0,0,0,7,8,0,15,0,0,0,0,0,10,6,4,6,7,2,5,1,0,0,0,0,JULI
SULAWESI BARAT,PASANGKAYU,BAMBALAMOTU,PANGIANG,83,44,26,16,1,0,0,3,12,2,11,11,9,4,5,4,44,36,8,3,30,28,2,16,13,6,7,9,JULI
SULAWESI BARAT,PASANGKAYU,BAMBALAMOTU,KALOLA,88,38,37,30,28,9,6,23,6,0,0,36,15,11,4,9,37,35,2,28,17,3,14,3,16,3,13,11,JULI
SULAWESI BARAT,PASANGKAYU,BAMBALAMOTU,WULAI,67,68,43,36,1,1,1,39,2,1,19,18,13,7,6,0,35,5,30,4,22,3,19,1,69,27,42,28,JULI
SULAWESI BARAT,PASANGKAYU,BARAS,BARAS,42,59,24,6,2,2,1,8,8,0,7,3,1,1,0,1,57,40,17,29,37,37,0,7,49,27,22,41,JULI
SULAWESI BARAT,PASANGKAYU,BARAS,BULU PARIGI,91,15,10,4,3,3,1,0,0,3,8,2,0,0,0,0,13,5,8,2,0,0,0,0,3,2,1,2,JULI
SULAWESI BARAT,PASANGKAYU,BARAS,BALANTI,58,65,53,29,28,25,8,4,27,6,53,0,2,2,0,1,45,10,35,2,2,1,1,1,45,34,11,4,JULI
SULAWESI BARAT,PASANGKAYU,BARAS,MOTU,53,18,8,3,1,0,0,7,0,0,2,6,10,10,0,9,17,8,9,3,5,0,5,0,2,1,1,1,JULI
SULAWESI BARAT,PASANGKAYU,BARAS,TOWONI,88,23,5,0,0,0,0,5,0,0,1,3,4,3,1,3,15,9,6,3,0,0,0,0,4,0,4,1,JULI
SULAWESI BARAT,PASANGKAYU,BARAS,KASANO,39,16,0,0,0,0,0,0,0,0,0,0,6,1,5,0,12,12,0,6,7,3,4,1,2,2,0,1,JULI
SULAWESI BARAT,PASANGKAYU,BULU TABA,SUMBER SARI,74,39,32,5,0,0,0,23,0,5,26,2,2,1,1,0,29,25,4,21,18,14,4,12,38,9,29,7,JULI
SULAWESI BARAT,PASANGKAYU,BULU TABA,LELEJAE,77,71,32,17,2,0,0,24,5,3,26,3,4,2,2,1,48,28,20,14,18,2,16,0,14,4,10,11,JULI
SULAWESI BARAT,PASANGKAYU,BULU TABA,BUKIT HARAPAN,43,74,62,37,37,6,4,4,32,20,62,0,3,2,1,1,11,9,2,7,8,3,5,0,35,12,23,14,JULI
SULAWESI BARAT,PASANGKAYU,BULU TABA,LILIMORI,94,47,45,29,17,9,1,13,10,15,5,5,9,3,6,2,11,9,2,2,10,3,7,2,16,1,15,13,JULI
SULAWESI BARAT,PASANGKAYU,BULU TABA,KARAVE,63,49,35,3,3,1,1,33,1,0,13,4,5,4,1,1,35,22,13,12,11,3,8,3,17,1,16,4,JULI
SULAWESI BARAT,PASANGKAYU,BULU TABA,KASTABUANA,75,40,26,11,8,8,8,9,6,2,0,13,5,3,2,2,16,9,7,4,12,9,3,9,21,19,2,17,JULI
SULAWESI BARAT,PASANGKAYU,BULU TABA,OMPI,79,17,8,3,0,0,0,0,4,4,7,1,2,0,2,0,17,6,11,3,15,0,15,0,14,6,8,9,JULI
SULAWESI BARAT,PASANGKAYU,DAPURANG,DAPURANG,89,33,33,12,10,4,2,19,8,4,32,1,14,5,9,2,16,8,8,3,6,2,4,1,10,8,2,1,JULI
SULAWESI BARAT,PASANGKAYU,DAPURANG,BENGGAULU,63,77,71,24,22,9,1,17,1,13,49,15,7,1,6,1,44,19,25,9,35,22,13,20,13,2,11,8,JULI
SULAWESI BARAT,PASANGKAYU,DAPURANG,TIRTABUANA,43,75,4,4,0,0,0,0,0,3,0,4,4,2,2,2,54,15,39,2,3,3,0,2,52,20,32,52,JULI
SULAWESI BARAT,PASANGKAYU,DAPURANG,BULU BONGGU,86,63,46,28,16,0,0,11,25,6,32,13,9,2,7,1,13,7,6,4,6,4,2,4,38,10,28,22,JULI
SULAWESI BARAT,PASANGKAYU,DAPURANG,SARASA,100,48,28,11,0,0,0,27,0,0,25,3,14,5,9,4,10,7,3,2,3,0,3,0,28,3,25,12,JULI
SULAWESI BARAT,PASANGKAYU,DURIPOKU,TAMMARUNANG,74,12,12,2,1,0,0,9,0,0,7,2,4,1,3,1,10,5,5,4,7,1,6,1,13,4,9,9,JULI
SULAWESI BARAT,PASANGKAYU,DURIPOKU,SAPTANAJAYA,89,38,33,20,15,1,0,15,6,1,2,13,0,0,0,0,17,15,2,13,12,2,10,0,19,7,12,17,JULI
SULAWESI BARAT,PASANGKAYU,DURIPOKU,TARANGGI,61,12,6,4,0,0,0,2,4,0,5,0,12,1,11,0,11,6,5,1,2,2,0,2,8,2,6,1,JULI
SULAWESI BARAT,PASANGKAYU,DURIPOKU,SIPAKAINGA,62,24,3,1,1,0,0,0,1,1,2,0,1,0,1,0,17,13,4,10,11,9,2,8,12,10,2,9,JULI
SULAWESI BARAT,PASANGKAYU,LARIANG,KULU,69,28,12,8,5,1,1,9,2,0,9,0,2,2,0,1,25,21,4,16,12,1,11,0,13,10,3,3,JULI
SULAWESI BARAT,PASANGKAYU,LARIANG,PARABU,46,56,7,1,1,0,0,3,2,1,2,2,9,2,7,2,15,11,4,10,9,0,9,0,35,2,33,18,JULI
SULAWESI BARAT,PASANGKAYU,LARIANG,KENANGAN,93,43,36,1,0,0,0,23,1,10,33,2,4,1,3,1,39,28,11,21,19,2,17,1,9,4,5,8,JULI
SULAWESI BARAT,PASANGKAYU,LARIANG,BAJAWALI,99,17,2,0,0,0,0,0,1,1,0,1,17,8,9,1,16,16,0,10,10,2,8,0,6,6,0,6,JULI
SULAWESI BARAT,PASANGKAYU,LARIANG,SINGGANI,79,29,28,1,0,0,0,8,11,6,25,0,10,9,1,0,23,21,2,20,3,0,3,0,6,2,4,2,JULI
SULAWESI BARAT,PASANGKAYU,LARIANG,BATU MATORU,78,52,31,17,15,8,8,22,1,0,10,2,2,0,2,0,50,19,31,18,30,27,3,3,59,13,46,20,JULI
SULAWESI BARAT,PASANGKAYU,LARIANG,BAMBAKORO,51,66,62,57,38,31,22,20,19,0,30,25,10,3,7,1,17,13,4,0,6,2,4,2,52,44,8,28,JULI
SULAWESI BARAT,PASANGKAYU,PASANGKAYU,KARYA BERSAMA,59,15,7,6,6,0,0,0,0,3,3,0,2,2,0,1,13,10,3,8,8,1,7,1,13,5,8,12,JULI
SULAWESI BARAT,PASANGKAYU,PASANGKAYU,AKO,36,13,8,8,2,1,0,4,2,2,6,0,1,0,1,0,13,12,1,4,9,0,9,0,15,13,2,11,JULI
SULAWESI BARAT,PASANGKAYU,PASANGKAYU,PASANGKAYU,45,79,79,25,19,15,7,72,0,0,46,25,7,7,0,5,68,41,27,7,8,2,6,0,7,5,2,1,JULI
SULAWESI BARAT,PASANGKAYU,PASANGKAYU,MARTAJAYA,41,47,29,28,1,1,1,4,22,1,12,2,5,5,0,2,22,9,13,5,14,10,4,9,36,35,1,26,JULI
SULAWESI BARAT,PASANGKAYU,PASANGKAYU,PAKAVA,48,59,59,54,33,8,3,19,0,21,18,0,7,7,0,2,29,13,16,11,7,3,4,2,22,13,9,0,JULI
SULAWESI BARAT,PASANGKAYU,PASANGKAYU,GUNUNG SARI,32,52,47,14,4,3,3,39,5,0,18,12,1,1,0,1,24,19,5,5,7,2,5,2,9,4,5,1,JULI
SULAWESI BARAT,PASANGKAYU,PEDONGGA,MALEI,47,31,2,0,0,0,0,0,2,0,0,2,1,1,0,0,12,8,4,3,6,0,6,0,3,3,0,0,JULI
SULAWESI BARAT,PASANGKAYU,PEDONGGA,PEDANDA,48,23,11,0,0,0,0,8,1,1,2,5,1,1,0,1,10,9,1,9,0,0,0,0,1,1,0,1,JULI
SULAWESI BARAT,PASANGKAYU,PEDONGGA,BATU OGE,32,78,22,10,3,0,0,18,2,1,16,5,3,1,2,0,43,33,10,23,1,1,0,1,53,24,29,42,JULI
SULAWESI BARAT,PASANGKAYU,PEDONGGA,MARTASARI,30,10,4,0,0,0,0,0,1,1,4,0,1,0,1,0,10,8,2,3,5,0,5,0,8,3,5,6,JULI
SULAWESI BARAT,PASANGKAYU,SARJO,SARJO,44,17,9,2,0,0,0,6,3,0,3,4,7,6,1,6,15,13,2,2,11,11,0,1,15,4,11,8,JULI
SULAWESI BARAT,PASANGKAYU,SARJO,MAPONU,32,29,18,5,2,2,2,15,1,0,15,3,1,0,1,0,28,22,6,1,19,10,9,4,37,31,6,26,JULI
SULAWESI BARAT,PASANGKAYU,SARJO,LETAWA,93,76,24,18,7,2,2,6,10,2,1,17,11,7,4,2,12,7,5,1,7,3,4,0,58,24,34,19,JULI
SULAWESI BARAT,PASANGKAYU,SARJO,SARUDE,96,26,18,9,4,0,0,11,4,3,17,1,12,10,2,3,22,6,16,2,2,0,2,0,0,0,0,0,JULI
SULAWESI BARAT,PASANGKAYU,SARUDU,DODA,33,13,12,3,2,2,0,12,0,0,12,0,3,1,2,1,11,6,5,0,10,7,3,0,9,0,9,1,JULI
SULAWESI BARAT,PASANGKAYU,SARUDU,SARUDU,78,33,4,4,2,0,0,2,0,2,0,0,6,1,5,1,29,15,14,7,21,17,4,6,31,0,31,13,JULI
SULAWESI BARAT,PASANGKAYU,SARUDU,BULU MARIO,99,52,39,3,1,1,1,33,4,0,33,3,17,2,15,0,46,45,1,27,26,18,8,15,43,10,33,33,JULI
SULAWESI BARAT,PASANGKAYU,SARUDU,KUMASARI,88,72,4,1,0,0,0,0,4,0,4,0,11,5,6,1,68,8,60,6,32,17,15,17,12,5,7,0,JULI
SULAWESI BARAT,PASANGKAYU,SARUDU,PATIKA,53,80,43,34,13,5,5,21,14,1,36,5,5,5,0,1,58,25,33,11,56,36,20,20,34,19,15,17,JULI
SULAWESI BARAT,PASANGKAYU,TIKKE RAYA,MAKMUR JAYA,52,51,19,16,3,1,0,9,0,7,18,1,1,1,0,0,50,45,5,36,12,6,6,3,29,2,27,16,JULI
SULAWESI BARAT,PASANGKAYU,TIKKE RAYA,LARIANG,73,75,12,6,2,0,0,6,4,2,12,0,4,2,2,2,68,21,47,2,54,1,53,1,52,7,45,13,JULI
SULAWESI BARAT,PASANGKAYU,TIKKE RAYA,TIKKE,41,39,17,10,3,1,0,11,5,0,16,1,2,1,1,0,14,13,1,11,11,8,3,0,23,14,9,18,JULI
SULAWESI BARAT,PASANGKAYU,TIKKE RAYA,PAJALELE,31,65,16,9,2,1,0,0,8,6,14,1,4,4,0,3,19,15,4,13,8,4,4,0,6,6,0,5,JULI
SULAWESI BARAT,PASANGKAYU,TIKKE RAYA,JENGENG RAYA,35,14,12,4,3,1,1,3,2,5,9,0,3,2,1,0,13,8,5,3,6,6,0,5,5,2,3,4,JULI
SULAWESI BARAT,MAJENE,BANGGAE,BANGGAE,43,23,3,2,1,1,0,2,1,0,3,0,6,0,6,0,13,6,7,1,6,2,4,1,15,15,0,10,JULI
SULAWESI BARAT,MAJENE,BANGGAE,BARU,50,35,2,2,1,1,0,2,0,0,0,0,9,1,8,1,33,20,13,8,5,1,4,0,1,0,1,0,JULI
SULAWESI BARAT,MAJENE,BANGGAE,PANGALI ALI,34,45,10,4,3,1,1,4,3,0,7,3,5,0,5,0,29,21,8,6,20,15,5,14,49,28,21,2,JULI
SULAWESI BARAT,MAJENE,BANGGAE,TOTOLI,39,47,30,4,0,0,0,30,0,0,2,14,4,3,1,3,27,7,20,6,8,7,1,4,34,18,16,26,JULI
SULAWESI BARAT,MAJENE,BANGGAE,RANGAS,44,40,17,5,5,0,0,15,2,0,7,2,4,2,2,0,40,9,31,4,13,6,7,6,35,10,25,4,JULI
SULAWESI BARAT,MAJENE,BANGGAE,GALUNG,64,68,65,35,12,12,6,49,0,8,21,31,10,2,8,0,17,16,1,8,0,0,0,0,0,0,0,0,JULI
SULAWESI BARAT,MAJENE,BANGGAE,PALIPI SOREANG,70,64,55,33,6,5,5,18,8,14,24,12,12,3,9,2,42,24,18,9,21,15,6,10,27,5,22,10,JULI
SULAWESI BARAT,MAJENE,BANGGAE,PAMBOBORANG,38,58,21,1,1,0,0,8,6,7,10,10,6,6,0,3,50,21,29,5,40,24,16,22,35,31,4,31,JULI
SULAWESI BARAT,MAJENE,BANGGAE TIMUR,BAURUNG,56,57,44,22,15,0,0,13,17,0,33,6,0,0,0,0,38,30,8,16,34,15,19,12,17,8,9,9,JULI
SULAWESI BARAT,MAJENE,BANGGAE TIMUR,BARUGA,46,26,23,0,0,0,0,2,6,11,8,10,8,8,0,8,18,10,8,2,14,1,13,0,32,19,13,17,JULI
SULAWESI BARAT,MAJENE,BANGGAE TIMUR,BARUGA DHUA,60,23,19,16,8,6,3,7,0,8,17,0,1,1,0,0,10,9,1,9,4,0,4,0,17,16,1,16,JULI
SULAWESI BARAT,MAJENE,BANGGAE TIMUR,LABUANG,95,38,10,8,1,0,0,8,2,0,0,0,2,1,1,0,13,13,0,6,0,0,0,0,24,19,5,8,JULI
SULAWESI BARAT,MAJENE,BANGGAE TIMUR,TANDE,37,73,17,15,15,12,3,9,4,0,8,0,4,0,4,0,69,43,26,12,30,0,30,0,9,9,0,6,JULI
SULAWESI BARAT,MAJENE,BANGGAE TIMUR,LEMBANG,75,58,48,36,14,3,3,24,8,10,3,27,0,0,0,0,39,24,15,18,39,11,28,5,79,75,4,75,JULI
SULAWESI BARAT,MAJENE,BANGGAE TIMUR,LABUANG UTARA,88,69,13,11,9,3,0,7,4,2,6,0,6,2,4,0,65,52,13,8,7,7,0,2,10,2,8,8,JULI
SULAWESI BARAT,MAJENE,BANGGAE TIMUR,TANDE TIMUR,66,48,3,2,1,0,0,0,1,2,1,2,8,7,1,0,43,18,25,12,35,9,26,8,58,19,39,5,JULI
SULAWESI BARAT,MAJENE,BANGGAE TIMUR,BUTTU BARUGA,94,14,0,0,0,0,0,0,0,0,0,0,10,4,6,1,12,12,0,9,3,0,3,0,11,8,3,1,JULI
SULAWESI BARAT,MAJENE,MALUNDA,MALUNDA,69,57,21,7,0,0,0,0,17,2,6,4,13,1,12,1,38,35,3,9,1,0,1,0,4,1,3,3,JULI
SULAWESI BARAT,MAJENE,MALUNDA,LAMUNGANG BATU,76,76,21,18,18,11,9,9,1,2,13,8,3,0,3,0,69,69,0,61,23,18,5,13,34,25,9,7,JULI
SULAWESI BARAT,MAJENE,MALUNDA,BAMBANGAN,86,73,13,4,4,2,2,4,2,4,8,1,17,0,17,0,38,5,33,4,33,0,33,0,66,49,17,4,JULI
SULAWESI BARAT,MAJENE,MALUNDA,LOMBANG,77,54,2,2,0,0,0,0,0,1,2,0,15,3,12,1,36,21,15,16,23,20,3,11,20,9,11,0,JULI
SULAWESI BARAT,MAJENE,MALUNDA,LOMBONG,89,69,0,0,0,0,0,0,0,0,0,0,16,9,7,1,66,20,46,11,44,13,31,12,53,12,41,32,JULI
SULAWESI BARAT,MAJENE,MALUNDA,MEKKATTA,84,55,35,18,10,4,4,28,2,0,7,14,0,0,0,0,42,26,16,1,28,4,24,4,10,1,9,9,JULI
SULAWESI BARAT,MAJENE,MALUNDA,MALIAYA,62,13,12,11,2,0,0,12,0,0,0,0,0,0,0,0,10,10,0,10,5,3,2,3,12,2,10,11,JULI
SULAWESI BARAT,MAJENE,MALUNDA,LOMBANG TIMUR,77,12,5,1,1,0,0,5,0,0,4,1,15,12,3,9,11,5,6,4,11,8,3,3,7,7,0,7,JULI
SULAWESI BARAT,MAJENE,MALUNDA,SALUTAHONGAN,52,59,36,5,0,0,0,16,2,2,16,7,0,0,0,0,34,14,20,8,21,3,18,0,61,50,11,25,JULI
SULAWESI BARAT,MAJENE,MALUNDA,LOMBONG TIMUR,78,48,20,5,3,0,0,20,0,0,9,10,3,1,2,1,48,14,34,6,6,3,3,2,21,4,17,8,JULI
SULAWESI BARAT,MAJENE,MALUNDA,MEKKATTA SELATAN,76,77,43,6,3,3,3,6,28,3,31,0,0,0,0,0,31,17,14,13,31,10,21,1,33,26,7,14,JULI
SULAWESI BARAT,MAJENE,MALUNDA,KAYUANGIN,46,12,6,4,4,2,1,4,1,0,2,4,2,0,2,0,11,8,3,4,9,2,7,2,4,0,4,4,JULI
SULAWESI BARAT,MAJENE,PAMBOANG,LALAMPANUA,86,36,31,11,9,7,7,7,3,8,30,1,4,0,4,0,19,10,9,4,9,2,7,1,7,7,0,2,JULI
SULAWESI BARAT,MAJENE,PAMBOANG,SIRINDU,76,65,39,20,6,6,1,4,22,10,26,7,3,3,0,3,48,47,1,18,24,21,3,20,11,8,3,4,JULI
SULAWESI BARAT,MAJENE,PAMBOANG,ADOLANG,78,39,38,24,8,0,0,33,4,1,9,13,9,2,7,0,23,17,6,2,5,5,0,5,29,12,17,28,JULI
SULAWESI BARAT,MAJENE,PAMBOANG,BABABULO,36,76,20,17,6,0,0,1,5,1,16,0,5,4,1,3,51,41,10,22,41,13,28,11,34,6,28,32,JULI
SULAWESI BARAT,MAJENE,PAMBOANG,BONDE,58,18,0,0,0,0,0,0,0,0,0,0,8,5,3,5,10,8,2,0,6,4,2,1,16,0,16,13,JULI
SULAWESI BARAT,MAJENE,PAMBOANG,BETTENG,66,12,11,2,2,2,0,8,2,0,2,2,1,1,0,1,10,6,4,4,9,9,0,2,7,0,7,5,JULI
SULAWESI BARAT,MAJENE,PAMBOANG,SIMBANG,68,68,33,10,5,1,1,19,11,1,9,14,1,0,1,0,58,42,16,16,23,15,8,3,56,24,32,5,JULI
SULAWESI BARAT,MAJENE,PAMBOANG,BONDE UTARA,91,52,52,51,9,0,0,11,0,15,43,0,6,3,3,1,25,9,16,2,15,1,14,0,30,16,14,29,JULI
SULAWESI BARAT,MAJENE,PAMBOANG,BABABULO UTARA,39,79,4,4,3,0,0,1,2,0,2,0,4,0,4,0,68,51,17,50,64,42,22,42,74,9,65,8,JULI
SULAWESI BARAT,MAJENE,PAMBOANG,BUTTU PAMBOANG,38,23,9,2,1,0,0,0,1,1,6,0,5,5,0,1,23,5,18,0,23,2,21,1,39,25,14,22,JULI
SULAWESI BARAT,MAJENE,PAMBOANG,BANUA ADOLANG,62,77,7,2,0,0,0,0,2,4,4,3,1,1,0,0,77,49,28,10,32,15,17,13,36,7,29,28,JULI
SULAWESI BARAT,MAJENE,PAMBOANG,ADOLANG DHUA,68,61,14,6,0,0,0,12,1,1,14,0,9,6,3,2,29,17,12,3,26,21,5,17,40,12,28,33,JULI
SULAWESI BARAT,MAJENE,PAMBOANG,TINAMBUNG,43,47,31,17,5,3,2,8,4,8,13,15,3,1,2,1,16,13,3,9,11,11,0,11,39,22,17,24,JULI
SULAWESI BARAT,MAJENE,PAMBOANG,PESULOANG,70,36,13,9,2,2,0,4,7,0,0,9,10,8,2,8,36,18,18,0,9,2,7,2,11,0,11,4,JULI
SULAWESI BARAT,MAJENE,PAMBOANG,BALOMBONG,49,35,16,15,3,1,0,2,8,4,11,2,6,4,2,3,26,23,3,7,19,2,17,2,23,23,0,11,JULI
SULAWESI BARAT,MAJENE,SENDANA,MOSSO,71,61,10,3,0,0,0,5,1,2,9,1,10,9,1,5,19,14,5,13,3,2,1,0,19,3,16,8,JULI
SULAWESI BARAT,MAJENE,SENDANA,MOSSO DHUA,54,15,15,14,8,5,0,0,13,2,7,6,3,0,3,0,11,8,3,4,10,8,2,6,17,6,11,14,JULI
SULAWESI BARAT,MAJENE,SENDANA,TOTOLISI SENDANA,82,17,6,4,4,1,0,5,0,1,1,1,5,1,4,1,11,9,2,2,1,0,1,0,6,0,6,5,JULI
SULAWESI BARAT,MAJENE,SENDANA,TALLUBANUA,94,64,46,42,36,22,14,20,12,0,41,1,18,6,12,6,36,24,12,16,18,12,6,9,19,1,18,19,JULI
SULAWESI BARAT,MAJENE,SENDANA,LALATEDZONG,84,58,34,14,7,1,1,5,1,2,29,1,6,3,3,0,39,24,15,24,27,6,21,3,50,25,25,32,JULI
SULAWESI BARAT,MAJENE,SENDANA,BINANGA,50,16,2,2,2,0,0,1,1,0,1,1,4,4,0,0,12,6,6,0,1,0,1,0,8,2,6,8,JULI
SULAWESI BARAT,MAJENE,SENDANA,PUTTADA,45,70,3,2,2,2,1,2,0,0,2,0,4,1,3,0,40,9,31,1,2,2,0,2,51,47,4,44,JULI
SULAWESI BARAT,MAJENE,SENDANA,PAMINGGALAN,66,31,31,13,2,1,1,12,14,0,21,10,9,4,5,2,21,18,3,3,19,0,19,0,22,8,14,9,JULI
SULAWESI BARAT,MAJENE,SENDANA,LEPPANGANG,57,12,0,0,0,0,0,0,0,0,0,0,4,3,1,2,10,5,5,3,7,7,0,3,5,5,0,3,JULI
SULAWESI BARAT,MAJENE,SENDANA,PUNDAU,91,79,10,4,2,0,0,7,3,0,7,2,4,0,4,0,74,36,38,5,58,33,25,3,53,22,31,24,JULI
SULAWESI BARAT,MAJENE,SENDANA,SENDANA,32,27,2,0,0,0,0,0,2,0,0,0,0,0,0,0,18,17,1,6,5,0,5,0,12,3,9,3,JULI
SULAWESI BARAT,MAJENE,SENDANA,BANUA SENDANA,69,38,34,10,8,6,2,1,3,6,23,9,1,1,0,1,12,11,1,8,6,0,6,0,9,1,8,9,JULI
SULAWESI BARAT,MAJENE,SENDANA,TALLUBANUA UTARA,96,73,13,11,5,4,3,8,1,1,13,0,14,7,7,4,52,22,30,5,3,1,2,0,44,25,19,6,JULI
SULAWESI BARAT,MAJENE,SENDANA,LIMBORO RAMBU-RAMBU,31,21,0,0,0,0,0,0,0,0,0,0,5,1,4,1,21,11,10,9,18,9,9,5,13,1,12,11,JULI
SULAWESI BARAT,MAJENE,SENDANA,LIMBUA,56,25,20,16,9,7,6,6,2,1,14,1,2,0,2,0,25,23,2,19,8,4,4,0,6,3,3,1,JULI
SULAWESI BARAT,MAJENE,SENDANA,BUKIT SAMANG,66,39,12,2,0,0,0,3,0,7,6,2,4,4,0,3,27,13,14,8,14,8,6,2,23,4,19,4,JULI
SULAWESI BARAT,MAJENE,TAMMERODO SENDANA,SEPPONG,47,54,29,10,2,0,0,5,16,0,8,6,3,2,1,2,48,18,30,14,30,15,15,10,12,12,0,12,JULI
SULAWESI BARAT,MAJENE,TAMMERODO SENDANA,TAMMERODO,95,18,6,4,0,0,0,6,0,0,1,1,17,12,5,0,17,5,12,1,14,13,1,2,24,12,12,14,JULI
SULAWESI BARAT,MAJENE,TAMMERODO SENDANA,ULIDANG,49,44,4,3,0,0,0,3,1,0,3,0,1,1,0,1,28,18,10,0,22,21,1,20,15,1,14,13,JULI
SULAWESI BARAT,MAJENE,TAMMERODO SENDANA,TALLAMBALAO,34,46,37,0,0,0,0,25,10,1,31,2,5,3,2,0,37,22,15,12,32,29,3,15,28,7,21,26,JULI
SULAWESI BARAT,MAJENE,TAMMERODO SENDANA,TAMMERODO UTARA,80,61,33,18,18,1,0,26,6,0,1,18,1,0,1,0,25,5,20,1,8,4,4,2,38,13,25,21,JULI
SULAWESI BARAT,MAJENE,TAMMERODO SENDANA,MANYAMBA,66,25,14,13,9,3,3,9,0,1,1,4,3,1,2,1,19,6,13,1,14,5,9,3,17,13,4,11,JULI
SULAWESI BARAT,MAJENE,TAMMERODO SENDANA,AWO,76,42,42,31,24,18,14,22,6,0,19,13,9,9,0,9,35,5,30,2,33,23,10,1,24,15,9,22,JULI
SULAWESI BARAT,MAJENE,TUBO SENDANA,ONANG,55,53,9,7,5,3,1,8,0,0,7,1,6,0,6,0,50,37,13,37,0,0,0,0,25,12,13,18,JULI
SULAWESI BARAT,MAJENE,TUBO SENDANA,TUBO,35,19,1,0,0,0,0,0,0,0,0,0,7,1,6,0,13,10,3,9,3,0,3,0,3,1,2,3,JULI
SULAWESI BARAT,MAJENE,TUBO SENDANA,ONANG UTARA,95,79,16,13,4,2,0,12,2,0,16,0,9,6,3,5,14,12,2,0,9,1,8,0,7,1,6,0,JULI
SULAWESI BARAT,MAJENE,TUBO SENDANA,TUBO SELATAN,46,66,53,41,1,0,0,2,42,1,50,2,8,7,1,2,16,8,8,2,15,1,14,0,24,17,7,14,JULI
SULAWESI BARAT,MAJENE,TUBO SENDANA,BONDE BONDE,57,56,50,24,19,7,6,44,0,0,34,12,1,1,0,1,15,6,9,3,3,2,1,2,24,3,21,14,JULI
SULAWESI BARAT,MAJENE,TUBO SENDANA,TUBO TENGAH,46,69,7,7,6,0,0,1,1,0,3,4,9,7,2,5,53,17,36,17,30,19,11,12,23,23,0,13,JULI
SULAWESI BARAT,MAJENE,TUBO SENDANA,TUBO POANG,66,36,36,1,0,0,0,16,0,17,31,2,2,0,2,0,15,8,7,8,12,3,9,0,21,13,8,3,JULI
SULAWESI BARAT,MAJENE,ULUMANDA,KABIRAAN,77,61,50,12,7,5,0,50,0,0,40,2,12,5,7,3,61,40,21,30,55,38,17,12,15,4,11,3,JULI
SULAWESI BARAT,MAJENE,ULUMANDA,SAMBABO,67,27,22,18,9,0,0,18,4,0,18,4,12,12,0,0,15,8,7,6,5,1,4,1,17,3,14,4,JULI
SULAWESI BARAT,MAJENE,ULUMANDA,TANDEALLO,56,75,37,25,19,2,2,4,2,19,33,4,10,1,9,1,64,27,37,18,61,13,48,12,72,1,71,19,JULI
SULAWESI BARAT,MAJENE,ULUMANDA,ULUMANDA,33,10,10,9,7,0,0,3,6,0,6,0,1,1,0,1,10,5,5,4,6,6,0,1,2,1,1,2,JULI
SULAWESI BARAT,MAJENE,ULUMANDA,SALUTAMBUNG,33,26,25,16,14,9,1,18,0,3,19,6,3,2,1,0,22,15,7,9,21,10,11,2,39,25,14,8,JULI
SULAWESI BARAT,MAJENE,ULUMANDA,POPENGA,31,77,46,12,2,2,1,16,20,6,1,40,4,3,1,3,56,29,27,4,38,28,10,12,26,1,25,7,JULI
SULAWESI BARAT,MAJENE,ULUMANDA,SULAI,94,49,0,0,0,0,0,0,0,0,0,0,17,16,1,16,36,22,14,18,27,4,23,2,10,2,8,3,JULI
SULAWESI BARAT,MAJENE,ULUMANDA,PANGGALO,30,45,28,21,2,0,0,11,5,9,23,5,2,1,1,0,32,18,14,11,10,8,2,8,14,7,7,12,JULI
SULAWESI BARAT,MAMASA,ARALLE,ARALLE,52,63,22,13,6,5,0,1,9,5,18,1,5,2,3,0,25,22,3,16,12,10,2,0,46,21,25,16,JULI
SULAWESI BARAT,MAMASA,ARALLE,RALLE ANAK,89,47,37,14,11,8,3,25,5,0,8,6,8,4,4,1,43,35,8,0,36,14,22,2,35,23,12,0,JULI
SULAWESI BARAT,MAMASA,ARALLE,PANETEAN,82,54,34,26,18,16,5,1,15,0,29,4,2,1,1,0,45,35,10,27,14,7,7,6,31,24,7,23,JULI
SULAWESI BARAT,MAMASA,ARALLE,UHAILANU,96,71,27,13,4,3,2,25,0,0,3,2,15,4,11,0,65,62,3,17,31,11,20,11,80,43,37,48,JULI
SULAWESI BARAT,MAMASA,ARALLE,ARALLE UTARA,94,56,9,7,3,1,0,5,3,0,4,1,16,1,15,1,18,6,12,1,0,0,0,0,13,13,0,13,JULI
SULAWESI BARAT,MAMASA,ARALLE,UHAIDAHO,87,11,0,0,0,0,0,0,0,0,0,0,0,0,0,0,10,10,0,2,2,1,1,0,7,6,1,7,JULI
SULAWESI BARAT,MAMASA,ARALLE,BARURU,74,49,11,11,2,2,2,3,3,2,5,3,5,1,4,1,42,35,7,4,33,12,21,1,65,31,34,4,JULI
SULAWESI BARAT,MAMASA,ARALLE,RALLEANAK UTARA,79,79,24,10,6,4,3,4,1,15,17,7,14,11,3,7,68,12,56,6,55,27,28,4,47,44,3,14,JULI
SULAWESI BARAT,MAMASA,ARALLE,PAMOSEANG PANGGA,42,76,54,30,29,8,5,30,2,15,13,8,6,0,6,0,36,32,4,24,16,7,9,2,65,31,34,60,JULI
SULAWESI BARAT,MAMASA,ARALLE,KALABE,54,50,23,8,3,1,0,1,1,13,14,2,2,2,0,1,33,26,7,14,29,15,14,3,6,3,3,2,JULI
SULAWESI BARAT,MAMASA,ARALLE,ARALLE SELATAN,82,60,22,13,10,1,0,2,18,0,19,1,4,3,1,2,32,26,6,13,21,4,17,2,34,0,34,19,JULI
SULAWESI BARAT,MAMASA,ARALLE,HAHANGAN,80,77,15,1,0,0,0,3,12,0,3,6,14,3,11,0,16,15,1,0,7,3,4,1,13,1,12,7,JULI
SULAWESI BARAT,MAMASA,BALLA,BALLA,90,68,34,12,5,0,0,9,14,8,5,17,12,3,9,0,51,18,33,17,24,8,16,3,63,10,53,19,JULI
SULAWESI BARAT,MAMASA,BALLA,BALLA BARAT,82,47,36,22,4,4,0,17,8,6,19,6,10,8,2,5,30,25,5,20,19,5,14,3,36,30,6,26,JULI
SULAWESI BARAT,MAMASA,BALLA,BALLA SATANETEAN,63,18,12,0,0,0,0,12,0,0,8,2,1,0,1,0,18,7,11,4,15,13,2,13,11,2,9,0,JULI
SULAWESI BARAT,MAMASA,BALLA,BALLA TUMUKA,71,20,10,6,6,0,0,4,3,1,1,4,1,1,0,1,16,8,8,2,13,11,2,5,18,2,16,6,JULI
SULAWESI BARAT,MAMASA,BALLA,SEPAKUAN,60,67,30,0,0,0,0,23,6,1,1,13,2,2,0,2,67,48,19,31,57,40,17,22,26,6,20,5,JULI
SULAWESI BARAT,MAMASA,BALLA,PIDARA,77,42,6,2,1,0,0,5,1,0,0,3,3,2,1,2,34,28,6,4,4,2,2,2,20,17,3,15,JULI
SULAWESI BARAT,MAMASA,BALLA,BAMBAPUANG,91,21,12,4,4,2,0,2,4,1,9,3,2,2,0,1,16,6,10,0,16,5,11,0,5,5,0,2,JULI
SULAWESI BARAT,MAMASA,BALLA,BALLA TIMUR,90,56,23,9,7,6,5,7,4,4,22,0,2,2,0,2,35,27,8,9,8,3,5,1,45,39,6,39,JULI
SULAWESI BARAT,MAMASA,BAMBANG,MOKALLANG,49,49,39,19,6,4,4,7,10,12,16,23,6,4,2,4,13,5,8,5,2,2,0,1,27,3,24,19,JULI
SULAWESI BARAT,MAMASA,BAMBANG,MASOSO,74,27,12,4,4,2,1,11,0,0,5,2,14,3,11,2,16,10,6,4,16,0,16,0,8,0,8,5,JULI
SULAWESI BARAT,MAMASA,BAMBANG,SALUASSING,45,47,40,0,0,0,0,19,5,8,22,14,7,5,2,3,32,8,24,2,5,0,5,0,32,9,23,25,JULI
SULAWESI BARAT,MAMASA,BAMBANG,SALUBULO,53,40,23,16,8,0,0,1,17,5,12,0,3,0,3,0,22,6,16,0,21,1,20,1,35,20,15,1,JULI
SULAWESI BARAT,MAMASA,BAMBANG,SALUKADI,80,46,35,28,24,14,4,1,25,2,24,1,14,2,12,1,25,20,5,3,19,19,0,5,9,7,2,0,JULI
SULAWESI BARAT,MAMASA,BAMBANG,SALUKEPOPOK,84,38,36,18,9,8,5,20,0,1,17,9,8,2,6,2,24,17,7,13,18,7,11,2,18,14,4,14,JULI
SULAWESI BARAT,MAMASA,BAMBANG,ULUMAMBI BARAT,52,15,6,0,0,0,0,5,1,0,6,0,0,0,0,0,15,10,5,8,3,1,2,0,10,7,3,7,JULI
SULAWESI BARAT,MAMASA,BAMBANG,LIMBADEBATA,58,80,9,6,2,0,0,4,5,0,3,5,1,0,1,0,35,10,25,10,12,7,5,4,47,3,44,9,JULI
SULAWESI BARAT,MAMASA,BAMBANG,TANETE TOMBA,78,79,75,63,9,0,0,19,14,9,58,5,4,2,2,1,18,5,13,1,7,5,2,2,5,2,3,4,JULI
SULAWESI BARAT,MAMASA,BAMBANG,BAMBANG,60,42,10,0,0,0,0,10,0,0,9,1,9,3,6,1,38,21,17,19,32,28,4,7,13,13,0,4,JULI
SULAWESI BARAT,MAMASA,BAMBANG,RANTELEMO,55,39,13,1,1,1,1,2,6,3,13,0,1,0,1,0,39,9,30,6,38,28,10,8,20,19,1,11,JULI
SULAWESI BARAT,MAMASA,BAMBANG,SALUDENGEN,41,44,43,2,0,0,0,42,1,0,21,10,8,2,6,2,42,20,22,15,13,10,3,5,29,11,18,21,JULI
SULAWESI BARAT,MAMASA,BAMBANG,ULUMAMBI,44,53,52,51,24,22,16,11,12,2,7,40,2,0,2,0,48,30,18,0,12,0,12,0,5,2,3,0,JULI
SULAWESI BARAT,MAMASA,BAMBANG,BAMBANG TIMUR,43,13,1,0,0,0,0,1,0,0,1,0,3,2,1,2,12,7,5,0,7,5,2,0,8,4,4,7,JULI
SULAWESI BARAT,MAMASA,BAMBANG,MINANGA,98,70,3,1,1,0,0,2,1,0,0,2,15,4,11,2,51,5,46,2,35,14,21,13,6,4,2,0,JULI
SULAWESI BARAT,MAMASA,BAMBANG,SIKAMASE,95,63,12,1,0,0,0,5,7,0,6,6,10,3,7,2,42,28,14,13,1,1,0,0,38,22,16,28,JULI
SULAWESI BARAT,MAMASA,BAMBANG,RANTETARIMA,96,71,42,40,18,12,5,5,14,4,13,23,14,12,2,2,19,15,4,4,13,10,3,1,49,14,35,12,JULI
SULAWESI BARAT,MAMASA,BAMBANG,SALURURU,90,13,1,0,0,0,0,1,0,0,0,1,8,1,7,0,12,6,6,6,2,0,2,0,3,3,0,2,JULI
SULAWESI BARAT,MAMASA,BAMBANG,SALUTABANG,36,76,40,5,4,4,2,37,0,0,16,21,2,0,2,0,20,9,11,1,6,0,6,0,0,0,0,0,JULI
SULAWESI BARAT,MAMASA,BAMBANG,BALATANA,62,63,4,4,4,2,1,0,0,1,1,0,12,5,7,5,63,30,33,17,2,2,0,1,20,0,20,5,JULI
SULAWESI BARAT,MAMASA,BUNTUMALANGKA,BUNTUMALANGKA,61,36,20,20,4,2,0,18,1,0,4,13,3,3,0,2,18,15,3,2,17,5,12,1,22,2,20,0,JULI
SULAWESI BARAT,MAMASA,BUNTUMALANGKA,RANTEBERAN,52,26,21,14,11,5,4,7,4,3,16,5,4,0,4,0,23,9,14,4,5,0,5,0,12,2,10,8,JULI
SULAWESI BARAT,MAMASA,BUNTUMALANGKA,KEBANGA,89,46,18,15,6,1,1,11,2,4,16,1,8,1,7,1,36,22,14,14,25,24,1,24,46,30,16,35,JULI
SULAWESI BARAT,MAMASA,BUNTUMALANGKA,SALURINDU,87,78,70,61,5,4,3,18,28,18,23,23,1,1,0,1,59,38,21,10,27,27,0,9,73,51,22,24,JULI
SULAWESI BARAT,MAMASA,BUNTUMALANGKA,TAORA,95,68,35,6,4,3,0,32,0,1,10,25,2,2,0,1,21,15,6,7,14,11,3,2,26,17,9,19,JULI
SULAWESI BARAT,MAMASA,BUNTUMALANGKA,KABAE,54,62,16,2,0,0,0,16,0,0,12,3,6,5,1,2,16,14,2,12,16,6,10,4,14,9,5,3,JULI
SULAWESI BARAT,MAMASA,BUNTUMALANGKA,SALUTAMBUN BARAT,75,23,18,1,1,0,0,14,4,0,1,4,2,0,2,0,11,8,3,3,4,4,0,0,15,10,5,9,JULI
SULAWESI BARAT,MAMASA,BUNTUMALANGKA,PENATANGAN,52,49,5,5,3,3,3,1,1,0,1,3,3,1,2,1,30,28,2,8,10,8,2,1,13,7,6,8,JULI
SULAWESI BARAT,MAMASA,BUNTUMALANGKA,SALUTAMBUN TIMUR,92,26,24,20,5,5,1,4,9,2,1,22,12,7,5,3,21,9,12,0,16,11,5,6,19,16,3,5,JULI
SULAWESI BARAT,MAMASA,BUNTUMALANGKA,SALUTAMBUN,40,65,25,23,18,8,0,0,3,8,15,9,2,1,1,0,31,29,2,15,10,0,10,0,31,21,10,26,JULI
SULAWESI BARAT,MAMASA,BUNTUMALANGKA,ARALLE TIMUR,87,14,4,4,0,0,0,4,0,0,0,4,13,2,11,0,12,7,5,0,4,4,0,3,8,4,4,7,JULI
SULAWESI BARAT,MAMASA,MAMASA,MAMASA,95,46,34,27,27,21,19,5,3,3,34,0,3,2,1,1,25,20,5,5,17,4,13,2,12,7,5,11,JULI
SULAWESI BARAT,MAMASA,MAMASA,RAMBUSARATU,66,61,0,0,0,0,0,0,0,0,0,0,13,9,4,1,47,40,7,15,47,17,30,16,52,48,4,24,JULI
SULAWESI BARAT,MAMASA,MAMASA,OSANGO,79,21,15,0,0,0,0,12,1,1,11,2,12,3,9,2,16,9,7,0,5,5,0,4,18,13,5,3,JULI
SULAWESI BARAT,MAMASA,MAMASA,LAMBANAN,40,27,10,1,1,0,0,5,3,0,9,0,8,4,4,0,15,15,0,6,15,11,4,4,8,5,3,8,JULI
SULAWESI BARAT,MAMASA,MAMASA,LEMBANA SALULO,79,34,22,2,2,1,0,8,10,4,2,5,9,6,3,3,13,10,3,0,0,0,0,0,14,0,14,2,JULI
SULAWESI BARAT,MAMASA,MAMASA,TAUPE,43,26,4,2,2,2,2,1,1,0,1,2,8,5,3,4,21,17,4,8,12,12,0,5,16,0,16,9,JULI
SULAWESI BARAT,MAMASA,MAMASA,BUNTU BUDA,70,46,3,2,0,0,0,2,1,0,0,0,12,1,11,0,27,8,19,0,20,11,9,9,51,30,21,1,JULI
SULAWESI BARAT,MAMASA,MAMASA,TONDOK BAKARU,63,10,7,1,0,0,0,6,1,0,3,4,0,0,0,0,10,7,3,0,3,3,0,3,3,0,3,2,JULI
SULAWESI BARAT,MAMASA,MAMASA,PEBASSIAN,97,22,12,6,2,1,1,1,4,5,4,8,15,1,14,1,13,6,7,6,6,6,0,0,11,7,4,3,JULI
SULAWESI BARAT,MAMASA,MAMASA,MAMBULILING,38,52,51,12,2,1,1,3,34,0,29,22,6,3,3,0,33,30,3,18,3,0,3,0,28,18,10,26,JULI
SULAWESI BARAT,MAMASA,MAMASA,BOMBONG LAMBE,81,74,49,40,40,3,3,45,1,0,47,1,0,0,0,0,14,14,0,9,10,9,1,1,51,36,15,22,JULI
SULAWESI BARAT,MAMASA,MAMASA,BUBUN BATU,64,65,1,0,0,0,0,0,0,1,1,0,12,6,6,1,56,45,11,43,12,5,7,3,18,4,14,16,JULI
SULAWESI BARAT,MAMASA,MAMBI,MAMBI,94,71,1,1,1,1,1,0,0,0,0,0,5,1,4,0,42,15,27,4,26,6,20,1,65,3,62,8,JULI
SULAWESI BARAT,MAMASA,MAMBI,TALIPUKKI,89,38,0,0,0,0,0,0,0,0,0,0,11,11,0,11,12,9,3,1,5,1,4,1,21,11,10,4,JULI
SULAWESI BARAT,MAMASA,MAMBI,RANTEBULAHAN,48,78,64,21,20,17,12,0,39,11,63,0,3,3,0,3,31,29,2,7,0,0,0,0,42,12,30,39,JULI
SULAWESI BARAT,MAMASA,MAMBI,SONDONGLAYU,47,41,40,4,3,0,0,14,1,16,26,7,5,0,5,0,25,18,7,12,14,4,10,0,30,26,4,23,JULI
SULAWESI BARAT,MAMASA,MAMBI,SALUBANUA,78,43,38,31,14,5,2,22,3,9,7,24,0,0,0,0,40,12,28,2,39,4,35,2,65,52,13,1,JULI
SULAWESI BARAT,MAMASA,MAMBI,TAPALINA,45,79,29,26,13,11,3,19,5,2,12,13,2,0,2,0,34,7,27,2,9,5,4,0,20,4,16,12,JULI
SULAWESI BARAT,MAMASA,MAMBI,SENDANA,100,47,20,16,7,1,0,3,3,14,5,11,6,2,4,2,17,12,5,8,10,2,8,0,11,9,2,0,JULI
SULAWESI BARAT,MAMASA,MAMBI,PAMOSEAN,36,17,10,4,2,1,1,2,4,1,9,0,7,4,3,1,10,5,5,4,0,0,0,0,6,6,0,4,JULI
SULAWESI BARAT,MAMASA,MAMBI,SELUMAKA,77,31,6,4,3,3,2,2,2,0,2,1,9,2,7,1,23,11,12,9,19,7,12,4,33,4,29,15,JULI
SULAWESI BARAT,MAMASA,MAMBI,BUJUNG MANURUNG,45,55,23,9,8,7,3,5,8,2,7,15,0,0,0,0,15,6,9,3,11,11,0,5,47,33,14,5,JULI
SULAWESI BARAT,MAMASA,MAMBI,SALU ALO,71,74,22,11,6,6,1,10,7,0,15,7,8,7,1,4,62,50,12,36,16,8,8,0,2,2,0,1,JULI
SULAWESI BARAT,MAMASA,MAMBI,INDOBANUA,54,38,28,17,8,7,0,16,2,10,27,0,0,0,0,0,35,24,11,8,31,5,26,2,18,11,7,9,JULI
SULAWESI BARAT,MAMASA,MAMBI,SALUDURIAN,32,77,49,46,19,16,13,12,16,1,22,4,5,2,3,2,58,17,41,3,12,8,4,8,10,7,3,7,JULI
SULAWESI BARAT,MAMASA,MEHALAAN,MEHALAAN,91,35,17,7,1,0,0,1,6,8,2,8,13,12,1,11,13,6,7,5,4,1,3,1,2,0,2,0,JULI
SULAWESI BARAT,MAMASA,MEHALAAN,BOTTENG,50,25,11,1,0,0,0,2,4,5,10,0,9,2,7,0,24,21,3,13,2,0,2,0,15,14,1,8,JULI
SULAWESI BARAT,MAMASA,MEHALAAN,SALUKONTA,76,78,71,9,9,9,6,10,8,40,13,22,15,6,9,1,73,34,39,15,50,1,49,0,104,74,30,52,JULI
SULAWESI BARAT,MAMASA,MEHALAAN,MESAKADA,95,64,38,37,28,13,4,33,1,0,20,16,2,1,1,1,31,16,15,0,6,0,6,0,36,4,32,6,JULI
SULAWESI BARAT,MAMASA,MEHALAAN,MEHALAAN BARAT,74,48,18,1,1,0,0,12,4,2,15,3,14,13,1,5,31,25,6,17,26,23,3,8,32,2,30,4,JULI
SULAWESI BARAT,MAMASA,MEHALAAN,SALUAHOK,38,59,39,5,1,0,0,0,20,5,33,5,1,0,1,0,24,13,11,5,19,10,9,9,48,0,48,7,JULI
SULAWESI BARAT,MAMASA,MEHALAAN,SALUBALO,32,28,1,1,0,0,0,1,0,0,0,1,3,1,2,1,11,9,2,0,2,0,2,0,17,14,3,4,JULI
SULAWESI BARAT,MAMASA,MEHALAAN,PASSEMBUK,92,76,46,18,12,0,0,3,4,8,38,5,15,6,9,1,16,12,4,0,5,1,4,0,17,16,1,4,JULI
SULAWESI BARAT,MAMASA,MEHALAAN,KONDO,79,30,30,6,1,1,1,17,11,0,17,3,0,0,0,0,20,12,8,3,14,5,9,2,9,0,9,6,JULI
SULAWESI BARAT,MAMASA,MEHALAAN,LEKO SUKAMAJU,61,75,39,37,27,7,7,19,8,2,9,22,9,9,0,7,70,52,18,8,20,1,19,1,69,69,0,55,JULI
SULAWESI BARAT,MAMASA,MEHALAAN,ULUMEA,30,56,29,9,7,7,4,16,0,9,15,1,5,2,3,2,21,9,12,6,10,7,3,2,28,28,0,12,JULI
SULAWESI BARAT,MAMASA,MESSAWA,MESSAWA,36,47,6,1,1,1,1,3,1,1,3,0,2,2,0,0,14,10,4,9,6,0,6,0,4,2,2,2,JULI
SULAWESI BARAT,MAMASA,MESSAWA,RIPPUNG,90,73,33,26,25,13,6,7,5,15,6,4,11,9,2,1,31,28,3,5,27,4,23,0,70,7,63,53,JULI
SULAWESI BARAT,MAMASA,MESSAWA,MAKUANG,85,55,9,9,1,0,0,9,0,0,0,9,13,8,5,2,54,7,47,1,52,33,19,26,3,1,2,1,JULI
SULAWESI BARAT,MAMASA,MESSAWA,SEPANG,54,43,11,7,0,0,0,4,1,5,0,10,1,1,0,0,40,11,29,9,37,3,34,0,64,63,1,5,JULI
SULAWESI BARAT,MAMASA,MESSAWA,MALIMBONG,73,66,51,14,8,2,1,29,5,7,36,8,7,5,2,2,21,5,16,4,4,0,4,0,22,21,1,1,JULI
SULAWESI BARAT,MAMASA,MESSAWA,MATANDE,50,27,16,4,0,0,0,4,4,0,5,6,3,2,1,1,16,11,5,0,14,10,4,9,16,12,4,8,JULI
SULAWESI BARAT,MAMASA,MESSAWA,SIPAI,89,49,31,8,1,0,0,8,22,0,28,2,13,7,6,6,41,30,11,28,15,13,2,0,9,7,2,8,JULI
SULAWESI BARAT,MAMASA,MESSAWA,PASMA MAMBU,92,17,13,1,0,0,0,12,0,0,4,2,8,4,4,1,15,6,9,4,1,0,1,0,10,3,7,2,JULI
SULAWESI BARAT,MAMASA,MESSAWA,TANETE BATU,64,79,30,30,22,3,0,8,15,7,22,4,7,1,6,0,17,8,9,7,3,0,3,0,18,12,6,5,JULI
SULAWESI BARAT,MAMASA,NOSU,NOSU,98,24,12,9,6,3,2,9,0,0,4,0,5,0,5,0,11,6,5,5,3,0,3,0,19,9,10,8,JULI
SULAWESI BARAT,MAMASA,NOSU,MINANGA,74,35,22,17,1,0,0,0,15,4,13,6,7,3,4,2,18,7,11,4,5,5,0,1,1,0,1,0,JULI
SULAWESI BARAT,MAMASA,NOSU,BATUPAPAN,44,70,51,7,1,1,0,40,3,5,10,11,4,3,1,3,10,5,5,4,3,2,1,2,22,16,6,12,JULI
SULAWESI BARAT,MAMASA,NOSU,MASEWWE,49,31,8,8,5,3,1,1,6,0,4,3,8,8,0,6,19,17,2,11,5,5,0,4,16,3,13,0,JULI
SULAWESI BARAT,MAMASA,NOSU,SIWI,78,26,9,9,5,2,1,6,1,1,6,1,4,3,1,2,14,12,2,10,9,2,7,2,17,0,17,14,JULI
SULAWESI BARAT,MAMASA,NOSU,MINANGA TIMUR,50,75,13,11,0,0,0,6,4,3,4,5,1,0,1,0,63,34,29,28,36,4,32,1,61,15,46,34,JULI
SULAWESI BARAT,MAMASA,NOSU,PARINDING,38,23,13,10,5,1,0,11,2,0,13,0,1,1,0,0,22,16,6,15,3,1,2,1,1,0,1,0,JULI
SULAWESI BARAT,MAMASA,PANA,PANA,38,26,13,6,2,1,1,10,2,0,1,6,1,1,0,0,15,12,3,8,8,0,8,0,17,6,11,5,JULI
SULAWESI BARAT,MAMASA,PANA,MANIPI,80,34,33,2,1,0,0,2,24,5,6,21,12,1,11,0,28,23,5,16,27,13,14,3,6,3,3,4,JULI
SULAWESI BARAT,MAMASA,PANA,MAMULLU,83,53,45,36,32,22,16,29,0,0,37,0,12,0,12,0,23,15,8,14,14,9,5,3,51,4,47,48,JULI
SULAWESI BARAT,MAMASA,PANA,SAPAN,73,28,2,0,0,0,0,0,2,0,1,1,3,2,1,0,18,7,11,4,6,1,5,0,25,14,11,22,JULI
SULAWESI BARAT,MAMASA,PANA,DATUBARINGAN,69,50,0,0,0,0,0,0,0,0,0,0,3,1,2,0,49,37,12,14,23,12,11,11,58,27,31,2,JULI
SULAWESI BARAT,MAMASA,PANA,PANURA,67,74,26,15,13,3,2,0,23,0,5,0,1,1,0,0,33,13,20,3,11,3,8,0,31,4,27,25,JULI
SULAWESI BARAT,MAMASA,PANA,TALLANG BULAWAN,71,61,12,3,3,1,1,8,2,1,7,5,14,5,9,2,61,11,50,7,15,4,11,0,40,40,0,14,JULI
SULAWESI BARAT,MAMASA,PANA,KARAKA,72,21,20,16,9,7,7,5,3,2,8,5,14,6,8,2,19,11,8,8,13,9,4,5,12,11,1,4,JULI
SULAWESI BARAT,MAMASA,PANA,ULUSALU,36,62,31,21,15,7,7,24,0,0,25,3,3,3,0,2,61,59,2,44,39,36,3,4,46,46,0,28,JULI
SULAWESI BARAT,MAMASA,PANA,WERI,75,80,41,1,0,0,0,14,3,22,16,2,3,3,0,1,70,30,40,14,52,35,17,14,1,0,1,0,JULI
SULAWESI BARAT,MAMASA,PANA,SALUTAMBUN,92,79,61,14,7,5,0,5,29,6,46,10,6,5,1,1,16,11,5,8,13,3,10,3,47,18,29,34,JULI
SULAWESI BARAT,MAMASA,PANA,SALOAN,56,40,17,3,0,0,0,15,0,1,7,6,6,3,3,2,27,5,22,3,21,10,11,1,27,9,18,17,JULI
SULAWESI BARAT,MAMASA,PANA,ULUSALU INDAH,30,58,9,4,0,0,0,7,1,1,8,1,4,4,0,4,41,18,23,3,3,0,3,0,10,8,2,10,JULI
SULAWESI BARAT,MAMASA,RANTEBULAHAN TIMUR,SALUMOKANAN,32,50,15,0,0,0,0,9,3,1,10,1,4,4,0,3,27,25,2,20,21,15,6,6,34,18,16,32,JULI
SULAWESI BARAT,MAMASA,RANTEBULAHAN TIMUR,SALUMOKANAN BARAT,82,24,5,0,0,0,0,1,4,0,3,1,6,6,0,4,19,12,7,5,5,4,1,1,7,4,3,0,JULI
SULAWESI BARAT,MAMASA,RANTEBULAHAN TIMUR,BUANGIN,38,20,15,12,1,1,0,9,2,0,7,3,5,1,4,0,17,8,9,5,0,0,0,0,2,0,2,2,JULI
SULAWESI BARAT,MAMASA,RANTEBULAHAN TIMUR,BAMBANG BUDA,47,39,0,0,0,0,0,0,0,0,0,0,1,0,1,0,10,7,3,7,8,1,7,0,9,2,7,6,JULI
SULAWESI BARAT,MAMASA,RANTEBULAHAN TIMUR,LEKO,85,60,60,23,2,0,0,21,32,3,4,27,2,2,0,1,57,17,40,10,20,1,19,1,14,9,5,8,JULI
SULAWESI BARAT,MAMASA,RANTEBULAHAN TIMUR,KIRAK,77,58,55,9,4,2,0,26,3,25,3,25,12,9,3,2,43,33,10,18,2,2,0,0,25,7,18,3,JULI
SULAWESI BARAT,MAMASA,RANTEBULAHAN TIMUR,SALUMOKANAN UTARA,57,18,3,3,2,0,0,2,0,0,0,0,2,1,1,1,18,7,11,3,6,4,2,3,2,0,2,0,JULI
SULAWESI BARAT,MAMASA,RANTEBULAHAN TIMUR,SAMPALE,54,16,5,0,0,0,0,3,0,0,0,0,2,2,0,0,15,6,9,5,10,1,9,1,14,11,3,2,JULI
SULAWESI BARAT,MAMASA,SESENAPADANG,OROBUA,92,33,28,14,11,5,1,16,11,0,24,0,10,4,6,2,11,6,5,2,6,4,2,2,4,3,1,2,JULI
SULAWESI BARAT,MAMASA,SESENAPADANG,PALADAN,63,56,24,5,5,3,0,24,0,0,24,0,1,0,1,0,48,40,8,2,3,3,0,1,37,9,28,15,JULI
SULAWESI BARAT,MAMASA,SESENAPADANG,OROBUA TIMUR,72,16,7,4,1,1,1,4,0,1,5,2,0,0,0,0,12,8,4,8,7,0,7,0,16,2,14,4,JULI
SULAWESI BARAT,MAMASA,SESENAPADANG,RANTE PUANG,90,19,11,8,5,0,0,9,2,0,0,3,1,0,1,0,13,5,8,4,1,1,0,1,3,1,2,2,JULI
SULAWESI BARAT,MAMASA,SESENAPADANG,SATENETEAN,65,61,60,16,8,3,0,6,33,21,2,7,6,3,3,3,48,41,7,34,44,41,3,22,47,29,18,8,JULI
SULAWESI BARAT,MAMASA,SESENAPADANG,LISUAN ADA,78,14,5,4,1,1,0,5,0,0,5,0,4,1,3,1,10,7,3,4,3,0,3,0,0,0,0,0,JULI
SULAWESI BARAT,MAMASA,SESENAPADANG,OROBUA SELATAN,80,11,0,0,0,0,0,0,0,0,0,0,1,1,0,1,10,9,1,1,4,1,3,1,3,3,0,0,JULI
SULAWESI BARAT,MAMASA,SESENAPADANG,MALANGKENA PADANG,65,24,0,0,0,0,0,0,0,0,0,0,11,1,10,0,21,16,5,9,5,4,1,3,17,17,0,14,JULI
SULAWESI BARAT,MAMASA,SESENAPADANG,MALIMBONG,70,34,2,2,0,0,0,0,1,1,2,0,5,0,5,0,33,33,0,0,25,19,6,16,46,12,34,4,JULI
SULAWESI BARAT,MAMASA,SESENAPADANG,MARAMPAN OROBUA,92,10,7,4,4,0,0,2,1,3,7,0,16,1,15,0,10,6,4,5,6,4,2,1,9,7,2,0,JULI
SULAWESI BARAT,MAMASA,SUMARORONG,SUMARORONG,85,47,18,5,4,0,0,17,0,1,0,18,14,1,13,0,16,15,1,4,9,2,7,0,15,9,6,13,JULI
SULAWESI BARAT,MAMASA,SUMARORONG,TABONE,62,54,43,11,1,1,0,35,5,3,42,1,2,0,2,0,22,21,1,5,20,0,20,0,36,6,30,19,JULI
SULAWESI BARAT,MAMASA,SUMARORONG,BATANG URU,98,61,22,3,0,0,0,4,17,0,12,4,11,6,5,3,15,14,1,1,8,2,6,1,8,4,4,5,JULI
SULAWESI BARAT,MAMASA,SUMARORONG,SASAKAN,72,62,59,3,3,2,2,2,28,25,2,26,5,1,4,0,26,15,11,3,20,8,12,8,38,25,13,30,JULI
SULAWESI BARAT,MAMASA,SUMARORONG,TADISI,74,11,6,5,4,2,0,0,6,0,2,4,0,0,0,0,10,7,3,3,6,2,4,1,3,3,0,3,JULI
SULAWESI BARAT,MAMASA,SUMARORONG,SIBANAWA,38,71,60,45,17,16,5,46,4,2,9,20,7,3,4,2,20,7,13,4,16,12,4,4,57,47,10,54,JULI
SULAWESI BARAT,MAMASA,SUMARORONG,BATANGNGURU TIMUR,30,67,50,33,18,18,4,28,2,13,36,6,0,0,0,0,25,21,4,10,24,9,15,8,70,54,16,43,JULI
SULAWESI BARAT,MAMASA,SUMARORONG,SALUBALO,37,65,24,15,11,6,4,6,13,1,2,15,2,2,0,0,49,22,27,0,27,16,11,6,11,4,7,11,JULI
SULAWESI BARAT,MAMASA,SUMARORONG,BANEA,33,17,9,9,4,4,3,5,1,0,9,0,4,2,2,2,15,13,2,10,3,2,1,1,12,6,6,0,JULI
SULAWESI BARAT,MAMASA,SUMARORONG,RANTE KAMASE,43,13,8,3,3,1,1,2,4,0,4,0,8,8,0,2,13,6,7,4,6,6,0,2,0,0,0,0,JULI
SULAWESI BARAT,MAMASA,TABANG,TABANG,42,32,25,4,1,1,1,11,9,0,22,2,4,2,2,0,23,17,6,4,2,1,1,0,5,3,2,4,JULI
SULAWESI BARAT,MAMASA,TABANG,TADOKALUA,48,40,13,13,10,5,3,4,0,5,12,0,5,2,3,2,23,18,5,13,6,5,1,1,22,7,15,1,JULI
SULAWESI BARAT,MAMASA,TABANG,TABANG BARAT,84,65,11,1,1,0,0,0,10,1,7,1,16,13,3,3,47,46,1,30,17,1,16,0,22,1,21,17,JULI
SULAWESI BARAT,MAMASA,TABANG,MASUPU,52,58,4,0,0,0,0,3,0,1,2,0,8,8,0,0,57,19,38,2,24,13,11,11,1,1,0,0,JULI
SULAWESI BARAT,MAMASA,TABANG,KALAMA,47,29,6,6,6,4,3,1,1,1,3,2,3,3,0,3,12,9,3,2,11,8,3,3,28,26,2,7,JULI
SULAWESI BARAT,MAMASA,TABANG,BAKADISURA,56,32,27,20,6,6,2,12,8,0,11,8,9,2,7,1,28,7,21,5,23,15,8,15,1,0,1,0,JULI
SULAWESI BARAT,MAMASA,TABANG,SALUKONA,35,53,52,17,2,2,0,31,19,0,52,0,2,2,0,1,52,13,39,2,3,1,2,0,34,8,26,33,JULI
SULAWESI BARAT,MAMASA,TABULAHAN,LAKAHANG,37,64,63,56,55,2,0,12,28,17,15,27,6,5,1,0,51,26,25,26,12,1,11,0,37,14,23,37,JULI
SULAWESI BARAT,MAMASA,TABULAHAN,PERIANGAN,76,69,42,42,20,15,2,1,34,0,3,38,15,12,3,6,63,61,2,42,0,0,0,0,21,14,7,17,JULI
SULAWESI BARAT,MAMASA,TABULAHAN,MALATIRO,52,73,33,18,8,6,2,2,25,1,11,22,6,4,2,2,55,50,5,31,8,7,1,4,19,5,14,15,JULI
SULAWESI BARAT,MAMASA,TABULAHAN,TABULAHAN,84,53,43,36,2,2,1,30,5,4,41,2,13,0,13,0,12,8,4,1,9,3,6,3,20,12,8,14,JULI
SULAWESI BARAT,MAMASA,TABULAHAN,SALULEANG,36,30,3,3,1,0,0,0,1,1,0,0,4,2,2,1,29,7,22,2,16,2,14,1,5,0,5,5,JULI
SULAWESI BARAT,MAMASA,TABULAHAN,TAMPAK KURRA,79,38,3,2,0,0,0,0,2,0,0,2,13,9,4,0,10,6,4,0,10,8,2,1,14,7,7,5,JULI
SULAWESI BARAT,MAMASA,TABULAHAN,GANDANG DEWATA,95,35,22,11,5,2,0,4,13,4,10,2,13,8,5,3,22,21,1,10,20,18,2,1,21,4,17,6,JULI
SULAWESI BARAT,MAMASA,TABULAHAN,BURANA,63,27,11,1,1,1,0,1,8,0,8,1,4,3,1,0,10,10,0,9,2,0,2,0,15,2,13,4,JULI
SULAWESI BARAT,MAMASA,TABULAHAN,SALUBAKKA,60,29,11,1,1,1,0,6,3,0,9,1,1,1,0,1,29,20,9,7,9,5,4,1,17,1,16,15,JULI
SULAWESI BARAT,MAMASA,TABULAHAN,PANGANDARAN,36,67,32,23,7,5,3,7,16,1,13,1,5,5,0,4,17,7,10,4,14,8,6,7,41,10,31,26,JULI
SULAWESI BARAT,MAMASA,TABULAHAN,TALOPAK,89,44,3,1,0,0,0,0,0,2,3,0,10,2,8,2,36,19,17,7,8,8,0,5,38,24,14,28,JULI
SULAWESI BARAT,MAMASA,TABULAHAN,PEU',99,35,28,17,11,7,7,4,15,1,17,7,19,8,11,0,33,22,11,7,25,5,20,1,4,2,2,1,JULI
SULAWESI BARAT,MAMASA,TABULAHAN,TIMORO,77,13,11,7,0,0,0,9,2,0,10,0,7,7,0,4,11,10,1,8,11,11,0,7,15,3,12,4,JULI
SULAWESI BARAT,MAMASA,TABULAHAN,LAKAHANG UTAMA,43,12,10,2,0,0,0,5,0,3,4,2,0,0,0,0,10,6,4,1,8,2,6,1,10,6,4,5,JULI
SULAWESI BARAT,MAMASA,TANDUK KALUA,MINAKE,69,72,23,4,2,1,1,6,5,1,13,6,5,3,2,1,69,22,47,11,17,1,16,0,26,24,2,9,JULI
SULAWESI BARAT,MAMASA,TANDUK KALUA,MALABO,68,15,8,3,2,2,0,8,0,0,4,4,2,1,1,0,15,7,8,0,6,1,5,0,7,0,7,2,JULI
SULAWESI BARAT,MAMASA,TANDUK KALUA,SINDAGAMANIK,86,19,1,0,0,0,0,0,1,0,1,0,16,16,0,6,17,10,7,5,0,0,0,0,7,5,2,6,JULI
SULAWESI BARAT,MAMASA,TANDUK KALUA,PARONDOBULAWAN,80,22,13,4,0,0,0,8,1,0,6,6,16,1,15,0,20,5,15,2,3,0,3,0,15,4,11,5,JULI
SULAWESI BARAT,MAMASA,TANDUK KALUA,TAMALANTIK,38,37,31,11,4,4,4,27,0,0,6,4,6,4,2,2,17,11,6,1,2,1,1,0,23,8,15,13,JULI
SULAWESI BARAT,MAMASA,TANDUK KALUA,MANNABABA,61,43,41,5,4,2,1,25,4,1,15,25,12,6,6,5,21,16,5,10,18,9,9,0,32,2,30,23,JULI
SULAWESI BARAT,MAMASA,TANDUK KALUA,MESAKADA,77,71,26,5,5,2,1,20,5,0,21,4,0,0,0,0,32,26,6,23,2,0,2,0,33,8,25,22,JULI
SULAWESI BARAT,MAMASA,TANDUK KALUA,BALLABATU,82,48,20,12,10,9,1,9,9,0,17,1,8,7,1,4,45,8,37,8,18,11,7,5,44,3,41,1,JULI
SULAWESI BARAT,MAMASA,TANDUK KALUA,PAMBE,91,16,4,0,0,0,0,3,0,1,1,1,14,12,2,4,15,9,6,2,12,8,4,6,22,12,10,9,JULI
SULAWESI BARAT,MAMASA,TANDUK KALUA,SALURANO,32,76,65,64,56,22,14,13,31,3,3,44,0,0,0,0,43,39,4,34,22,5,17,2,68,42,26,62,JULI
SULAWESI BARAT,MAMASA,TANDUK KALUA,TALIMBUNG,84,30,2,1,1,0,0,1,0,0,0,2,13,5,8,1,16,6,10,1,11,3,8,1,22,21,1,10,JULI
SULAWESI BARAT,MAMASA,TANDUK KALUA,KANAN,32,12,0,0,0,0,0,0,0,0,0,0,5,1,4,1,12,11,1,3,2,2,0,1,1,0,1,1,JULI
SULAWESI BARAT,MAMASA,TAWALIAN,TAWALIAN,55,37,22,16,11,2,0,11,3,4,18,1,1,0,1,0,16,14,2,11,12,7,5,1,20,10,10,11,JULI
SULAWESI BARAT,MAMASA,TAWALIAN,TAWALIAN TIMUR,31,60,42,14,1,1,1,18,23,0,2,19,2,0,2,0,57,12,45,12,41,14,27,9,14,14,0,6,JULI
SULAWESI BARAT,MAMASA,TAWALIAN,KARIANGO,93,79,39,8,0,0,0,6,29,3,5,34,18,4,14,0,63,39,24,3,56,34,22,14,74,64,10,40,JULI
SULAWESI BARAT,MAMASA,TAWALIAN,RANTETANGNGA,100,55,14,11,3,1,0,6,4,3,9,2,16,4,12,2,22,14,8,4,12,10,2,7,48,24,24,28,JULI
SULAWESI BARAT,POLEWALI MANDAR,ALLU,PETOOSANG,55,79,29,10,0,0,0,7,22,0,9,11,2,2,0,2,53,41,12,38,0,0,0,0,19,0,19,14,JULI
SULAWESI BARAT,POLEWALI MANDAR,ALLU,MOMBI,44,42,36,35,9,2,0,14,13,4,24,10,5,4,1,1,24,8,16,6,11,3,8,0,9,9,0,8,JULI
SULAWESI BARAT,POLEWALI MANDAR,ALLU,KALUMAMMANG,42,40,11,5,3,0,0,4,0,0,9,2,4,2,2,0,15,7,8,6,11,11,0,6,15,3,12,8,JULI
SULAWESI BARAT,POLEWALI MANDAR,ALLU,PAO-PAO,54,51,30,17,1,1,0,12,5,8,8,7,10,2,8,2,36,21,15,1,0,0,0,0,18,14,4,7,JULI
SULAWESI BARAT,POLEWALI MANDAR,ALLU,PUPPU URING,42,64,47,7,1,1,1,31,9,4,30,13,3,3,0,3,50,33,17,25,23,14,9,4,6,1,5,0,JULI
SULAWESI BARAT,POLEWALI MANDAR,ALLU,SARAGIAN,52,18,13,1,0,0,0,8,2,2,10,3,7,1,6,0,10,10,0,3,7,2,5,1,0,0,0,0,JULI
SULAWESI BARAT,POLEWALI MANDAR,ALLU,SAYOANG,100,78,28,20,0,0,0,3,7,2,28,0,14,7,7,4,63,9,54,7,35,20,15,5,11,8,3,5,JULI
SULAWESI BARAT,POLEWALI MANDAR,ALLU,ALU,57,15,15,1,0,0,0,14,0,0,1,9,8,4,4,0,14,11,3,10,2,0,2,0,9,6,3,0,JULI
SULAWESI BARAT,POLEWALI MANDAR,ANREAPI,ANREAPI,39,53,10,6,5,3,2,7,1,0,1,9,1,1,0,1,43,11,32,1,36,28,8,8,24,9,15,0,JULI
SULAWESI BARAT,POLEWALI MANDAR,ANREAPI,DUAMPANUA,87,62,59,38,12,2,0,25,13,12,55,1,13,2,11,2,48,33,15,33,4,2,2,0,20,1,19,12,JULI
SULAWESI BARAT,POLEWALI MANDAR,ANREAPI,KELAPA DUA,50,12,10,0,0,0,0,3,6,1,6,4,1,0,1,0,10,6,4,0,0,0,0,0,1,1,0,1,JULI
SULAWESI BARAT,POLEWALI MANDAR,ANREAPI,PAPPANDANGAN,33,45,33,27,1,1,1,11,13,5,27,2,2,2,0,1,34,6,28,1,33,23,10,5,15,1,14,2,JULI
SULAWESI BARAT,POLEWALI MANDAR,ANREAPI,KUNYI,98,67,53,30,27,0,0,34,18,1,26,7,7,4,3,1,65,32,33,1,52,43,9,10,64,56,8,51,JULI
SULAWESI BARAT,POLEWALI MANDAR,BALANIPA,BALANIPA,90,79,30,8,3,2,0,20,3,4,10,17,12,10,2,7,29,27,2,5,0,0,0,0,47,32,15,7,JULI
SULAWESI BARAT,POLEWALI MANDAR,BALANIPA,TAMMAJARRA,69,35,3,3,1,0,0,0,1,1,2,1,5,3,2,1,34,21,13,8,20,0,20,0,39,10,29,21,JULI
SULAWESI BARAT,POLEWALI MANDAR,BALANIPA,TAMANGGALLE,97,73,11,8,6,5,2,1,4,3,8,0,6,3,3,2,38,23,15,4,35,9,26,3,69,18,51,4,JULI
SULAWESI BARAT,POLEWALI MANDAR,BALANIPA,MOSSO,75,30,3,1,1,1,1,1,1,0,2,0,14,2,12,2,26,7,19,0,20,13,7,13,36,15,21,0,JULI
SULAWESI BARAT,POLEWALI MANDAR,BALANIPA,GALUNG TULUK,81,10,7,0,0,0,0,6,0,0,3,3,8,5,3,0,10,8,2,5,4,3,1,0,9,5,4,0,JULI
SULAWESI BARAT,POLEWALI MANDAR,BALANIPA,SABANG SUBIK,78,25,4,4,2,2,2,2,0,0,3,1,12,1,11,0,24,19,5,5,2,1,1,1,8,0,8,6,JULI
SULAWESI BARAT,POLEWALI MANDAR,BALANIPA,PAMBUSUANG,73,77,0,0,0,0,0,0,0,0,0,0,9,6,3,3,74,9,65,4,48,15,33,0,11,7,4,10,JULI
SULAWESI BARAT,POLEWALI MANDAR,BALANIPA,BALA,81,63,56,33,21,14,13,37,6,0,16,23,4,2,2,2,50,41,9,31,13,4,9,3,41,29,12,20,JULI
SULAWESI BARAT,POLEWALI MANDAR,BALANIPA,LAMBANAN,83,31,6,0,0,0,0,3,0,0,6,0,2,1,1,1,31,19,12,17,24,19,5,4,42,13,29,14,JULI
SULAWESI BARAT,POLEWALI MANDAR,BALANIPA,LEGO,41,49,33,14,0,0,0,27,5,1,24,8,5,2,3,2,39,31,8,26,24,10,14,4,39,15,24,23,JULI
SULAWESI BARAT,POLEWALI MANDAR,BALANIPA,PALLIS,90,39,0,0,0,0,0,0,0,0,0,0,2,1,1,0,15,11,4,1,12,6,6,6,36,0,36,32,JULI
SULAWESI BARAT,POLEWALI MANDAR,BINUANG,AMASSANGAN,82,24,10,3,2,1,1,6,0,3,7,1,2,0,2,0,11,6,5,4,10,2,8,2,23,15,8,14,JULI
SULAWESI BARAT,POLEWALI MANDAR,BINUANG,TONYAMAN,55,19,14,4,3,3,0,5,6,2,3,3,9,4,5,3,16,10,6,3,15,14,1,4,15,15,0,8,JULI
SULAWESI BARAT,POLEWALI MANDAR,BINUANG,KUAJANG,49,54,32,10,5,4,4,0,23,5,19,10,5,1,4,0,26,12,14,1,4,4,0,3,37,1,36,32,JULI
SULAWESI BARAT,POLEWALI MANDAR,BINUANG,PAKU,31,76,38,12,2,2,0,2,25,6,32,1,3,1,2,1,45,38,7,4,8,2,6,2,5,2,3,0,JULI
SULAWESI BARAT,POLEWALI MANDAR,BINUANG,MIRRING,79,45,26,17,9,5,4,15,7,0,13,9,8,2,6,2,33,7,26,3,5,4,1,1,36,21,15,28,JULI
SULAWESI BARAT,POLEWALI MANDAR,BINUANG,BATETANGNGA,77,59,55,26,10,3,0,44,5,0,3,42,5,5,0,5,28,5,23,1,12,1,11,0,46,9,37,3,JULI
SULAWESI BARAT,POLEWALI MANDAR,BINUANG,MAMMI,67,80,19,16,16,10,7,9,1,2,12,4,2,0,2,0,24,10,14,1,20,5,15,5,50,37,13,23,JULI
SULAWESI BARAT,POLEWALI MANDAR,BINUANG,KALEOK,65,71,17,9,6,5,2,10,3,0,10,7,2,0,2,0,18,11,7,8,7,6,1,2,34,18,16,10,JULI
SULAWESI BARAT,POLEWALI MANDAR,BINUANG,AMOLA,52,22,8,8,6,6,6,0,1,1,7,0,4,4,0,2,21,12,9,12,21,12,9,9,18,4,14,13,JULI
SULAWESI BARAT,POLEWALI MANDAR,BINUANG,REA,36,72,13,6,0,0,0,7,4,1,11,2,2,0,2,0,59,52,7,28,17,5,12,1,43,17,26,42,JULI
SULAWESI BARAT,POLEWALI MANDAR,BULO,BULO,35,20,17,1,1,0,0,5,7,3,3,6,5,4,1,2,18,11,7,4,9,0,9,0,7,4,3,0,JULI
SULAWESI BARAT,POLEWALI MANDAR,BULO,PULLIWA,78,55,40,25,7,1,1,26,1,11,9,29,13,9,4,7,54,19,35,9,11,7,4,5,41,31,10,14,JULI
SULAWESI BARAT,POLEWALI MANDAR,BULO,PATAMBANUA,97,24,20,9,7,6,2,11,7,0,13,1,1,0,1,0,12,12,0,0,3,3,0,2,17,6,11,4,JULI
SULAWESI BARAT,POLEWALI MANDAR,BULO,KAROMBANG,86,75,68,58,39,2,2,31,9,16,48,16,6,5,1,1,75,13,62,1,74,36,38,13,123,119,4,115,JULI
SULAWESI BARAT,POLEWALI MANDAR,BULO,DAALA TIMUR,88,49,21,4,0,0,0,17,1,1,9,7,2,2,0,2,17,11,6,6,13,6,7,5,45,18,27,41,JULI
SULAWESI BARAT,POLEWALI MANDAR,BULO,LENGGO,61,30,22,19,7,3,1,12,5,1,20,0,7,3,4,1,23,15,8,1,3,1,2,0,19,14,5,8,JULI
SULAWESI BARAT,POLEWALI MANDAR,BULO,SABURA,93,46,41,31,21,10,7,21,5,7,14,8,15,5,10,0,39,13,26,4,11,3,8,1,23,17,6,18,JULI
SULAWESI BARAT,POLEWALI MANDAR,BULO,SEPPORRAKI,50,45,0,0,0,0,0,0,0,0,0,0,8,3,5,2,14,10,4,2,6,5,1,1,8,2,6,1,JULI
SULAWESI BARAT,POLEWALI MANDAR,BULO,IHING,65,72,52,38,29,10,3,27,8,0,20,4,7,2,5,2,15,11,4,9,14,14,0,11,30,29,1,3,JULI
SULAWESI BARAT,POLEWALI MANDAR,CAMPALAGIAN,PAPPANG,57,15,10,3,0,0,0,8,0,2,1,8,4,1,3,1,15,6,9,1,11,11,0,10,17,8,9,11,JULI
SULAWESI BARAT,POLEWALI MANDAR,CAMPALAGIAN,LALIKO,100,41,39,16,9,3,0,21,6,8,16,5,19,15,4,5,15,6,9,1,4,3,1,2,11,0,11,6,JULI
SULAWESI BARAT,POLEWALI MANDAR,CAMPALAGIAN,BONDE,57,24,24,12,0,0,0,3,18,0,4,3,8,0,8,0,11,10,1,7,3,3,0,2,18,4,14,4,JULI
SULAWESI BARAT,POLEWALI MANDAR,CAMPALAGIAN,KATUMBANGAN LEMO,77,15,10,9,2,0,0,8,0,0,2,8,14,6,8,0,11,10,1,8,7,2,5,1,12,2,10,5,JULI
SULAWESI BARAT,POLEWALI MANDAR,CAMPALAGIAN,PANYAMPA,73,39,10,7,3,2,0,2,0,7,3,0,13,4,9,4,35,23,12,6,1,1,0,0,17,17,0,10,JULI
SULAWESI BARAT,POLEWALI MANDAR,CAMPALAGIAN,SURUANG,99,28,5,3,3,1,0,0,5,0,0,2,4,1,3,1,24,6,18,3,13,4,9,2,17,15,2,13,JULI
SULAWESI BARAT,POLEWALI MANDAR,CAMPALAGIAN,LAMPOKO,75,58,50,7,3,1,0,19,30,1,19,17,0,0,0,0,19,17,2,7,14,2,12,0,35,14,21,31,JULI
SULAWESI BARAT,POLEWALI MANDAR,CAMPALAGIAN,KATUMBANGAN,44,60,16,8,1,0,0,10,2,3,0,6,4,0,4,0,47,44,3,23,39,3,36,0,49,47,2,19,JULI
SULAWESI BARAT,POLEWALI MANDAR,CAMPALAGIAN,LAPEO,77,20,20,1,1,1,1,5,12,1,6,2,13,8,5,2,20,6,14,2,6,3,3,0,8,0,8,0,JULI
SULAWESI BARAT,POLEWALI MANDAR,CAMPALAGIAN,PARAPPE,80,77,5,5,5,4,1,4,0,0,2,0,10,10,0,3,60,25,35,4,26,26,0,8,55,43,12,15,JULI
SULAWESI BARAT,POLEWALI MANDAR,CAMPALAGIAN,ONGKO,86,36,4,1,1,1,1,3,0,0,2,1,11,6,5,0,11,10,1,8,3,3,0,3,0,0,0,0,JULI
SULAWESI BARAT,POLEWALI MANDAR,CAMPALAGIAN,KENJE,70,14,5,4,3,2,2,0,3,0,0,2,8,6,2,2,14,12,2,2,0,0,0,0,2,0,2,2,JULI
SULAWESI BARAT,POLEWALI MANDAR,CAMPALAGIAN,SUMARRANG,80,40,35,15,7,7,1,17,16,0,35,0,10,0,10,0,36,10,26,0,11,1,10,1,16,8,8,0,JULI
SULAWESI BARAT,POLEWALI MANDAR,CAMPALAGIAN,BOTTO,53,37,16,6,6,1,1,9,5,1,5,7,2,2,0,2,27,27,0,2,25,6,19,1,30,26,4,21,JULI
SULAWESI BARAT,POLEWALI MANDAR,CAMPALAGIAN,GATTUNGAN,37,19,0,0,0,0,0,0,0,0,0,0,4,4,0,1,14,10,4,1,3,1,2,1,13,1,12,5,JULI
SULAWESI BARAT,POLEWALI MANDAR,CAMPALAGIAN,PADANG TIMUR,30,60,0,0,0,0,0,0,0,0,0,0,1,0,1,0,33,13,20,7,29,22,7,9,16,15,1,8,JULI
SULAWESI BARAT,POLEWALI MANDAR,CAMPALAGIAN,PADANG,77,76,54,52,37,11,0,22,29,3,33,18,9,6,3,0,42,42,0,6,13,6,7,4,17,6,11,5,JULI
SULAWESI BARAT,POLEWALI MANDAR,CAMPALAGIAN,LAGI-AGI,58,69,38,32,12,9,3,24,0,7,15,18,1,1,0,1,49,26,23,19,37,17,20,5,28,4,24,4,JULI
SULAWESI BARAT,POLEWALI MANDAR,LIMBORO,LIMBORO,44,34,6,0,0,0,0,3,0,1,2,2,3,0,3,0,10,7,3,7,9,9,0,2,28,11,17,12,JULI
SULAWESI BARAT,POLEWALI MANDAR,LIMBORO,LEMBANG LEMBANG,71,10,3,1,0,0,0,3,0,0,2,0,4,2,2,1,10,6,4,5,3,3,0,2,7,0,7,4,JULI
SULAWESI BARAT,POLEWALI MANDAR,LIMBORO,TANDASURA,61,68,38,16,10,9,9,28,0,1,17,0,7,4,3,0,60,9,51,1,54,34,20,1,27,26,1,7,JULI
SULAWESI BARAT,POLEWALI MANDAR,LIMBORO,SAMASUNDU,45,39,24,10,7,4,4,11,4,0,18,3,0,0,0,0,29,25,4,4,19,19,0,17,31,3,28,27,JULI
SULAWESI BARAT,POLEWALI MANDAR,LIMBORO,NAPO,61,37,21,5,5,2,1,15,5,0,19,2,9,0,9,0,21,14,7,4,11,5,6,4,1,1,0,1,JULI
SULAWESI BARAT,POLEWALI MANDAR,LIMBORO,TODANG TODANG,48,65,49,42,32,31,8,27,12,0,11,34,1,1,0,1,58,29,29,28,12,4,8,3,12,4,8,0,JULI
SULAWESI BARAT,POLEWALI MANDAR,LIMBORO,PENDULANGAN,62,67,51,32,25,9,3,39,5,1,39,6,10,3,7,1,39,14,25,14,25,11,14,9,49,25,24,25,JULI
SULAWESI BARAT,POLEWALI MANDAR,LIMBORO,RENGGEANG,83,63,59,10,4,2,2,15,15,15,15,25,4,4,0,0,31,14,17,3,2,1,1,1,36,22,14,19,JULI
SULAWESI BARAT,POLEWALI MANDAR,LIMBORO,SALARRI,61,37,36,12,5,4,0,6,21,1,13,2,4,2,2,0,32,29,3,16,26,26,0,10,34,22,12,34,JULI
SULAWESI BARAT,POLEWALI MANDAR,LIMBORO,TANGAN BARU,75,26,8,3,2,2,1,4,3,0,4,4,12,1,11,0,16,5,11,1,7,6,1,5,0,0,0,0,JULI
SULAWESI BARAT,POLEWALI MANDAR,LIMBORO,PALECE,51,71,60,5,5,1,1,52,3,1,9,34,10,0,10,0,14,13,1,10,5,2,3,0,42,31,11,22,JULI
SULAWESI BARAT,POLEWALI MANDAR,LUYO,BATUPANGA,58,64,57,55,13,5,1,25,30,0,46,0,11,3,8,1,58,48,10,43,26,2,24,1,6,5,1,1,JULI
SULAWESI BARAT,POLEWALI MANDAR,LUYO,MAMBU,36,44,12,2,0,0,0,4,5,1,4,6,2,2,0,1,10,8,2,6,3,3,0,3,11,11,0,5,JULI
SULAWESI BARAT,POLEWALI MANDAR,LUYO,TENGGELANG,77,51,10,8,2,1,1,1,5,1,10,0,15,6,9,2,51,47,4,44,50,40,10,12,57,13,44,13,JULI
SULAWESI BARAT,POLEWALI MANDAR,LUYO,BARU,42,49,47,35,32,19,0,12,27,5,38,2,1,1,0,0,45,10,35,2,25,7,18,0,3,1,2,2,JULI
SULAWESI BARAT,POLEWALI MANDAR,LUYO,PUSSUI,96,56,38,16,9,3,2,20,3,4,29,9,9,2,7,0,35,29,6,9,8,2,6,2,17,6,11,4,JULI
SULAWESI BARAT,POLEWALI MANDAR,LUYO,MAPILI BARAT,73,30,7,2,0,0,0,3,2,1,1,6,11,6,5,2,15,11,4,7,13,9,4,8,8,8,0,0,JULI
SULAWESI BARAT,POLEWALI MANDAR,LUYO,SAMBALI WALI,87,66,8,5,3,3,3,0,2,2,0,6,17,14,3,9,17,17,0,11,8,3,5,0,22,16,6,11,JULI
SULAWESI BARAT,POLEWALI MANDAR,LUYO,BATUPANGA DAALA,88,33,0,0,0,0,0,0,0,0,0,0,7,7,0,5,14,9,5,8,12,0,12,0,11,6,5,3,JULI
SULAWESI BARAT,POLEWALI MANDAR,LUYO,LUYO,58,73,7,6,2,1,0,3,2,2,6,0,4,4,0,3,23,8,15,7,7,7,0,6,36,32,4,20,JULI
SULAWESI BARAT,POLEWALI MANDAR,LUYO,PUSSUI BARAT,39,59,47,7,1,1,1,41,4,0,38,6,0,0,0,0,59,16,43,12,58,5,53,1,46,18,28,9,JULI
SULAWESI BARAT,POLEWALI MANDAR,LUYO,PUCCADI,61,52,5,2,1,1,1,3,1,0,5,0,9,4,5,0,25,22,3,19,17,16,1,10,33,26,7,11,JULI
SULAWESI BARAT,POLEWALI MANDAR,MAPILLI,MAPILI,89,75,74,74,32,25,19,6,18,24,32,33,7,5,2,2,18,18,0,6,10,2,8,0,29,6,23,29,JULI
SULAWESI BARAT,POLEWALI MANDAR,MAPILLI,UGIBARU,33,76,70,34,20,16,11,20,37,2,33,36,5,5,0,2,35,27,8,11,16,3,13,1,24,21,3,5,JULI
SULAWESI BARAT,POLEWALI MANDAR,MAPILLI,RUMPA,62,33,11,10,10,7,4,3,1,1,7,2,0,0,0,0,10,6,4,0,0,0,0,0,2,1,1,0,JULI
SULAWESI BARAT,POLEWALI MANDAR,MAPILLI,KURMA,53,15,5,3,0,0,0,2,1,2,5,0,0,0,0,0,15,5,10,4,13,1,12,0,5,2,3,5,JULI
SULAWESI BARAT,POLEWALI MANDAR,MAPILLI,BUKU,81,36,6,4,0,0,0,6,0,0,0,4,11,7,4,2,17,6,11,0,7,5,2,0,6,5,1,3,JULI
SULAWESI BARAT,POLEWALI MANDAR,MAPILLI,BONNE BONNE,38,61,29,22,9,7,0,20,9,0,22,5,3,3,0,3,15,15,0,6,7,5,2,2,9,3,6,2,JULI
SULAWESI BARAT,POLEWALI MANDAR,MAPILLI,BEROANGIN,61,35,9,6,3,0,0,8,1,0,0,8,7,0,7,0,35,33,2,7,26,22,4,20,17,5,12,15,JULI
SULAWESI BARAT,POLEWALI MANDAR,MAPILLI,SEGERANG,54,56,15,1,0,0,0,9,1,1,10,2,5,0,5,0,11,6,5,3,11,6,5,6,29,1,28,20,JULI
SULAWESI BARAT,POLEWALI MANDAR,MAPILLI,BONRA,51,15,13,5,0,0,0,5,6,1,3,8,2,2,0,1,13,10,3,7,5,5,0,0,15,6,9,4,JULI
SULAWESI BARAT,POLEWALI MANDAR,MAPILLI,SATTOKO,90,16,9,8,7,2,2,3,1,3,1,8,4,1,3,0,15,9,6,5,2,2,0,0,7,7,0,0,JULI
SULAWESI BARAT,POLEWALI MANDAR,MAPILLI,RAPPANG BARAT,64,65,40,36,14,7,1,27,6,6,39,1,12,11,1,7,24,24,0,7,24,24,0,5,59,57,2,11,JULI
SULAWESI BARAT,POLEWALI MANDAR,MAPILLI,LANDI KANUSUANG,44,77,46,39,25,5,3,8,12,17,8,21,4,3,1,3,11,6,5,1,2,0,2,0,44,14,30,29,JULI
SULAWESI BARAT,POLEWALI MANDAR,MATAKALI,MATAKALI,38,78,46,18,6,5,4,3,15,8,2,44,4,2,2,1,69,58,11,12,41,36,5,20,93,57,36,24,JULI
SULAWESI BARAT,POLEWALI MANDAR,MATAKALI,PETAMPANUA,52,18,6,6,6,1,0,4,2,0,3,2,6,2,4,1,18,13,5,1,15,8,7,5,3,2,1,0,JULI
SULAWESI BARAT,POLEWALI MANDAR,MATAKALI,BARUMBUNG,41,51,20,7,7,1,0,20,0,0,7,0,7,1,6,0,36,10,26,4,20,16,4,5,14,1,13,7,JULI
SULAWESI BARAT,POLEWALI MANDAR,MATAKALI,PASIANG,36,56,40,14,12,11,2,34,2,2,18,5,6,5,1,1,18,13,5,8,14,11,3,1,31,24,7,20,JULI
SULAWESI BARAT,POLEWALI MANDAR,MATAKALI,TONROLIMA,85,62,61,13,8,0,0,13,41,2,23,19,3,0,3,0,31,10,21,0,15,6,9,4,10,3,7,8,JULI
SULAWESI BARAT,POLEWALI MANDAR,MATAKALI,INDOMAKKOMBONG,60,32,28,23,8,0,0,15,10,1,3,11,9,6,3,2,24,23,1,9,0,0,0,0,8,7,1,4,JULI
SULAWESI BARAT,POLEWALI MANDAR,MATAKALI,BUNGA-BUNGA,75,18,15,10,2,0,0,13,1,1,13,1,2,1,1,0,12,11,1,10,10,2,8,0,8,6,2,3,JULI
SULAWESI BARAT,POLEWALI MANDAR,MATANGNGA,MATANGNGA,87,71,4,4,1,1,0,0,3,1,0,2,5,0,5,0,65,48,17,47,10,8,2,4,7,0,7,5,JULI
SULAWESI BARAT,POLEWALI MANDAR,MATANGNGA,LILLI,92,25,18,12,1,0,0,6,2,3,10,2,10,9,1,0,21,9,12,5,16,1,15,1,4,3,1,2,JULI
SULAWESI BARAT,POLEWALI MANDAR,MATANGNGA,RANGOAN,32,43,26,22,18,18,0,21,5,0,16,4,2,1,1,1,15,15,0,1,4,1,3,1,17,4,13,12,JULI
SULAWESI BARAT,POLEWALI MANDAR,MATANGNGA,TAPUA,55,36,13,10,1,0,0,8,4,0,4,3,3,3,0,3,16,14,2,2,9,5,4,1,4,4,0,3,JULI
SULAWESI BARAT,POLEWALI MANDAR,MATANGNGA,MAMBU TAPUA,89,79,78,49,5,2,1,56,19,2,32,45,14,5,9,3,33,33,0,7,6,6,0,0,9,7,2,1,JULI
SULAWESI BARAT,POLEWALI MANDAR,MATANGNGA,BA'BA TAPUA,45,31,6,4,3,1,1,0,0,0,5,0,8,5,3,4,17,6,11,1,6,2,4,1,11,8,3,9,JULI
SULAWESI BARAT,POLEWALI MANDAR,MATANGNGA,KATIMBANG,100,45,45,18,1,0,0,10,13,0,11,31,14,12,2,6,25,7,18,1,25,7,18,0,36,8,28,35,JULI
SULAWESI BARAT,POLEWALI MANDAR,POLEWALI,POLEWALI,75,39,4,0,0,0,0,3,1,0,4,0,5,3,2,3,21,19,2,10,10,8,2,0,22,17,5,13,JULI
SULAWESI BARAT,POLEWALI MANDAR,POLEWALI,WATTANG,83,11,11,11,1,1,0,8,2,1,5,2,4,0,4,0,11,7,4,7,2,0,2,0,2,0,2,0,JULI
SULAWESI BARAT,POLEWALI MANDAR,POLEWALI,SULEWATANG,91,21,0,0,0,0,0,0,0,0,0,0,5,0,5,0,12,10,2,1,1,1,0,1,14,0,14,8,JULI
SULAWESI BARAT,POLEWALI MANDAR,POLEWALI,LANTORA,41,40,21,4,4,2,1,8,5,1,2,17,3,2,1,2,38,9,29,2,36,4,32,2,0,0,0,0,JULI
SULAWESI BARAT,POLEWALI MANDAR,POLEWALI,TAKATIDUNG,50,37,12,5,2,0,0,0,4,5,8,2,6,5,1,4,34,17,17,13,18,8,10,1,2,0,2,0,JULI
SULAWESI BARAT,POLEWALI MANDAR,POLEWALI,PEKKABATA,38,79,14,3,2,2,2,5,6,1,6,5,6,4,2,3,62,60,2,39,48,30,18,9,34,28,6,30,JULI
SULAWESI BARAT,POLEWALI MANDAR,POLEWALI,MADATE,30,78,68,29,15,2,0,15,46,2,49,13,4,1,3,0,52,12,40,3,17,10,7,9,68,2,66,37,JULI
SULAWESI BARAT,POLEWALI MANDAR,POLEWALI,MANDING,55,63,31,5,2,2,2,3,2,10,18,13,3,1,2,1,32,12,20,2,25,23,2,16,28,7,21,4,JULI
SULAWESI BARAT,POLEWALI MANDAR,POLEWALI,DARMA,74,37,19,2,0,0,0,19,0,0,9,4,4,1,3,0,25,25,0,1,14,10,4,0,32,27,5,26,JULI
SULAWESI BARAT,POLEWALI MANDAR,TAPANGO,PELITAKAN,83,46,13,0,0,0,0,0,7,0,10,1,14,12,2,3,41,33,8,33,39,8,31,5,68,26,42,46,JULI
SULAWESI BARAT,POLEWALI MANDAR,TAPANGO,TAPANGO,63,28,15,15,8,8,3,12,0,0,5,0,2,1,1,1,26,8,18,2,19,11,8,8,34,34,0,21,JULI
SULAWESI BARAT,POLEWALI MANDAR,TAPANGO,RAPPANG,92,50,28,16,5,5,2,10,11,2,15,10,17,13,4,8,14,11,3,6,14,8,6,2,21,11,10,21,JULI
SULAWESI BARAT,POLEWALI MANDAR,TAPANGO,DAKKA,73,37,20,12,4,4,0,19,1,0,3,12,7,3,4,1,23,19,4,5,3,2,1,1,7,2,5,4,JULI
SULAWESI BARAT,POLEWALI MANDAR,TAPANGO,BATU,50,43,13,2,0,0,0,11,1,1,3,6,8,3,5,1,40,37,3,7,19,17,2,2,37,9,28,21,JULI
SULAWESI BARAT,POLEWALI MANDAR,TAPANGO,RISO,39,63,22,10,4,0,0,1,10,4,7,9,3,0,3,0,44,6,38,1,32,26,6,26,52,21,31,9,JULI
SULAWESI BARAT,POLEWALI MANDAR,TAPANGO,PALATTA,63,26,11,6,5,0,0,0,9,0,9,2,9,8,1,3,25,17,8,14,15,14,1,7,14,8,6,0,JULI
SULAWESI BARAT,POLEWALI MANDAR,TAPANGO,TAPANGO BARAT,62,31,21,3,1,0,0,14,7,0,8,4,4,4,0,0,26,5,21,1,17,3,14,3,37,3,34,19,JULI
SULAWESI BARAT,POLEWALI MANDAR,TAPANGO,KURRAK,69,36,31,30,17,17,6,18,3,1,18,12,2,2,0,2,18,8,10,5,18,14,4,10,8,1,7,5,JULI
SULAWESI BARAT,POLEWALI MANDAR,TAPANGO,BUSSU,86,53,24,13,1,1,1,21,2,0,5,4,15,3,12,0,48,35,13,4,22,19,3,6,24,5,19,18,JULI
SULAWESI BARAT,POLEWALI MANDAR,TAPANGO,TUTTULA,57,40,14,14,7,6,0,12,2,0,11,3,1,0,1,0,10,10,0,1,3,2,1,2,19,13,6,13,JULI
SULAWESI BARAT,POLEWALI MANDAR,TAPANGO,JAMBU MALEA,80,19,19,19,13,3,2,6,7,0,9,8,16,10,6,8,17,17,0,17,0,0,0,0,7,2,5,4,JULI
SULAWESI BARAT,POLEWALI MANDAR,TAPANGO,KALIMBUA,38,28,2,1,1,0,0,1,0,0,1,0,7,1,6,1,10,10,0,3,8,8,0,0,10,0,10,2,JULI
SULAWESI BARAT,POLEWALI MANDAR,TAPANGO,BANATO REJO,73,16,3,0,0,0,0,3,0,0,3,0,1,0,1,0,13,12,1,7,0,0,0,0,3,0,3,0,JULI
SULAWESI BARAT,POLEWALI MANDAR,TINAMBUNG,TINAMBUNG,40,77,61,27,3,1,1,16,43,0,40,13,8,2,6,0,42,19,23,3,25,15,10,3,25,9,16,7,JULI
SULAWESI BARAT,POLEWALI MANDAR,TINAMBUNG,KARAMA,98,40,21,4,0,0,0,20,1,0,10,8,12,4,8,1,16,7,9,6,15,3,12,3,7,7,0,4,JULI
SULAWESI BARAT,POLEWALI MANDAR,TINAMBUNG,TANGNGA TANGNGA,38,42,24,23,3,0,0,0,8,10,17,7,5,3,2,0,13,6,7,1,12,5,7,1,40,0,40,15,JULI
SULAWESI BARAT,POLEWALI MANDAR,TINAMBUNG,LEKOPADIS,46,35,25,18,7,3,3,15,2,1,9,10,0,0,0,0,22,10,12,2,4,1,3,1,17,2,15,14,JULI
SULAWESI BARAT,POLEWALI MANDAR,TINAMBUNG,GALUNG LOMBOK,53,17,14,3,0,0,0,9,4,1,0,2,7,2,5,0,16,8,8,4,9,2,7,2,8,6,2,7,JULI
SULAWESI BARAT,POLEWALI MANDAR,TINAMBUNG,TANDUNG,86,28,9,1,1,1,0,3,1,4,5,2,7,6,1,5,27,12,15,1,0,0,0,0,5,0,5,5,JULI
SULAWESI BARAT,POLEWALI MANDAR,TINAMBUNG,BATULAYA,70,74,7,2,0,0,0,6,0,0,6,1,0,0,0,0,30,26,4,25,28,10,18,8,36,12,24,20,JULI
SULAWESI BARAT,POLEWALI MANDAR,TINAMBUNG,SEPABATU,88,78,72,70,42,4,3,65,0,1,6,47,9,4,5,1,32,7,25,1,28,24,4,8,74,15,59,37,JULI
SULAWESI BARAT,POLEWALI MANDAR,TUTAR,TARAMANU,32,80,24,19,14,13,10,2,5,5,23,0,5,5,0,1,68,18,50,4,63,57,6,48,73,27,46,14,JULI
SULAWESI BARAT,POLEWALI MANDAR,TUTAR,AMBOPADANG,99,74,12,4,2,1,0,7,1,2,7,5,4,0,4,0,59,10,49,4,28,19,9,18,37,10,27,24,JULI
SULAWESI BARAT,POLEWALI MANDAR,TUTAR,TUBBI,49,72,13,1,1,1,1,9,3,0,2,11,6,1,5,0,13,7,6,5,11,1,10,0,22,8,14,6,JULI
SULAWESI BARAT,POLEWALI MANDAR,TUTAR,RATTE,75,13,13,12,5,4,4,1,4,1,13,0,3,2,1,2,12,9,3,3,6,0,6,0,15,4,11,8,JULI
SULAWESI BARAT,POLEWALI MANDAR,TUTAR,BESOANGIN,93,49,8,8,1,1,0,5,2,1,8,0,5,5,0,2,39,17,22,7,6,4,2,1,9,7,2,8,JULI
SULAWESI BARAT,POLEWALI MANDAR,TUTAR,PIRIANG TAPIKO,54,36,12,2,1,0,0,3,2,3,1,0,6,6,0,3,32,18,14,9,31,1,30,1,29,9,20,3,JULI
SULAWESI BARAT,POLEWALI MANDAR,TUTAR,PEBURRU,67,40,8,4,3,0,0,2,2,1,7,0,9,0,9,0,39,36,3,29,35,28,7,2,39,20,19,27,JULI
SULAWESI BARAT,POLEWALI MANDAR,TUTAR,TALOBA,39,26,10,4,0,0,0,7,0,3,1,6,4,2,2,0,19,11,8,7,14,1,13,0,4,4,0,1,JULI
SULAWESI BARAT,POLEWALI MANDAR,TUTAR,POLLEWANI,39,10,8,0,0,0,0,3,2,1,2,6,5,5,0,0,10,5,5,2,7,5,2,0,12,0,12,6,JULI
SULAWESI BARAT,POLEWALI MANDAR,TUTAR,ARABUA,92,34,27,11,4,2,0,16,1,3,7,0,15,13,2,5,13,13,0,13,13,12,1,2,27,13,14,17,JULI
SULAWESI BARAT,POLEWALI MANDAR,TUTAR,BESOANGIN UTARA,97,48,31,23,0,0,0,14,17,0,26,0,2,0,2,0,38,17,21,3,18,5,13,5,22,11,11,0,JULI
SULAWESI BARAT,POLEWALI MANDAR,TUTAR,PODA,30,76,36,22,1,0,0,14,3,12,2,23,2,1,1,0,51,37,14,7,36,17,19,17,52,6,46,4,JULI
SULAWESI BARAT,POLEWALI MANDAR,TUTAR,TARAMANU TUA,50,18,6,5,3,0,0,3,1,2,6,0,0,0,0,0,15,8,7,6,4,3,1,0,1,1,0,1,JULI
SULAWESI BARAT,POLEWALI MANDAR,WONOMULYO,SIDODADI,47,40,21,11,3,0,0,19,2,0,9,6,8,3,5,1,22,17,5,6,2,2,0,0,24,15,9,8,JULI
SULAWESI BARAT,POLEWALI MANDAR,WONOMULYO,SIDOREJO,33,55,27,25,6,6,3,9,5,6,5,20,4,0,4,0,46,34,12,23,40,33,7,30,27,24,3,23,JULI
SULAWESI BARAT,POLEWALI MANDAR,WONOMULYO,SUMBEREJO,90,38,27,5,3,0,0,1,0,8,20,6,13,1,12,1,26,23,3,12,0,0,0,0,20,10,10,11,JULI
SULAWESI BARAT,POLEWALI MANDAR,WONOMULYO,BUMIAYU,80,22,19,19,8,6,0,16,3,0,1,2,3,2,1,1,18,18,0,3,16,7,9,7,9,8,1,4,JULI
SULAWESI BARAT,POLEWALI MANDAR,WONOMULYO,KEBUNSARI,33,22,17,2,0,0,0,9,1,2,7,6,0,0,0,0,13,13,0,4,2,2,0,2,1,0,1,0,JULI
SULAWESI BARAT,POLEWALI MANDAR,WONOMULYO,BANUA BARU,73,58,56,8,7,3,0,18,18,15,15,19,5,4,1,0,43,15,28,1,33,12,21,7,8,2,6,7,JULI
SULAWESI BARAT,POLEWALI MANDAR,WONOMULYO,NEPO,54,28,1,0,0,0,0,1,0,0,1,0,1,1,0,0,11,8,3,1,10,8,2,6,12,5,7,9,JULI
SULAWESI BARAT,POLEWALI MANDAR,WONOMULYO,SUGIHWARAS,41,12,10,10,4,3,2,3,4,0,5,1,8,4,4,1,10,7,3,3,6,4,2,4,0,0,0,0,JULI
SULAWESI BARAT,POLEWALI MANDAR,WONOMULYO,CAMPURJO,79,19,0,0,0,0,0,0,0,0,0,0,3,1,2,1,13,5,8,5,3,0,3,0,3,1,2,0,JULI
SULAWESI BARAT,POLEWALI MANDAR,WONOMULYO,BUMIMULYO,74,18,17,7,2,2,2,9,3,1,3,6,7,3,4,1,15,6,9,5,0,0,0,0,3,1,2,3,JULI
SULAWESI BARAT,POLEWALI MANDAR,WONOMULYO,TUMPILING,67,70,49,30,20,4,1,16,5,24,16,14,1,1,0,1,32,21,11,2,6,6,0,1,54,34,20,52,JULI
SULAWESI BARAT,POLEWALI MANDAR,WONOMULYO,BAKKA-BAKKA,54,11,2,0,0,0,0,1,1,0,1,1,10,4,6,3,10,8,2,0,5,4,1,3,0,0,0,0,JULI
SULAWESI BARAT,POLEWALI MANDAR,WONOMULYO,ARJO SARI,59,77,23,15,12,11,7,16,0,0,0,17,0,0,0,0,26,10,16,4,26,0,26,0,12,6,6,6,JULI
SULAWESI BARAT,POLEWALI MANDAR,WONOMULYO,GALESON,49,50,33,9,4,2,2,8,22,1,27,2,8,6,2,0,44,13,31,4,28,8,20,6,60,35,25,26,JULI
SULAWESI BARAT,MAMUJU,MAMUJU,BINANGA,68,20,10,9,8,3,0,7,3,0,7,0,7,0,7,0,18,18,0,2,16,7,9,0,13,4,9,1,JULI
SULAWESI BARAT,MAMUJU,MAMUJU,MAMUNYU,53,69,8,7,3,3,2,2,0,2,3,4,3,1,2,0,56,39,17,23,5,4,1,3,31,5,26,13,JULI
SULAWESI BARAT,MAMUJU,MAMUJU,KAREMA,71,72,24,10,6,0,0,9,15,0,15,8,8,4,4,1,53,47,6,4,6,6,0,5,20,1,19,4,JULI
SULAWESI BARAT,MAMUJU,MAMUJU,RIMUKU,50,39,33,25,13,4,4,29,0,0,25,3,10,10,0,2,20,14,6,13,4,0,4,0,22,16,6,5,JULI
SULAWESI BARAT,MAMUJU,MAMUJU,BAMBU,100,54,5,4,0,0,0,2,0,2,3,0,6,1,5,0,15,5,10,0,2,1,1,0,11,0,11,10,JULI
SULAWESI BARAT,MAMUJU,MAMUJU,KARAMPUANG,44,48,8,0,0,0,0,1,4,1,3,1,5,0,5,0,44,43,1,15,13,12,1,12,16,10,6,13,JULI
SULAWESI BARAT,MAMUJU,MAMUJU,TADUI,30,66,56,16,16,9,7,18,23,3,3,8,0,0,0,0,41,18,23,10,32,17,15,7,3,1,2,3,JULI
SULAWESI BARAT,MAMUJU,MAMUJU,BATU PANNU,62,76,28,2,2,0,0,28,0,0,13,1,11,5,6,5,20,13,7,6,4,1,3,0,11,9,2,2,JULI
SULAWESI BARAT,MAMUJU,TAPALANG,GALUNG,99,69,12,4,3,3,2,1,7,1,0,10,11,6,5,1,55,11,44,5,2,0,2,0,25,1,24,1,JULI
SULAWESI BARAT,MAMUJU,TAPALANG,KASAMBANG,74,13,12,5,3,0,0,3,5,3,7,5,13,2,11,1,10,7,3,5,9,5,4,2,15,10,5,4,JULI
SULAWESI BARAT,MAMUJU,TAPALANG,DAYANGINNA,98,47,37,19,4,1,1,26,7,2,10,26,9,8,1,8,16,8,8,0,16,7,9,0,31,5,26,23,JULI
SULAWESI BARAT,MAMUJU,TAPALANG,OROBATU,74,45,42,36,26,19,19,18,3,0,27,13,7,0,7,0,42,39,3,1,22,2,20,2,51,8,43,29,JULI
SULAWESI BARAT,MAMUJU,TAPALANG,TAKANDEANG,78,75,63,63,1,0,0,39,8,10,53,4,6,1,5,1,68,11,57,9,4,1,3,0,44,20,24,18,JULI
SULAWESI BARAT,MAMUJU,TAPALANG,BELA,45,54,17,15,1,0,0,13,0,1,1,6,1,0,1,0,29,12,17,4,24,6,18,0,28,15,13,18,JULI
SULAWESI BARAT,MAMUJU,TAPALANG,TAAN,48,74,44,0,0,0,0,5,1,34,15,1,8,3,5,3,24,5,19,5,2,2,0,1,14,7,7,5,JULI
SULAWESI BARAT,MAMUJU,TAPALANG,TAMPALANG,93,56,34,28,2,0,0,10,11,7,6,21,4,4,0,3,56,25,31,5,7,5,2,1,32,4,28,17,JULI
SULAWESI BARAT,MAMUJU,TAPALANG,RANTEDODA,56,77,37,5,5,0,0,15,14,0,11,10,3,1,2,1,26,18,8,1,24,1,23,0,58,14,44,9,JULI
SULAWESI BARAT,MAMUJU,TAPALANG,KOPEANG,88,35,4,1,1,0,0,2,2,0,2,1,5,2,3,1,27,21,6,7,25,4,21,1,27,11,16,2,JULI
SULAWESI BARAT,MAMUJU,KALUKKU,SINYONYOI,92,11,11,11,7,7,7,0,3,0,8,3,6,6,0,5,10,9,1,7,6,2,4,1,8,0,8,1,JULI
SULAWESI BARAT,MAMUJU,KALUKKU,BEBANGA,40,73,7,7,5,4,2,5,0,0,6,1,1,0,1,0,48,13,35,0,18,12,6,8,51,36,15,30,JULI
SULAWESI BARAT,MAMUJU,KALUKKU,KALUKKU,53,18,11,5,1,0,0,4,2,3,3,5,2,1,1,0,18,10,8,0,15,0,15,0,0,0,0,0,JULI
SULAWESI BARAT,MAMUJU,KALUKKU,SINYONYOI SELATAN,60,77,60,6,6,1,0,57,1,2,30,24,1,1,0,1,43,19,24,7,29,1,28,1,55,47,8,26,JULI
SULAWESI BARAT,MAMUJU,KALUKKU,SONDOANG,55,68,38,14,0,0,0,22,6,10,32,3,0,0,0,0,58,27,31,18,53,19,34,19,46,36,10,42,JULI
SULAWESI BARAT,MAMUJU,KALUKKU,BERU-BERU,95,56,16,14,3,3,2,8,5,1,8,4,19,4,15,3,28,12,16,11,27,2,25,2,21,19,2,14,JULI
SULAWESI BARAT,MAMUJU,KALUKKU,BELANG BELANG,41,36,5,5,5,4,0,2,1,0,2,3,6,3,3,1,23,23,0,8,1,1,0,1,17,0,17,3,JULI
SULAWESI BARAT,MAMUJU,KALUKKU,KABULOANG,33,41,30,9,2,2,2,2,0,15,23,3,1,0,1,0,40,34,6,10,22,20,2,17,19,8,11,11,JULI
SULAWESI BARAT,MAMUJU,KALUKKU,KEANG,79,46,11,0,0,0,0,6,2,0,7,1,0,0,0,0,34,20,14,0,6,0,6,0,23,3,20,7,JULI
SULAWESI BARAT,MAMUJU,KALUKKU,POKKANG,59,80,29,17,4,1,1,10,8,0,2,14,6,3,3,1,35,35,0,16,26,17,9,0,68,12,56,3,JULI
SULAWESI BARAT,MAMUJU,KALUKKU,GULILING,86,79,71,63,13,10,10,60,0,1,47,15,10,7,3,7,38,9,29,2,2,2,0,2,7,7,0,1,JULI
SULAWESI BARAT,MAMUJU,KALUKKU,UHAIMATE,82,45,1,1,1,0,0,1,0,0,0,1,10,8,2,2,20,6,14,1,0,0,0,0,2,0,2,2,JULI
SULAWESI BARAT,MAMUJU,KALUKKU,KALUKKU BARAT,94,52,49,48,30,7,7,17,22,1,46,2,13,12,1,11,16,8,8,2,14,11,3,3,36,9,27,23,JULI
SULAWESI BARAT,MAMUJU,KALUKKU,PAMMULUKANG,68,28,10,9,2,1,1,1,8,0,1,3,6,6,0,6,10,6,4,4,0,0,0,0,2,2,0,2,JULI
SULAWESI BARAT,MAMUJU,KALUMPANG,KALUMPANG,47,71,48,47,45,17,17,28,1,0,45,0,9,7,2,6,12,8,4,3,1,0,1,0,39,31,8,26,JULI
SULAWESI BARAT,MAMUJU,KALUMPANG,KARATAUN,32,10,4,0,0,0,0,2,2,0,2,1,0,0,0,0,10,9,1,8,5,2,3,1,3,2,1,0,JULI
SULAWESI BARAT,MAMUJU,KALUMPANG,KARAMA,69,68,57,35,19,18,3,42,11,1,27,8,11,4,7,4,54,8,46,0,16,16,0,4,51,42,9,22,JULI
SULAWESI BARAT,MAMUJU,KALUMPANG,SIRAUN,92,27,26,1,1,0,0,14,1,7,8,8,13,10,3,2,23,11,12,4,10,3,7,3,10,6,4,5,JULI
SULAWESI BARAT,MAMUJU,KALUMPANG,TUMOGA,78,24,21,8,8,5,2,12,2,4,9,4,15,2,13,2,22,17,5,17,16,5,11,4,14,5,9,7,JULI
SULAWESI BARAT,MAMUJU,KALUMPANG,SALUMAKKI,95,49,17,7,6,3,2,7,6,1,0,4,4,3,1,0,12,6,6,4,3,2,1,0,36,6,30,15,JULI
SULAWESI BARAT,MAMUJU,KALUMPANG,POLIO,95,41,7,5,3,2,0,0,7,0,3,0,16,6,10,5,33,13,20,3,10,5,5,5,11,7,4,4,JULI
SULAWESI BARAT,MAMUJU,KALUMPANG,LIMBONG,36,36,18,15,6,4,3,12,0,1,1,14,2,1,1,0,25,21,4,18,3,1,2,0,12,2,10,9,JULI
SULAWESI BARAT,MAMUJU,KALUMPANG,SANDAPANG,39,34,19,6,6,5,3,7,4,4,3,1,5,2,3,2,16,9,7,5,7,7,0,5,13,3,10,7,JULI
SULAWESI BARAT,MAMUJU,KALUMPANG,KONDO BULO,39,47,16,8,0,0,0,5,7,3,0,8,0,0,0,0,21,17,4,0,9,3,6,2,31,13,18,22,JULI
SULAWESI BARAT,MAMUJU,KALUMPANG,MAKKALIKI,77,17,17,10,5,0,0,3,8,0,2,14,11,1,10,0,15,5,10,5,3,0,3,0,7,3,4,1,JULI
SULAWESI BARAT,MAMUJU,KALUMPANG,BATU MAKKADA,68,42,3,1,0,0,0,1,2,0,1,2,12,1,11,0,28,23,5,0,14,5,9,4,24,14,10,3,JULI
SULAWESI BARAT,MAMUJU,KALUMPANG,LASA',49,57,14,3,2,0,0,9,2,0,5,2,4,3,1,1,49,32,17,2,5,2,3,1,19,12,7,1,JULI
SULAWESI BARAT,MAMUJU,PAPALANG,TOABO,71,66,58,42,36,25,10,17,1,19,18,8,4,0,4,0,20,17,3,13,5,0,5,0,20,14,6,18,JULI
SULAWESI BARAT,MAMUJU,PAPALANG,PAPALANG,66,27,14,6,0,0,0,7,7,0,3,10,12,9,3,6,14,7,7,3,7,5,2,2,13,10,3,5,JULI
SULAWESI BARAT,MAMUJU,PAPALANG,BONDA,78,21,20,4,0,0,0,1,11,0,17,2,1,0,1,0,19,13,6,11,7,3,4,2,9,6,3,1,JULI
SULAWESI BARAT,MAMUJU,PAPALANG,TOPORE,70,58,4,4,1,1,1,2,0,0,4,0,1,0,1,0,12,12,0,1,4,0,4,0,10,8,2,10,JULI
SULAWESI BARAT,MAMUJU,PAPALANG,SALUKAYU,97,21,3,3,0,0,0,2,1,0,0,0,15,8,7,8,13,13,0,5,0,0,0,0,10,6,4,10,JULI
SULAWESI BARAT,MAMUJU,PAPALANG,SUKADAMAI,81,79,20,11,9,5,5,11,0,3,12,6,16,13,3,3,69,60,9,34,66,20,46,16,29,24,5,13,JULI
SULAWESI BARAT,MAMUJU,PAPALANG,BODA-BODA,71,38,8,2,0,0,0,8,0,0,1,1,4,0,4,0,33,31,2,7,2,0,2,0,11,10,1,10,JULI
SULAWESI BARAT,MAMUJU,PAPALANG,SISANGO,70,66,5,0,0,0,0,5,0,0,4,1,12,5,7,2,46,28,18,14,42,5,37,2,71,31,40,7,JULI
SULAWESI BARAT,MAMUJU,PAPALANG,BATU AMPA,58,73,6,0,0,0,0,4,0,1,5,0,8,8,0,1,72,71,1,7,24,18,6,0,11,1,10,11,JULI
SULAWESI BARAT,MAMUJU,SAMPAGA,BUNDE,37,17,17,10,2,1,0,5,6,4,8,8,4,0,4,0,14,13,1,8,7,7,0,0,7,3,4,3,JULI
SULAWESI BARAT,MAMUJU,SAMPAGA,KALONDING,82,21,12,5,2,2,2,10,0,0,8,1,7,4,3,4,15,6,9,2,1,1,0,0,2,0,2,0,JULI
SULAWESI BARAT,MAMUJU,SAMPAGA,TARAILU,50,31,1,1,1,0,0,1,0,0,0,1,3,1,2,1,10,10,0,2,0,0,0,0,7,2,5,6,JULI
SULAWESI BARAT,MAMUJU,SAMPAGA,SAMPAGA,35,41,14,10,5,2,1,9,1,2,2,5,5,1,4,0,31,19,12,8,14,4,10,2,39,2,37,30,JULI
SULAWESI BARAT,MAMUJU,SAMPAGA,TANAMBUAH,55,73,33,2,1,1,1,2,27,2,22,10,0,0,0,0,40,24,16,2,23,5,18,4,43,13,30,40,JULI
SULAWESI BARAT,MAMUJU,SAMPAGA,SALUBARANA,88,24,8,3,3,0,0,3,5,0,8,0,9,1,8,0,20,14,6,10,1,0,1,0,7,3,4,7,JULI
SULAWESI BARAT,MAMUJU,SAMPAGA,LOSSO,73,21,15,13,12,10,0,6,8,0,5,3,0,0,0,0,12,10,2,9,8,1,7,1,1,0,1,1,JULI
SULAWESI BARAT,MAMUJU,TOMMO,TOMMO,85,53,12,6,0,0,0,4,6,2,9,2,1,0,1,0,46,19,27,15,4,4,0,0,1,0,1,1,JULI
SULAWESI BARAT,MAMUJU,TOMMO,CAMPALOGA,33,64,23,13,2,2,1,21,1,0,18,4,2,2,0,0,18,13,5,7,15,8,7,2,16,12,4,2,JULI
SULAWESI BARAT,MAMUJU,TOMMO,BUANA SAKTI,83,11,4,0,0,0,0,3,0,0,4,0,5,2,3,0,11,9,2,7,5,3,2,2,7,4,3,1,JULI
SULAWESI BARAT,MAMUJU,TOMMO,TAMEMONGGA,70,70,24,23,18,9,3,13,6,1,15,7,14,13,1,5,18,16,2,10,3,3,0,2,25,10,15,2,JULI
SULAWESI BARAT,MAMUJU,TOMMO,TAMEJARRA,43,71,49,24,15,13,1,46,0,0,38,7,2,2,0,1,24,21,3,18,23,0,23,0,33,14,19,28,JULI
SULAWESI BARAT,MAMUJU,TOMMO,RANTEMARIO,68,24,16,13,13,10,1,14,1,0,9,1,4,1,3,1,18,16,2,0,5,5,0,1,15,14,1,0,JULI
SULAWESI BARAT,MAMUJU,TOMMO,MALINO,71,46,3,0,0,0,0,3,0,0,0,2,9,3,6,2,26,20,6,18,8,5,3,3,2,1,1,2,JULI
SULAWESI BARAT,MAMUJU,TOMMO,KAKULLASANG,66,19,9,0,0,0,0,1,6,1,1,2,2,0,2,0,15,9,6,4,10,9,1,4,0,0,0,0,JULI
SULAWESI BARAT,MAMUJU,TOMMO,LELING,32,42,3,3,0,0,0,3,0,0,1,2,2,1,1,1,41,37,4,23,0,0,0,0,6,3,3,1,JULI
SULAWESI BARAT,MAMUJU,TOMMO,KALEPU,76,56,38,34,5,2,2,33,0,1,23,7,5,5,0,5,25,15,10,2,15,14,1,4,26,14,12,19,JULI
SULAWESI BARAT,MAMUJU,TOMMO,SANDANA,69,30,13,13,2,1,1,5,4,0,4,8,5,4,1,0,24,9,15,1,17,4,13,0,30,26,4,8,JULI
SULAWESI BARAT,MAMUJU,TOMMO,LELING BARAT,66,78,55,8,4,3,3,0,20,26,5,27,3,1,2,1,20,18,2,14,5,5,0,1,2,0,2,1,JULI
SULAWESI BARAT,MAMUJU,TOMMO,LELING UTARA,66,51,15,8,0,0,0,2,10,2,10,2,6,6,0,4,25,13,12,4,9,0,9,0,19,16,3,10,JULI
SULAWESI BARAT,MAMUJU,TOMMO,SALUDENGEN,71,15,1,0,0,0,0,0,0,0,0,1,10,10,0,1,13,6,7,4,10,1,9,1,8,3,5,3,JULI
SULAWESI BARAT,MAMUJU,SIMBORO DAN KEPULAUAN,SIMBORO,41,36,25,16,11,8,0,5,16,3,4,6,2,1,1,1,31,27,4,12,21,6,15,4,21,7,14,12,JULI
SULAWESI BARAT,MAMUJU,SIMBORO DAN KEPULAUAN,RANGAS,74,12,6,3,1,0,0,5,1,0,1,0,1,1,0,1,11,11,0,0,5,5,0,0,10,6,4,4,JULI
SULAWESI BARAT,MAMUJU,SIMBORO DAN KEPULAUAN,BOTTENG,52,28,20,6,1,0,0,3,10,2,20,0,6,1,5,1,26,12,14,4,5,5,0,1,7,3,4,2,JULI
SULAWESI BARAT,MAMUJU,SIMBORO DAN KEPULAUAN,SALETTO,53,68,34,6,5,2,1,1,19,13,14,9,8,0,8,0,33,31,2,5,32,12,20,7,51,44,7,19,JULI
SULAWESI BARAT,MAMUJU,SIMBORO DAN KEPULAUAN,SUMARE,39,72,0,0,0,0,0,0,0,0,0,0,6,0,6,0,40,6,34,3,3,1,2,0,53,17,36,46,JULI
SULAWESI BARAT,MAMUJU,SIMBORO DAN KEPULAUAN,BOTTENG UTARA,62,62,18,9,4,0,0,9,0,5,15,0,5,0,5,0,20,19,1,0,3,2,1,2,29,10,19,0,JULI
SULAWESI BARAT,MAMUJU,SIMBORO DAN KEPULAUAN,TAPANDULLU,64,59,55,19,6,0,0,20,30,3,8,18,10,1,9,1,59,44,15,32,58,46,12,2,90,22,68,79,JULI
SULAWESI BARAT,MAMUJU,SIMBORO DAN KEPULAUAN,PATI'DI,80,54,15,11,7,2,2,6,7,0,6,8,2,2,0,0,27,18,9,1,19,12,7,12,43,34,9,43,JULI
SULAWESI BARAT,MAMUJU,TAPALANG BARAT,DUNGKAIT,50,11,8,7,0,0,0,5,2,1,2,0,3,3,0,3,11,10,1,1,6,5,1,2,7,2,5,6,JULI
SULAWESI BARAT,MAMUJU,TAPALANG BARAT,LEBANI,98,37,14,11,5,5,2,4,5,0,5,3,11,9,2,7,33,24,9,21,7,5,2,0,8,3,5,5,JULI
SULAWESI BARAT,MAMUJU,TAPALANG BARAT,LABUANG RANO,37,27,13,4,3,2,0,9,3,1,8,4,2,2,0,0,27,10,17,3,18,8,10,2,32,6,26,3,JULI
SULAWESI BARAT,MAMUJU,TAPALANG BARAT,PASABU,54,10,9,4,2,2,0,9,0,0,2,1,4,3,1,3,10,9,1,5,10,7,3,5,9,1,8,3,JULI
SULAWESI BARAT,MAMUJU,TAPALANG BARAT,TANETE PAO,66,25,19,7,2,1,1,14,1,0,17,1,1,1,0,0,24,8,16,4,4,1,3,0,14,9,5,13,JULI
SULAWESI BARAT,MAMUJU,TAPALANG BARAT,PANGASAAN,87,42,8,3,2,2,0,6,2,0,1,7,10,7,3,2,19,16,3,7,5,4,1,1,27,16,11,12,JULI
SULAWESI BARAT,MAMUJU,TAPALANG BARAT,AHU,40,62,13,3,0,0,0,1,7,1,12,0,0,0,0,0,41,12,29,9,10,9,1,0,32,19,13,22,JULI
SULAWESI BARAT,MAMUJU,BONEHAU,BONEHAU,83,51,28,21,15,0,0,15,13,0,17,8,0,0,0,0,33,6,27,1,15,15,0,3,33,25,8,1,JULI
SULAWESI BARAT,MAMUJU,BONEHAU,SALUTIWO,31,34,10,5,0,0,0,7,3,0,9,1,6,5,1,4,25,9,16,9,23,17,6,1,33,0,33,32,JULI
SULAWESI BARAT,MAMUJU,BONEHAU,BUTTUADA,82,12,8,7,2,1,0,3,2,0,0,4,8,8,0,1,10,5,5,2,1,1,0,0,7,6,1,6,JULI
SULAWESI BARAT,MAMUJU,BONEHAU,TAMALEA,46,58,26,21,13,8,5,6,6,5,0,19,1,1,0,1,30,20,10,15,9,9,0,0,25,10,15,22,JULI
SULAWESI BARAT,MAMUJU,BONEHAU,LUMIKA,37,60,30,9,0,0,0,23,7,0,10,19,4,4,0,4,10,5,5,1,10,6,4,5,8,1,7,2,JULI
SULAWESI BARAT,MAMUJU,BONEHAU,MAPPU,60,24,24,21,2,1,1,11,2,1,18,6,9,4,5,1,13,12,1,5,4,2,2,1,18,1,17,15,JULI
SULAWESI BARAT,MAMUJU,BONEHAU,BANUADA,42,54,18,6,4,2,1,8,3,5,11,0,8,2,6,2,38,29,9,12,0,0,0,0,2,1,1,1,JULI
SULAWESI BARAT,MAMUJU,BONEHAU,HINUA,54,54,28,21,4,0,0,23,1,4,3,4,1,1,0,1,52,6,46,0,9,2,7,0,39,26,13,32,JULI
SULAWESI BARAT,MAMUJU,BONEHAU,KINATANG,39,39,20,17,0,0,0,20,0,0,17,0,0,0,0,0,29,9,20,7,3,3,0,3,9,6,3,2,JULI
SULAWESI BARAT,MAMUJU,KEP. BALA BALAKANG,BALA BALAKANG,99,64,30,10,6,3,2,1,11,8,6,19,1,0,1,0,15,15,0,2,14,13,1,11,54,20,34,29,JULI
SULAWESI BARAT,MAMUJU,KEP. BALA BALAKANG,BALA-BALAKANG TIMUR,68,29,14,14,13,4,1,12,0,1,0,0,1,0,1,0,11,6,5,4,0,0,0,0,6,4,2,5,JULI
SULAWESI BARAT,MAMUJU TENGAH,TOBADAK,MAHAHE,66,34,34,2,0,0,0,31,3,0,9,8,9,2,7,1,23,17,6,0,20,17,3,12,35,5,30,20,AGUSTUS
SULAWESI BARAT,MAMUJU TENGAH,TOBADAK,SALOBAJA,62,11,7,7,2,0,0,3,3,0,4,0,12,8,4,5,10,9,1,9,4,1,3,1,6,1,5,4,AGUSTUS
SULAWESI BARAT,MAMUJU TENGAH,TOBADAK,TOBADAK,78,53,33,18,10,5,3,9,11,3,26,3,9,5,4,2,37,34,3,26,27,2,25,2,58,9,49,40,AGUSTUS
SULAWESI BARAT,MAMUJU TENGAH,TOBADAK,PALONGAAN,46,53,47,23,7,5,0,47,0,0,45,1,4,0,4,0,10,6,4,5,6,0,6,0,37,14,23,20,AGUSTUS
SULAWESI BARAT,MAMUJU TENGAH,TOBADAK,BATU PARIGI,78,54,26,24,19,19,11,10,2,1,13,11,0,0,0,0,46,38,8,7,36,19,17,4,54,27,27,48,AGUSTUS
SULAWESI BARAT,MAMUJU TENGAH,TOBADAK,BAMBADARU,83,62,39,10,1,1,0,8,14,15,14,1,4,0,4,0,16,12,4,3,3,3,0,0,24,1,23,17,AGUSTUS
SULAWESI BARAT,MAMUJU TENGAH,TOBADAK,SEJATI,51,38,17,17,9,7,7,3,0,6,16,0,10,4,6,2,30,16,14,9,15,7,8,3,39,4,35,35,AGUSTUS
SULAWESI BARAT,MAMUJU TENGAH,TOBADAK,SALOADAK,96,16,1,0,0,0,0,1,0,0,0,1,13,10,3,10,11,8,3,7,9,5,4,2,4,0,4,3,AGUSTUS
SULAWESI BARAT,MAMUJU TENGAH,PANGALE,POLO PANGALE,93,22,9,4,4,3,3,5,1,0,9,0,13,2,11,1,20,10,10,0,9,4,5,2,8,2,6,8,AGUSTUS
SULAWESI BARAT,MAMUJU TENGAH,PANGALE,PANGALE,98,56,24,9,4,3,1,19,4,0,4,4,7,1,6,1,26,21,5,5,14,14,0,5,18,13,5,1,AGUSTUS
SULAWESI BARAT,MAMUJU TENGAH,PANGALE,SARTANAMAJU,54,60,58,20,9,6,1,25,30,0,55,3,9,6,3,2,22,21,1,17,4,4,0,0,19,18,1,8,AGUSTUS
SULAWESI BARAT,MAMUJU TENGAH,PANGALE,POLO LERENG,82,18,13,10,5,0,0,9,3,1,13,0,7,7,0,2,14,13,1,12,8,3,5,2,8,1,7,2,AGUSTUS
SULAWESI BARAT,MAMUJU TENGAH,PANGALE,KUO,74,70,27,4,3,3,3,24,0,0,8,7,13,9,4,5,67,59,8,10,27,7,20,1,71,60,11,37,AGUSTUS
SULAWESI BARAT,MAMUJU TENGAH,PANGALE,POLO CAMBA,75,67,22,8,3,3,1,16,3,0,0,18,5,5,0,0,54,28,26,16,2,0,2,0,28,16,12,6,AGUSTUS
SULAWESI BARAT,MAMUJU TENGAH,PANGALE,LAMBA-LAMBA,63,61,11,7,3,1,0,4,5,2,11,0,0,0,0,0,53,31,22,10,16,7,9,3,40,27,13,14,AGUSTUS
SULAWESI BARAT,MAMUJU TENGAH,PANGALE,KOMBILING,40,22,10,2,2,0,0,1,4,5,10,0,6,5,1,2,15,12,3,1,6,6,0,5,15,13,2,6,AGUSTUS
SULAWESI BARAT,MAMUJU TENGAH,PANGALE,LEMO-LEMO,32,47,13,6,6,3,2,1,9,0,4,2,0,0,0,0,16,10,6,8,14,13,1,5,38,32,6,20,AGUSTUS
SULAWESI BARAT,MAMUJU TENGAH,BUDONG-BUDONG,BABANA,70,51,50,33,25,6,2,9,36,0,43,4,7,1,6,1,49,42,7,32,45,18,27,1,79,43,36,5,AGUSTUS
SULAWESI BARAT,MAMUJU TENGAH,BUDONG-BUDONG,LUMU,67,59,10,6,0,0,0,8,1,0,4,6,13,5,8,5,34,14,20,0,0,0,0,0,0,0,0,0,AGUSTUS
SULAWESI BARAT,MAMUJU TENGAH,BUDONG-BUDONG,PONTANAKAYANG,58,52,33,2,0,0,0,11,11,6,28,1,4,3,1,3,27,18,9,1,19,0,19,0,13,11,2,4,AGUSTUS
SULAWESI BARAT,MAMUJU TENGAH,BUDONG-BUDONG,SALOGATTA,56,60,37,6,0,0,0,1,30,4,12,20,7,3,4,1,30,6,24,1,1,1,0,1,14,13,1,9,AGUSTUS
SULAWESI BARAT,MAMUJU TENGAH,BUDONG-BUDONG,KIRE,82,36,11,9,6,2,1,6,1,3,7,4,5,4,1,0,19,8,11,0,2,1,1,0,18,10,8,11,AGUSTUS
SULAWESI BARAT,MAMUJU TENGAH,BUDONG-BUDONG,TINALI,83,23,11,5,3,2,0,0,8,3,2,5,14,9,5,6,19,9,10,2,10,4,6,0,0,0,0,0,AGUSTUS
SULAWESI BARAT,MAMUJU TENGAH,BUDONG-BUDONG,SALUMANURUNG,98,47,23,14,9,0,0,20,2,1,21,1,17,3,14,3,19,8,11,6,5,0,5,0,7,2,5,0,AGUSTUS
SULAWESI BARAT,MAMUJU TENGAH,BUDONG-BUDONG,PASAPA,38,80,58,14,10,9,6,50,2,0,10,45,2,2,0,2,60,20,40,11,7,2,5,0,3,1,2,0,AGUSTUS
SULAWESI BARAT,MAMUJU TENGAH,BUDONG-BUDONG,BOJO,44,27,22,8,2,2,2,11,8,1,22,0,2,2,0,0,18,16,2,11,13,11,2,3,23,7,16,19,AGUSTUS
SULAWESI BARAT,MAMUJU TENGAH,BUDONG-BUDONG,BARAKKANG,33,72,23,15,14,3,0,12,7,1,20,2,6,4,2,0,44,29,15,10,8,8,0,0,42,2,40,11,AGUSTUS
SULAWESI BARAT,MAMUJU TENGAH,BUDONG-BUDONG,LEMBAH HADA,58,59,4,1,0,0,0,0,0,1,4,0,4,2,2,0,13,7,6,5,8,2,6,1,48,24,24,1,AGUSTUS
SULAWESI BARAT,MAMUJU TENGAH,TOPOYO,BUDONG-BUDONG,86,28,21,5,4,2,0,2,9,2,21,0,3,0,3,0,20,10,10,5,3,3,0,2,21,19,2,8,AGUSTUS
SULAWESI BARAT,MAMUJU TENGAH,TOPOYO,TOPOYO,69,77,1,0,0,0,0,0,1,0,1,0,10,9,1,9,67,33,34,19,63,27,36,23,74,3,71,70,AGUSTUS
SULAWESI BARAT,MAMUJU TENGAH,TOPOYO,TUMBU,34,63,16,3,3,1,1,12,1,0,13,3,2,2,0,1,17,11,6,10,12,11,1,7,23,9,14,11,AGUSTUS
SULAWESI BARAT,MAMUJU TENGAH,TOPOYO,KABUBU,59,33,21,5,5,2,1,1,12,7,4,5,10,1,9,1,15,10,5,2,2,1,1,1,23,1,22,11,AGUSTUS
SULAWESI BARAT,MAMUJU TENGAH,TOPOYO,WAEPUTEH,52,42,2,1,0,0,0,2,0,0,0,1,7,2,5,0,23,18,5,15,10,6,4,5,13,10,3,8,AGUSTUS
SULAWESI BARAT,MAMUJU TENGAH,TOPOYO,TANGKOU,52,22,12,1,1,0,0,2,1,8,1,3,6,0,6,0,12,7,5,5,6,5,1,1,18,15,3,6,AGUSTUS
SULAWESI BARAT,MAMUJU TENGAH,TOPOYO,TABOLANG,53,38,25,4,2,2,0,11,13,1,16,3,6,2,4,2,38,22,16,4,11,3,8,1,29,14,15,10,AGUSTUS
SULAWESI BARAT,MAMUJU TENGAH,TOPOYO,PARAILI,85,78,29,6,3,2,0,22,3,2,23,4,15,11,4,10,36,14,22,11,17,8,9,5,9,6,3,3,AGUSTUS
SULAWESI BARAT,MAMUJU TENGAH,TOPOYO,SALUPANGKANG,59,38,0,0,0,0,0,0,0,0,0,0,0,0,0,0,38,34,4,20,15,10,5,2,6,6,0,2,AGUSTUS
SULAWESI BARAT,MAMUJU TENGAH,TOPOYO,SALUPANGKANG IV,74,64,61,37,2,0,0,29,3,21,61,0,8,8,0,0,42,10,32,6,26,14,12,2,23,18,5,20,AGUSTUS
SULAWESI BARAT,MAMUJU TENGAH,TOPOYO,TAPPILINA,65,44,36,2,2,2,0,4,19,1,23,6,8,5,3,1,13,8,5,3,1,0,1,0,9,2,7,2,AGUSTUS
SULAWESI BARAT,MAMUJU TENGAH,TOPOYO,BAMBAMANURUNG,63,30,21,11,5,1,0,16,5,0,5,11,8,8,0,2,13,7,6,6,12,3,9,2,15,10,5,11,AGUSTUS
SULAWESI BARAT,MAMUJU TENGAH,TOPOYO,SALULEKBO,33,67,32,16,6,2,1,24,3,3,8,1,6,1,5,0,45,32,13,19,0,0,0,0,20,8,12,8,AGUSTUS
SULAWESI BARAT,MAMUJU TENGAH,TOPOYO,PANGALLOANG,95,80,61,10,10,4,1,35,1,6,2,26,9,1,8,0,80,15,65,13,23,22,1,6,63,46,17,4,AGUSTUS
SULAWESI BARAT,MAMUJU TENGAH,TOPOYO,SINABATTA,64,43,16,11,9,4,0,2,9,1,9,1,9,7,2,6,16,9,7,5,11,0,11,0,37,15,22,30,AGUSTUS
SULAWESI BARAT,MAMUJU TENGAH,KAROSSA,KAROSSA,60,41,4,0,0,0,0,0,1,3,0,4,0,0,0,0,29,7,22,2,13,4,9,0,37,3,34,32,AGUSTUS
SULAWESI BARAT,MAMUJU TENGAH,KAROSSA,TASOKKO,59,32,10,1,1,0,0,10,0,0,6,2,11,8,3,2,16,7,9,0,4,2,2,0,8,7,1,1,AGUSTUS
SULAWESI BARAT,MAMUJU TENGAH,KAROSSA,LARA,47,41,19,19,17,3,0,4,3,3,15,4,7,6,1,5,12,8,4,3,4,2,2,1,20,16,4,8,AGUSTUS
SULAWESI BARAT,MAMUJU TENGAH,KAROSSA,KADAILA,90,22,14,10,7,0,0,12,2,0,9,1,10,3,7,3,15,7,8,4,4,2,2,1,3,0,3,0,AGUSTUS
SULAWESI BARAT,MAMUJU TENGAH,KAROSSA,KAYU CALLA,83,11,0,0,0,0,0,0,0,0,0,0,7,1,6,1,11,6,5,0,10,7,3,7,3,3,0,2,AGUSTUS
SULAWESI BARAT,MAMUJU TENGAH,KAROSSA,LEMBAH HOPO,69,48,23,17,6,4,2,9,2,2,6,0,11,6,5,3,45,7,38,2,9,7,2,4,41,33,8,0,AGUSTUS
SULAWESI BARAT,MAMUJU TENGAH,KAROSSA,BENGGAULU,98,49,11,4,2,2,2,8,1,0,1,4,0,0,0,0,11,11,0,11,3,0,3,0,9,9,0,3,AGUSTUS
SULAWESI BARAT,MAMUJU TENGAH,KAROSSA,SUKA MAJU,50,12,2,0,0,0,0,1,1,0,2,0,0,0,0,0,12,5,7,5,3,2,1,1,2,1,1,0,AGUSTUS
SULAWESI BARAT,MAMUJU TENGAH,KAROSSA,KAMBUNONG,88,55,13,0,0,0,0,8,0,3,4,3,6,3,3,1,40,36,4,30,10,3,7,1,5,3,2,0,AGUSTUS
SULAWESI BARAT,MAMUJU TENGAH,KAROSSA,SALUBIRO,48,72,71,52,46,37,4,7,29,27,57,9,9,7,2,4,59,55,4,12,48,23,25,16,37,9,28,10,AGUSTUS
SULAWESI BARAT,MAMUJU TENGAH,KAROSSA,SANJANGO,55,65,27,7,0,0,0,13,2,5,17,2,1,0,1,0,36,19,17,0,8,1,7,1,35,35,0,20,AGUSTUS
SULAWESI BARAT,PASANGKAYU,BAMBAIRA,TAMPAURE,38,22,21,13,4,0,0,1,19,0,1,1,3,1,2,0,16,16,0,0,9,4,5,2,9,9,0,4,AGUSTUS
SULAWESI BARAT,PASANGKAYU,BAMBAIRA,BAMBAIRA,35,29,25,10,8,3,1,3,12,3,14,8,5,5,0,0,25,5,20,3,8,1,7,1,8,8,0,5,AGUSTUS
SULAWESI BARAT,PASANGKAYU,BAMBAIRA,KASOLOANG,39,55,22,6,1,0,0,16,1,4,17,4,7,5,2,3,27,10,17,5,12,1,11,0,15,10,5,5,AGUSTUS
SULAWESI BARAT,PASANGKAYU,BAMBAIRA,KALUKU NANGKA,54,10,5,4,3,1,1,2,1,1,1,4,3,1,2,1,10,5,5,5,10,1,9,1,11,2,9,4,AGUSTUS
SULAWESI BARAT,PASANGKAYU,BAMBALAMOTU,RANDOMAYANG,97,33,20,11,10,8,2,4,5,6,1,14,4,2,2,0,31,14,17,1,1,1,0,0,18,1,17,16,AGUSTUS
SULAWESI BARAT,PASANGKAYU,BAMBALAMOTU,BAMBALAMOTU,93,63,25,9,5,0,0,10,5,9,17,4,16,8,8,2,15,6,9,4,4,2,2,1,0,0,0,0,AGUSTUS
SULAWESI BARAT,PASANGKAYU,BAMBALAMOTU,POLEWALI,84,72,51,22,15,1,1,13,12,12,35,12,1,0,1,0,17,7,10,2,17,11,6,11,57,6,51,34,AGUSTUS
SULAWESI BARAT,PASANGKAYU,BAMBALAMOTU,PANGIANG,72,16,13,12,1,0,0,12,1,0,9,2,11,10,1,6,14,9,5,5,7,4,3,4,17,12,5,0,AGUSTUS
SULAWESI BARAT,PASANGKAYU,BAMBALAMOTU,KALOLA,46,10,3,0,0,0,0,1,2,0,2,1,0,0,0,0,10,6,4,4,4,2,2,2,4,1,3,3,AGUSTUS
SULAWESI BARAT,PASANGKAYU,BAMBALAMOTU,WULAI,35,61,39,25,7,7,5,27,0,5,15,20,5,1,4,0,25,20,5,8,13,11,2,8,28,1,27,16,AGUSTUS
SULAWESI BARAT,PASANGKAYU,BARAS,BARAS,82,38,12,9,9,8,5,3,2,1,6,2,8,1,7,0,11,6,5,1,1,0,1,0,6,6,0,6,AGUSTUS
SULAWESI BARAT,PASANGKAYU,BARAS,BULU PARIGI,66,56,36,19,16,3,2,25,0,8,16,7,2,1,1,1,49,25,24,11,41,29,12,10,26,0,26,10,AGUSTUS
SULAWESI BARAT,PASANGKAYU,BARAS,BALANTI,75,55,44,35,35,10,6,38,0,0,8,30,9,4,5,3,37,22,15,8,34,24,10,13,37,34,3,10,AGUSTUS
SULAWESI BARAT,PASANGKAYU,BARAS,MOTU,65,42,41,11,5,5,0,27,7,5,31,2,12,2,10,0,34,20,14,3,11,10,1,3,16,2,14,4,AGUSTUS
SULAWESI BARAT,PASANGKAYU,BARAS,TOWONI,41,58,49,2,0,0,0,10,4,33,39,2,7,0,7,0,53,36,17,29,1,1,0,1,17,5,12,0,AGUSTUS
SULAWESI BARAT,PASANGKAYU,BARAS,KASANO,35,36,36,24,20,14,1,18,6,0,8,1,2,0,2,0,11,7,4,6,11,11,0,5,15,9,6,3,AGUSTUS
SULAWESI BARAT,PASANGKAYU,BULU TABA,SUMBER SARI,92,11,5,3,3,0,0,0,5,0,3,2,16,16,0,6,10,9,1,9,7,4,3,0,0,0,0,0,AGUSTUS
SULAWESI BARAT,PASANGKAYU,BULU TABA,LELEJAE,90,29,1,0,0,0,0,1,0,0,0,1,13,8,5,7,18,9,9,4,11,7,4,1,0,0,0,0,AGUSTUS
SULAWESI BARAT,PASANGKAYU,BULU TABA,BUKIT HARAPAN,91,15,8,7,7,2,2,1,4,1,3,4,13,9,4,0,14,12,2,6,13,10,3,6,10,6,4,2,AGUSTUS
SULAWESI BARAT,PASANGKAYU,BULU TABA,LILIMORI,66,72,21,13,13,8,6,15,0,0,2,0,12,7,5,6,18,16,2,14,7,1,6,0,39,8,31,14,AGUSTUS
SULAWESI BARAT,PASANGKAYU,BULU TABA,KARAVE,99,24,18,18,16,10,6,4,4,2,12,1,8,1,7,1,19,12,7,6,19,4,15,1,18,9,9,10,AGUSTUS
SULAWESI BARAT,PASANGKAYU,BULU TABA,KASTABUANA,47,76,9,3,2,2,0,0,9,0,1,0,6,5,1,5,49,8,41,6,17,12,5,11,33,0,33,15,AGUSTUS
SULAWESI BARAT,PASANGKAYU,BULU TABA,OMPI,68,44,23,0,0,0,0,20,1,2,17,1,7,5,2,4,25,10,15,4,9,6,3,5,10,8,2,10,AGUSTUS
SULAWESI BARAT,PASANGKAYU,DAPURANG,DAPURANG,39,54,16,10,2,0,0,3,1,2,0,15,2,0,2,0,12,9,3,5,12,12,0,1,17,13,4,15,AGUSTUS
SULAWESI BARAT,PASANGKAYU,DAPURANG,BENGGAULU,41,46,31,8,0,0,0,28,2,0,7,14,6,2,4,1,12,10,2,10,6,4,2,4,13,0,13,3,AGUSTUS
SULAWESI BARAT,PASANGKAYU,DAPURANG,TIRTABUANA,49,68,53,34,9,6,6,6,28,6,32,16,7,4,3,0,31,19,12,0,14,6,8,1,57,22,35,30,AGUSTUS
SULAWESI BARAT,PASANGKAYU,DAPURANG,BULU BONGGU,87,52,24,3,3,2,2,13,5,0,23,1,10,3,7,2,41,23,18,0,35,11,24,9,15,8,7,15,AGUSTUS
SULAWESI BARAT,PASANGKAYU,DAPURANG,SARASA,89,53,19,13,8,3,3,6,2,3,16,0,17,16,1,11,37,33,4,21,24,20,4,5,16,13,3,4,AGUSTUS
SULAWESI BARAT,PASANGKAYU,DURIPOKU,TAMMARUNANG,41,17,17,14,1,1,1,11,2,3,12,5,5,1,4,1,13,6,7,6,12,7,5,3,12,0,12,9,AGUSTUS
SULAWESI BARAT,PASANGKAYU,DURIPOKU,SAPTANAJAYA,31,52,44,14,8,1,0,36,7,0,14,29,3,3,0,2,39,30,9,16,39,33,6,20,37,31,6,3,AGUSTUS
SULAWESI BARAT,PASANGKAYU,DURIPOKU,TARANGGI,76,26,0,0,0,0,0,0,0,0,0,0,12,6,6,4,12,7,5,7,12,6,6,5,4,2,2,1,AGUSTUS
SULAWESI BARAT,PASANGKAYU,DURIPOKU,SIPAKAINGA,54,71,61,37,9,3,0,14,23,13,28,8,7,1,6,0,24,16,8,12,15,11,4,3,34,22,12,4,AGUSTUS
SULAWESI BARAT,PASANGKAYU,LARIANG,KULU,50,56,27,25,0,0,0,23,1,1,5,4,2,1,1,1,35,24,11,24,30,30,0,10,13,9,4,13,AGUSTUS
SULAWESI BARAT,PASANGKAYU,LARIANG,PARABU,53,15,5,5,3,1,1,4,0,0,3,0,3,0,3,0,15,7,8,2,2,1,1,1,12,12,0,8,AGUSTUS
SULAWESI BARAT,PASANGKAYU,LARIANG,KENANGAN,97,62,20,4,2,2,0,19,0,1,16,0,13,4,9,1,28,26,2,8,22,3,19,1,11,8,3,10,AGUSTUS
SULAWESI BARAT,PASANGKAYU,LARIANG,BAJAWALI,51,75,12,12,0,0,0,4,8,0,3,7,9,7,2,6,14,5,9,2,11,5,6,0,17,14,3,8,AGUSTUS
SULAWESI BARAT,PASANGKAYU,LARIANG,SINGGANI,53,35,28,24,13,0,0,15,12,0,21,2,4,4,0,3,22,13,9,3,5,3,2,3,3,1,2,2,AGUSTUS
SULAWESI BARAT,PASANGKAYU,LARIANG,BATU MATORU,96,71,33,1,1,0,0,10,10,2,26,6,19,7,12,0,57,27,30,23,46,32,14,26,78,29,49,32,AGUSTUS
SULAWESI BARAT,PASANGKAYU,LARIANG,BAMBAKORO,36,28,5,5,1,1,0,4,0,1,3,1,5,0,5,0,17,8,9,0,7,7,0,5,16,4,12,3,AGUSTUS
SULAWESI BARAT,PASANGKAYU,PASANGKAYU,KARYA BERSAMA,74,50,15,15,11,6,3,5,5,1,3,12,3,2,1,2,40,22,18,21,20,2,18,1,53,12,41,37,AGUSTUS
SULAWESI BARAT,PASANGKAYU,PASANGKAYU,AKO,76,41,0,0,0,0,0,0,0,0,0,0,4,1,3,1,28,13,15,12,10,0,10,0,33,16,17,23,AGUSTUS
SULAWESI BARAT,PASANGKAYU,PASANGKAYU,PASANGKAYU,94,12,10,1,1,1,1,5,4,0,7,0,1,0,1,0,11,8,3,0,10,6,4,1,12,11,1,12,AGUSTUS
SULAWESI BARAT,PASANGKAYU,PASANGKAYU,MARTAJAYA,81,40,19,12,6,6,4,11,3,0,5,0,3,0,3,0,23,16,7,9,1,0,1,0,29,11,18,7,AGUSTUS
SULAWESI BARAT,PASANGKAYU,PASANGKAYU,PAKAVA,38,71,41,1,1,1,0,30,7,1,21,1,7,3,4,3,41,28,13,6,16,7,9,1,54,51,3,35,AGUSTUS
SULAWESI BARAT,PASANGKAYU,PASANGKAYU,GUNUNG SARI,51,71,25,1,1,0,0,16,1,7,13,7,1,1,0,0,33,20,13,4,28,24,4,20,12,5,7,9,AGUSTUS
SULAWESI BARAT,PASANGKAYU,PEDONGGA,MALEI,33,80,33,31,10,5,3,14,16,0,19,2,2,0,2,0,78,65,13,55,35,26,9,13,29,23,6,26,AGUSTUS
SULAWESI BARAT,PASANGKAYU,PEDONGGA,PEDANDA,44,65,0,0,0,0,0,0,0,0,0,0,6,3,3,0,47,24,23,14,15,8,7,5,36,19,17,19,AGUSTUS
SULAWESI BARAT,PASANGKAYU,PEDONGGA,BATU OGE,95,76,19,2,2,2,1,17,0,0,19,0,1,1,0,0,41,40,1,36,30,26,4,23,22,8,14,14,AGUSTUS
SULAWESI BARAT,PASANGKAYU,PEDONGGA,MARTASARI,33,46,27,0,0,0,0,6,13,2,9,1,5,0,5,0,44,6,38,5,25,4,21,2,37,31,6,25,AGUSTUS
SULAWESI BARAT,PASANGKAYU,SARJO,SARJO,67,71,58,57,23,19,16,0,40,0,52,1,3,1,2,0,31,5,26,3,1,1,0,0,4,2,2,4,AGUSTUS
SULAWESI BARAT,PASANGKAYU,SARJO,MAPONU,40,17,1,1,1,1,0,0,1,0,1,0,1,0,1,0,13,11,2,11,2,1,1,1,1,1,0,1,AGUSTUS
SULAWESI BARAT,PASANGKAYU,SARJO,LETAWA,76,58,51,15,15,7,1,45,0,4,27,10,6,0,6,0,14,9,5,6,10,6,4,1,35,12,23,24,AGUSTUS
SULAWESI BARAT,PASANGKAYU,SARJO,SARUDE,92,62,34,14,3,2,1,19,9,1,9,16,13,12,1,3,59,26,33,22,0,0,0,0,14,9,5,9,AGUSTUS
SULAWESI BARAT,PASANGKAYU,SARUDU,DODA,83,58,9,0,0,0,0,2,6,1,6,3,2,0,2,0,42,8,34,5,10,1,9,1,45,25,20,32,AGUSTUS
SULAWESI BARAT,PASANGKAYU,SARUDU,SARUDU,51,71,2,1,1,0,0,1,0,1,1,0,8,5,3,4,26,18,8,16,17,7,10,5,60,6,54,40,AGUSTUS
SULAWESI BARAT,PASANGKAYU,SARUDU,BULU MARIO,93,73,12,12,4,4,1,4,3,3,4,6,13,5,8,3,58,8,50,8,39,5,34,3,48,20,28,10,AGUSTUS
SULAWESI BARAT,PASANGKAYU,SARUDU,KUMASARI,82,31,17,9,8,3,2,13,0,2,16,1,0,0,0,0,19,8,11,2,17,15,2,5,7,0,7,1,AGUSTUS
SULAWESI BARAT,PASANGKAYU,SARUDU,PATIKA,46,51,28,17,13,0,0,16,5,1,10,17,1,0,1,0,20,13,7,4,17,5,12,2,21,11,10,16,AGUSTUS
SULAWESI BARAT,PASANGKAYU,TIKKE RAYA,MAKMUR JAYA,38,31,31,2,0,0,0,1,21,7,7,6,5,5,0,4,31,10,21,6,31,11,20,8,20,16,4,8,AGUSTUS
SULAWESI BARAT,PASANGKAYU,TIKKE RAYA,LARIANG,76,64,0,0,0,0,0,0,0,0,0,0,10,2,8,2,56,31,25,21,2,0,2,0,29,2,27,25,AGUSTUS
SULAWESI BARAT,PASANGKAYU,TIKKE RAYA,TIKKE,54,25,4,4,0,0,0,1,0,0,2,0,7,3,4,3,19,6,13,4,17,6,11,1,10,2,8,4,AGUSTUS
SULAWESI BARAT,PASANGKAYU,TIKKE RAYA,PAJALELE,83,14,7,6,1,1,1,1,3,2,2,1,9,8,1,7,10,6,4,6,9,3,6,3,13,0,13,1,AGUSTUS
SULAWESI BARAT,PASANGKAYU,TIKKE RAYA,JENGENG RAYA,31,65,14,9,6,3,2,9,2,0,12,1,6,2,4,1,56,37,19,0,45,3,42,0,77,3,74,2,AGUSTUS
SULAWESI BARAT,MAJENE,BANGGAE,BANGGAE,92,64,44,23,9,3,1,5,34,2,29,13,2,2,0,1,27,12,15,12,19,17,2,17,6,4,2,5,AGUSTUS
SULAWESI BARAT,MAJENE,BANGGAE,BARU,79,24,13,3,2,0,0,8,1,3,10,2,6,4,2,4,14,14,0,8,5,4,1,2,5,5,0,2,AGUSTUS
SULAWESI BARAT,MAJENE,BANGGAE,PANGALI ALI,65,60,7,5,5,2,1,6,0,0,5,1,5,2,3,0,27,18,9,15,16,8,8,7,48,41,7,1,AGUSTUS
SULAWESI BARAT,MAJENE,BANGGAE,TOTOLI,33,78,72,4,3,0,0,63,9,0,68,4,6,4,2,2,58,41,17,28,44,24,20,7,71,41,30,20,AGUSTUS
SULAWESI BARAT,MAJENE,BANGGAE,RANGAS,85,30,18,15,3,0,0,0,5,4,8,2,6,1,5,0,13,11,2,1,8,0,8,0,10,10,0,3,AGUSTUS
SULAWESI BARAT,MAJENE,BANGGAE,GALUNG,83,27,8,4,2,1,1,1,1,2,0,7,6,0,6,0,15,11,4,6,2,2,0,2,14,3,11,4,AGUSTUS
SULAWESI BARAT,MAJENE,BANGGAE,PALIPI SOREANG,46,23,17,13,0,0,0,13,4,0,17,0,1,1,0,0,22,5,17,5,0,0,0,0,5,4,1,4,AGUSTUS
SULAWESI BARAT,MAJENE,BANGGAE,PAMBOBORANG,89,54,13,5,3,0,0,6,4,0,8,0,7,3,4,3,34,19,15,15,16,7,9,2,3,2,1,2,AGUSTUS
SULAWESI BARAT,MAJENE,BANGGAE TIMUR,BAURUNG,82,27,14,1,1,1,1,4,2,5,12,2,0,0,0,0,23,6,17,1,2,1,1,0,3,0,3,1,AGUSTUS
SULAWESI BARAT,MAJENE,BANGGAE TIMUR,BARUGA,54,39,37,3,0,0,0,23,12,0,20,0,10,3,7,3,39,27,12,24,5,2,3,0,17,11,6,13,AGUSTUS
SULAWESI BARAT,MAJENE,BANGGAE TIMUR,BARUGA DHUA,93,53,6,6,5,1,0,3,3,0,4,2,1,0,1,0,22,19,3,16,13,4,9,4,1,1,0,1,AGUSTUS
SULAWESI BARAT,MAJENE,BANGGAE TIMUR,LABUANG,63,10,6,6,3,2,1,3,0,1,5,0,0,0,0,0,10,5,5,2,2,2,0,1,1,0,1,1,AGUSTUS
SULAWESI BARAT,MAJENE,BANGGAE TIMUR,TANDE,95,25,23,1,0,0,0,9,5,6,8,1,3,1,2,0,17,5,12,0,4,3,1,1,17,16,1,4,AGUSTUS
SULAWESI BARAT,MAJENE,BANGGAE TIMUR,LEMBANG,48,22,5,4,2,1,0,2,3,0,1,0,9,4,5,0,12,5,7,0,9,6,3,1,2,1,1,2,AGUSTUS
SULAWESI BARAT,MAJENE,BANGGAE TIMUR,LABUANG UTARA,47,31,4,3,1,1,0,3,1,0,2,0,3,0,3,0,18,18,0,0,8,5,3,3,7,4,3,2,AGUSTUS
SULAWESI BARAT,MAJENE,BANGGAE TIMUR,TANDE TIMUR,43,56,37,13,2,1,1,36,0,0,2,31,7,2,5,1,27,23,4,10,6,2,4,0,29,15,14,16,AGUSTUS
SULAWESI BARAT,MAJENE,BANGGAE TIMUR,BUTTU BARUGA,56,70,56,36,2,0,0,8,16,4,23,21,3,0,3,0,50,16,34,2,28,1,27,0,32,19,13,23,AGUSTUS
SULAWESI BARAT,MAJENE,MALUNDA,MALUNDA,59,71,62,59,25,21,11,13,16,20,45,16,7,3,4,3,25,17,8,7,10,7,3,5,7,6,1,4,AGUSTUS
SULAWESI BARAT,MAJENE,MALUNDA,LAMUNGANG BATU,94,49,47,10,5,0,0,10,30,6,9,25,6,2,4,1,33,17,16,8,24,23,1,19,47,28,19,43,AGUSTUS
SULAWESI BARAT,MAJENE,MALUNDA,BAMBANGAN,70,28,11,6,3,0,0,7,2,2,3,8,12,7,5,6,26,10,16,5,2,0,2,0,7,6,1,6,AGUSTUS
SULAWESI BARAT,MAJENE,MALUNDA,LOMBANG,71,16,11,2,1,1,1,7,3,0,4,6,1,1,0,1,15,5,10,2,10,7,3,3,10,1,9,10,AGUSTUS
SULAWESI BARAT,MAJENE,MALUNDA,LOMBONG,63,52,44,30,0,0,0,22,10,7,34,4,1,1,0,0,51,28,23,11,1,0,1,0,20,5,15,15,AGUSTUS
SULAWESI BARAT,MAJENE,MALUNDA,MEKKATTA,85,31,14,5,4,2,0,0,5,2,9,4,1,1,0,1,14,8,6,8,7,2,5,1,21,13,8,14,AGUSTUS
SULAWESI BARAT,MAJENE,MALUNDA,MALIAYA,86,60,1,1,1,0,0,1,0,0,0,1,1,0,1,0,43,9,34,1,41,11,30,11,57,6,51,4,AGUSTUS
SULAWESI BARAT,MAJENE,MALUNDA,LOMBANG TIMUR,41,15,3,3,2,1,0,2,0,0,0,1,3,1,2,0,12,9,3,0,4,3,1,3,12,4,8,9,AGUSTUS
SULAWESI BARAT,MAJENE,MALUNDA,SALUTAHONGAN,88,27,17,7,1,1,1,4,0,3,16,1,1,1,0,1,18,17,1,13,18,6,12,1,10,5,5,4,AGUSTUS
SULAWESI BARAT,MAJENE,MALUNDA,LOMBONG TIMUR,30,32,2,0,0,0,0,2,0,0,1,0,4,0,4,0,20,14,6,13,11,9,2,5,10,7,3,0,AGUSTUS
SULAWESI BARAT,MAJENE,MALUNDA,MEKKATTA SELATAN,86,60,39,34,16,3,2,6,31,0,8,31,0,0,0,0,20,11,9,10,14,1,13,1,7,3,4,7,AGUSTUS
SULAWESI BARAT,MAJENE,MALUNDA,KAYUANGIN,39,76,36,13,12,9,1,11,10,9,4,1,5,0,5,0,61,35,26,12,10,10,0,4,28,17,11,12,AGUSTUS
SULAWESI BARAT,MAJENE,PAMBOANG,LALAMPANUA,75,77,13,3,2,0,0,3,6,4,7,1,2,1,1,0,27,15,12,6,16,16,0,2,26,25,1,3,AGUSTUS
SULAWESI BARAT,MAJENE,PAMBOANG,SIRINDU,96,30,16,11,8,3,1,7,2,5,5,11,5,5,0,5,15,14,1,7,7,1,6,1,18,6,12,15,AGUSTUS
SULAWESI BARAT,MAJENE,PAMBOANG,ADOLANG,80,69,19,10,3,0,0,7,5,4,7,8,9,5,4,3,37,5,32,2,23,9,14,3,9,7,2,2,AGUSTUS
SULAWESI BARAT,MAJENE,PAMBOANG,BABABULO,73,12,4,3,1,0,0,3,0,0,4,0,9,9,0,2,10,5,5,5,7,0,7,0,11,5,6,4,AGUSTUS
SULAWESI BARAT,MAJENE,PAMBOANG,BONDE,82,12,6,4,4,0,0,0,2,2,6,0,15,8,7,3,11,5,6,2,8,2,6,1,7,7,0,6,AGUSTUS
SULAWESI BARAT,MAJENE,PAMBOANG,BETTENG,38,19,13,8,6,6,0,5,8,0,0,8,6,1,5,1,18,17,1,14,5,5,0,1,18,2,16,12,AGUSTUS
SULAWESI BARAT,MAJENE,PAMBOANG,SIMBANG,43,59,11,11,1,1,1,4,1,3,11,0,6,4,2,3,59,52,7,0,34,12,22,10,51,22,29,44,AGUSTUS
SULAWESI BARAT,MAJENE,PAMBOANG,BONDE UTARA,98,14,8,4,3,2,0,1,2,1,4,2,3,1,2,1,12,9,3,7,9,2,7,1,18,13,5,12,AGUSTUS
SULAWESI BARAT,MAJENE,PAMBOANG,BABABULO UTARA,50,31,18,15,10,5,0,18,0,0,18,0,10,6,4,2,25,16,9,11,13,0,13,0,17,7,10,10,AGUSTUS
SULAWESI BARAT,MAJENE,PAMBOANG,BUTTU PAMBOANG,95,19,7,0,0,0,0,4,1,1,4,0,13,6,7,3,12,12,0,2,11,11,0,2,10,3,7,4,AGUSTUS
SULAWESI BARAT,MAJENE,PAMBOANG,BANUA ADOLANG,83,57,42,23,6,3,3,32,0,7,16,17,11,8,3,3,17,14,3,5,6,2,4,2,18,8,10,1,AGUSTUS
SULAWESI BARAT,MAJENE,PAMBOANG,ADOLANG DHUA,87,17,1,0,0,0,0,0,0,0,1,0,0,0,0,0,14,14,0,6,2,1,1,0,12,6,6,9,AGUSTUS
SULAWESI BARAT,MAJENE,PAMBOANG,TINAMBUNG,48,30,15,0,0,0,0,4,6,5,8,1,1,1,0,0,28,27,1,1,20,12,8,11,11,8,3,3,AGUSTUS
SULAWESI BARAT,MAJENE,PAMBOANG,PESULOANG,91,31,0,0,0,0,0,0,0,0,0,0,1,1,0,0,27,5,22,0,4,1,3,0,7,6,1,3,AGUSTUS
SULAWESI BARAT,MAJENE,PAMBOANG,BALOMBONG,98,59,44,3,1,1,0,25,5,4,24,9,11,1,10,0,32,7,25,1,22,1,21,0,6,2,4,1,AGUSTUS
SULAWESI BARAT,MAJENE,SENDANA,MOSSO,87,58,20,14,9,4,2,8,9,0,1,2,8,2,6,0,24,20,4,3,6,1,5,1,21,15,6,6,AGUSTUS
SULAWESI BARAT,MAJENE,SENDANA,MOSSO DHUA,49,74,41,1,1,1,1,15,7,10,34,5,9,9,0,9,34,24,10,23,32,28,4,1,0,0,0,0,AGUSTUS
SULAWESI BARAT,MAJENE,SENDANA,TOTOLISI SENDANA,50,40,6,2,2,2,0,6,0,0,2,1,2,2,0,2,36,25,11,11,20,6,14,1,15,3,12,4,AGUSTUS
SULAWESI BARAT,MAJENE,SENDANA,TALLUBANUA,30,42,19,13,1,0,0,1,4,7,8,6,6,0,6,0,41,14,27,1,36,14,22,13,20,15,5,1,AGUSTUS
SULAWESI BARAT,MAJENE,SENDANA,LALATEDZONG,70,17,15,7,1,0,0,15,0,0,10,1,10,0,10,0,10,9,1,9,3,1,2,0,10,5,5,3,AGUSTUS
SULAWESI BARAT,MAJENE,SENDANA,BINANGA,50,28,27,26,5,2,0,16,1,7,5,21,10,1,9,1,18,12,6,1,2,1,1,0,20,12,8,13,AGUSTUS
SULAWESI BARAT,MAJENE,SENDANA,PUTTADA,51,40,19,12,5,3,2,4,12,1,0,18,4,0,4,0,25,24,1,2,15,2,13,0,41,21,20,0,AGUSTUS
SULAWESI BARAT,MAJENE,SENDANA,PAMINGGALAN,47,44,22,7,1,0,0,6,7,2,14,8,4,4,0,4,12,11,1,7,10,2,8,1,2,0,2,0,AGUSTUS
SULAWESI BARAT,MAJENE,SENDANA,LEPPANGANG,64,49,13,2,0,0,0,8,4,1,13,0,4,4,0,1,44,35,9,7,7,4,3,2,39,14,25,30,AGUSTUS
SULAWESI BARAT,MAJENE,SENDANA,PUNDAU,74,14,3,1,1,1,1,0,2,0,0,0,6,3,3,2,13,13,0,1,2,0,2,0,3,0,3,1,AGUSTUS
SULAWESI BARAT,MAJENE,SENDANA,SENDANA,39,24,20,19,18,18,16,0,3,0,13,5,7,6,1,3,17,12,5,12,17,13,4,12,29,24,5,21,AGUSTUS
SULAWESI BARAT,MAJENE,SENDANA,BANUA SENDANA,61,67,18,15,2,1,1,12,2,0,9,5,3,1,2,0,60,42,18,21,14,6,8,5,5,5,0,4,AGUSTUS
SULAWESI BARAT,MAJENE,SENDANA,TALLUBANUA UTARA,61,65,57,8,4,2,1,12,4,2,0,54,11,3,8,3,41,10,31,8,41,40,1,17,39,8,31,34,AGUSTUS
SULAWESI BARAT,MAJENE,SENDANA,LIMBORO RAMBU-RAMBU,62,30,28,7,1,0,0,5,7,7,4,22,0,0,0,0,27,10,17,7,12,10,2,4,0,0,0,0,AGUSTUS
SULAWESI BARAT,MAJENE,SENDANA,LIMBUA,34,59,39,12,8,6,4,17,4,11,26,12,2,2,0,1,43,9,34,7,1,0,1,0,23,11,12,3,AGUSTUS
SULAWESI BARAT,MAJENE,SENDANA,BUKIT SAMANG,64,75,58,4,0,0,0,9,1,17,58,0,7,1,6,0,36,11,25,3,8,6,2,5,38,12,26,14,AGUSTUS
SULAWESI BARAT,MAJENE,TAMMERODO SENDANA,SEPPONG,41,18,9,1,1,1,0,8,0,0,4,0,8,8,0,0,13,12,1,10,7,6,1,0,2,1,1,2,AGUSTUS
SULAWESI BARAT,MAJENE,TAMMERODO SENDANA,TAMMERODO,83,33,7,6,3,1,1,3,2,1,6,1,14,1,13,1,19,5,14,3,12,10,2,3,21,4,17,12,AGUSTUS
SULAWESI BARAT,MAJENE,TAMMERODO SENDANA,ULIDANG,61,29,26,21,0,0,0,18,5,0,20,0,6,1,5,1,28,22,6,9,25,1,24,0,24,11,13,10,AGUSTUS
SULAWESI BARAT,MAJENE,TAMMERODO SENDANA,TALLAMBALAO,53,21,0,0,0,0,0,0,0,0,0,0,3,2,1,1,10,6,4,0,3,2,1,2,11,1,10,5,AGUSTUS
SULAWESI BARAT,MAJENE,TAMMERODO SENDANA,TAMMERODO UTARA,89,63,11,1,0,0,0,3,5,2,5,3,4,0,4,0,13,9,4,1,3,2,1,0,4,1,3,3,AGUSTUS
SULAWESI BARAT,MAJENE,TAMMERODO SENDANA,MANYAMBA,61,44,43,30,7,3,0,38,3,2,23,1,10,9,1,1,35,10,25,4,25,15,10,15,25,0,25,5,AGUSTUS
SULAWESI BARAT,MAJENE,TAMMERODO SENDANA,AWO,34,15,2,1,1,1,0,2,0,0,0,2,1,0,1,0,10,6,4,6,0,0,0,0,5,3,2,3,AGUSTUS
SULAWESI BARAT,MAJENE,TUBO SENDANA,ONANG,74,80,69,7,5,0,0,32,8,29,23,27,4,0,4,0,69,29,40,15,22,11,11,9,3,2,1,3,AGUSTUS
SULAWESI BARAT,MAJENE,TUBO SENDANA,TUBO,86,69,29,21,17,1,1,12,9,4,17,9,7,7,0,7,36,36,0,24,3,1,2,0,47,11,36,12,AGUSTUS
SULAWESI BARAT,MAJENE,TUBO SENDANA,ONANG UTARA,72,44,18,12,11,11,0,3,1,5,14,3,13,1,12,0,16,12,4,0,11,1,10,0,41,38,3,5,AGUSTUS
SULAWESI BARAT,MAJENE,TUBO SENDANA,TUBO SELATAN,92,28,22,14,14,3,1,14,6,1,16,2,17,7,10,1,26,20,6,1,24,9,15,6,36,8,28,8,AGUSTUS
SULAWESI BARAT,MAJENE,TUBO SENDANA,BONDE BONDE,62,14,5,1,1,0,0,1,2,1,0,4,6,1,5,0,14,12,2,5,11,1,10,0,10,10,0,3,AGUSTUS
SULAWESI BARAT,MAJENE,TUBO SENDANA,TUBO TENGAH,96,25,7,5,2,2,2,1,4,0,6,1,6,1,5,1,14,5,9,3,1,0,1,0,14,6,8,10,AGUSTUS
SULAWESI BARAT,MAJENE,TUBO SENDANA,TUBO POANG,85,21,1,1,0,0,0,0,1,0,1,0,15,7,8,3,17,13,4,1,15,2,13,0,2,0,2,0,AGUSTUS
SULAWESI BARAT,MAJENE,ULUMANDA,KABIRAAN,49,51,16,5,1,1,0,5,4,3,1,2,8,1,7,1,50,46,4,8,32,20,12,17,66,32,34,37,AGUSTUS
SULAWESI BARAT,MAJENE,ULUMANDA,SAMBABO,100,34,25,10,9,2,0,10,6,3,22,3,19,11,8,1,12,10,2,2,11,8,3,7,13,3,10,3,AGUSTUS
SULAWESI BARAT,MAJENE,ULUMANDA,TANDEALLO,48,56,14,11,5,2,1,4,7,1,3,0,9,8,1,5,44,26,18,17,0,0,0,0,4,2,2,0,AGUSTUS
SULAWESI BARAT,MAJENE,ULUMANDA,ULUMANDA,90,43,17,5,5,4,0,0,5,5,4,8,15,10,5,2,12,12,0,4,8,5,3,1,1,1,0,0,AGUSTUS
SULAWESI BARAT,MAJENE,ULUMANDA,SALUTAMBUNG,51,41,4,1,0,0,0,3,0,0,0,4,1,1,0,1,27,6,21,0,7,7,0,0,30,27,3,29,AGUSTUS
SULAWESI BARAT,MAJENE,ULUMANDA,POPENGA,73,43,8,4,4,2,0,5,2,0,3,0,6,6,0,1,34,13,21,5,16,4,12,4,21,14,7,18,AGUSTUS
SULAWESI BARAT,MAJENE,ULUMANDA,SULAI,49,10,9,9,6,2,2,6,0,1,9,0,0,0,0,0,10,10,0,4,6,3,3,0,12,11,1,12,AGUSTUS
SULAWESI BARAT,MAJENE,ULUMANDA,PANGGALO,39,17,17,13,8,4,4,4,3,4,12,4,5,4,1,4,10,9,1,1,0,0,0,0,8,8,0,7,AGUSTUS
SULAWESI BARAT,MAMASA,ARALLE,ARALLE,37,28,15,8,5,0,0,5,8,0,6,8,6,3,3,3,16,5,11,3,14,0,14,0,30,4,26,6,AGUSTUS
SULAWESI BARAT,MAMASA,ARALLE,RALLE ANAK,79,57,24,13,1,0,0,23,0,1,18,3,11,4,7,4,33,14,19,6,29,5,24,3,38,32,6,21,AGUSTUS
SULAWESI BARAT,MAMASA,ARALLE,PANETEAN,59,74,58,5,5,4,4,51,1,2,47,4,6,2,4,2,17,6,11,6,1,1,0,1,7,2,5,1,AGUSTUS
SULAWESI BARAT,MAMASA,ARALLE,UHAILANU,74,27,26,15,1,1,0,12,8,0,25,0,6,3,3,2,23,6,17,5,22,6,16,0,23,22,1,7,AGUSTUS
SULAWESI BARAT,MAMASA,ARALLE,ARALLE UTARA,52,20,7,4,4,2,2,5,0,0,5,1,10,6,4,3,17,14,3,0,6,2,4,2,1,0,1,0,AGUSTUS
SULAWESI BARAT,MAMASA,ARALLE,UHAIDAHO,89,57,4,4,3,0,0,1,2,1,2,0,7,7,0,3,37,34,3,9,5,2,3,1,36,19,17,21,AGUSTUS
SULAWESI BARAT,MAMASA,ARALLE,BARURU,37,73,30,9,4,4,1,29,0,0,3,8,5,1,4,0,51,27,24,8,10,1,9,1,46,43,3,41,AGUSTUS
SULAWESI BARAT,MAMASA,ARALLE,RALLEANAK UTARA,70,80,73,48,26,0,0,51,4,7,37,4,13,4,9,2,12,10,2,3,1,0,1,0,7,1,6,3,AGUSTUS
SULAWESI BARAT,MAMASA,ARALLE,PAMOSEANG PANGGA,59,80,68,51,36,28,11,36,18,3,22,38,9,6,3,0,15,5,10,5,0,0,0,0,36,17,19,34,AGUSTUS
SULAWESI BARAT,MAMASA,ARALLE,KALABE,99,73,25,4,0,0,0,8,10,0,1,19,18,18,0,2,15,5,10,1,6,4,2,2,39,11,28,27,AGUSTUS
SULAWESI BARAT,MAMASA,ARALLE,ARALLE SELATAN,32,75,40,6,1,1,0,23,8,8,27,8,2,0,2,0,57,39,18,39,12,6,6,0,21,1,20,10,AGUSTUS
SULAWESI BARAT,MAMASA,ARALLE,HAHANGAN,87,42,2,0,0,0,0,1,0,0,0,0,9,4,5,4,20,6,14,2,11,0,11,0,22,1,21,0,AGUSTUS
SULAWESI BARAT,MAMASA,BALLA,BALLA,55,20,19,14,9,4,0,19,0,0,16,2,7,1,6,1,13,9,4,0,11,11,0,0,23,9,14,20,AGUSTUS
SULAWESI BARAT,MAMASA,BALLA,BALLA BARAT,49,46,25,15,2,1,1,5,13,4,8,11,6,3,3,2,29,17,12,0,29,18,11,18,9,6,3,4,AGUSTUS
SULAWESI BARAT,MAMASA,BALLA,BALLA SATANETEAN,86,10,6,0,0,0,0,0,5,0,0,4,9,9,0,0,10,10,0,3,7,5,2,1,9,4,5,7,AGUSTUS
SULAWESI BARAT,MAMASA,BALLA,BALLA TUMUKA,57,56,25,6,0,0,0,0,8,3,15,8,11,2,9,0,45,27,18,8,40,37,3,14,34,2,32,32,AGUSTUS
SULAWESI BARAT,MAMASA,BALLA,SEPAKUAN,55,57,50,26,18,3,3,6,28,4,11,10,6,0,6,0,51,36,15,5,24,6,18,0,15,3,12,2,AGUSTUS
SULAWESI BARAT,MAMASA,BALLA,PIDARA,75,53,33,27,25,15,11,20,0,2,2,21,13,0,13,0,44,23,21,17,1,1,0,0,34,9,25,4,AGUSTUS
SULAWESI BARAT,MAMASA,BALLA,BAMBAPUANG,61,24,1,0,0,0,0,1,0,0,0,0,4,4,0,4,17,7,10,7,17,0,17,0,22,9,13,4,AGUSTUS
SULAWESI BARAT,MAMASA,BALLA,BALLA TIMUR,49,28,27,6,4,4,0,3,6,1,8,4,2,0,2,0,22,13,9,12,16,7,9,7,30,19,11,13,AGUSTUS
SULAWESI BARAT,MAMASA,BAMBANG,MOKALLANG,35,40,28,22,4,0,0,18,6,1,25,0,3,0,3,0,32,23,9,6,20,7,13,1,28,14,14,11,AGUSTUS
SULAWESI BARAT,MAMASA,BAMBANG,MASOSO,82,29,9,0,0,0,0,4,2,3,4,0,4,0,4,0,26,20,6,0,9,2,7,1,20,3,17,0,AGUSTUS
SULAWESI BARAT,MAMASA,BAMBANG,SALUASSING,37,80,44,31,12,5,3,14,12,3,13,0,7,7,0,7,30,20,10,7,9,3,6,0,5,5,0,5,AGUSTUS
SULAWESI BARAT,MAMASA,BAMBANG,SALUBULO,63,75,24,7,0,0,0,19,0,4,17,5,1,0,1,0,52,43,9,42,15,13,2,5,17,8,9,9,AGUSTUS
SULAWESI BARAT,MAMASA,BAMBANG,SALUKADI,58,29,25,3,3,2,1,6,5,1,12,3,7,5,2,5,11,11,0,1,7,4,3,0,7,6,1,0,AGUSTUS
SULAWESI BARAT,MAMASA,BAMBANG,SALUKEPOPOK,66,43,15,8,8,2,0,8,5,1,10,2,12,5,7,2,29,14,15,11,15,13,2,7,14,4,10,5,AGUSTUS
SULAWESI BARAT,MAMASA,BAMBANG,ULUMAMBI BARAT,45,21,9,2,0,0,0,3,0,5,7,0,4,3,1,3,16,6,10,2,2,2,0,1,15,4,11,10,AGUSTUS
SULAWESI BARAT,MAMASA,BAMBANG,LIMBADEBATA,60,48,3,2,0,0,0,2,1,0,0,3,6,6,0,5,21,17,4,0,18,4,14,0,18,11,7,14,AGUSTUS
SULAWESI BARAT,MAMASA,BAMBANG,TANETE TOMBA,39,36,18,4,2,0,0,16,1,1,18,0,3,0,3,0,27,18,9,3,1,1,0,0,22,22,0,21,AGUSTUS
SULAWESI BARAT,MAMASA,BAMBANG,BAMBANG,54,18,9,0,0,0,0,1,1,7,1,1,9,6,3,2,15,12,3,6,15,7,8,2,17,10,7,16,AGUSTUS
SULAWESI BARAT,MAMASA,BAMBANG,RANTELEMO,93,31,10,6,0,0,0,3,7,0,10,0,18,15,3,10,28,12,16,7,7,6,1,4,10,1,9,5,AGUSTUS
SULAWESI BARAT,MAMASA,BAMBANG,SALUDENGEN,42,36,9,2,1,1,0,7,2,0,0,1,5,2,3,0,14,12,2,5,13,9,4,1,15,12,3,0,AGUSTUS
SULAWESI BARAT,MAMASA,BAMBANG,ULUMAMBI,45,68,30,13,5,1,1,0,10,5,27,0,1,0,1,0,24,17,7,2,10,6,4,5,57,24,33,56,AGUSTUS
SULAWESI BARAT,MAMASA,BAMBANG,BAMBANG TIMUR,94,46,20,6,4,3,2,9,0,4,18,1,3,0,3,0,20,11,9,8,11,10,1,0,32,5,27,32,AGUSTUS
SULAWESI BARAT,MAMASA,BAMBANG,MINANGA,58,39,24,15,9,5,2,10,1,9,21,1,1,1,0,0,36,22,14,11,32,16,16,7,5,4,1,4,AGUSTUS
SULAWESI BARAT,MAMASA,BAMBANG,SIKAMASE,31,54,26,5,3,3,0,17,5,2,13,0,6,2,4,0,31,17,14,7,12,3,9,1,34,0,34,14,AGUSTUS
SULAWESI BARAT,MAMASA,BAMBANG,RANTETARIMA,81,78,64,35,5,0,0,19,22,9,23,26,14,4,10,4,64,60,4,31,54,19,35,17,96,21,75,16,AGUSTUS
SULAWESI BARAT,MAMASA,BAMBANG,SALURURU,81,77,35,30,28,1,0,35,0,0,8,24,14,7,7,2,23,13,10,9,10,6,4,3,8,2,6,0,AGUSTUS
SULAWESI BARAT,MAMASA,BAMBANG,SALUTABANG,80,42,4,1,1,0,0,2,2,0,2,0,15,3,12,3,20,10,10,8,4,2,2,1,22,18,4,10,AGUSTUS
SULAWESI BARAT,MAMASA,BAMBANG,BALATANA,54,17,13,11,8,8,2,11,0,0,3,2,10,1,9,0,15,8,7,3,8,7,1,5,3,0,3,0,AGUSTUS
SULAWESI BARAT,MAMASA,BUNTUMALANGKA,BUNTUMALANGKA,59,24,13,9,3,1,0,2,1,3,11,2,7,1,6,1,12,12,0,7,10,0,10,0,8,4,4,8,AGUSTUS
SULAWESI BARAT,MAMASA,BUNTUMALANGKA,RANTEBERAN,33,40,15,2,1,0,0,0,12,1,4,9,2,1,1,0,29,23,6,8,13,8,5,8,35,13,22,30,AGUSTUS
SULAWESI BARAT,MAMASA,BUNTUMALANGKA,KEBANGA,94,33,31,9,1,1,0,16,6,1,25,1,2,2,0,0,15,15,0,8,8,1,7,1,10,7,3,2,AGUSTUS
SULAWESI BARAT,MAMASA,BUNTUMALANGKA,SALURINDU,38,22,14,14,0,0,0,3,3,8,7,3,7,0,7,0,12,9,3,6,6,4,2,3,18,2,16,15,AGUSTUS
SULAWESI BARAT,MAMASA,BUNTUMALANGKA,TAORA,51,56,16,14,8,1,0,8,8,0,16,0,4,0,4,0,20,12,8,0,7,5,2,0,35,29,6,33,AGUSTUS
SULAWESI BARAT,MAMASA,BUNTUMALANGKA,KABAE,77,32,27,14,9,7,6,11,2,3,27,0,4,2,2,0,29,16,13,8,25,4,21,2,20,17,3,3,AGUSTUS
SULAWESI BARAT,MAMASA,BUNTUMALANGKA,SALUTAMBUN BARAT,54,44,8,4,2,1,0,2,0,4,1,2,7,0,7,0,20,9,11,5,2,2,0,2,26,1,25,24,AGUSTUS
SULAWESI BARAT,MAMASA,BUNTUMALANGKA,PENATANGAN,92,31,8,1,1,0,0,7,1,0,6,0,2,1,1,0,22,21,1,21,10,1,9,1,6,1,5,4,AGUSTUS
SULAWESI BARAT,MAMASA,BUNTUMALANGKA,SALUTAMBUN TIMUR,45,45,13,9,1,0,0,5,6,0,4,6,4,2,2,0,17,14,3,6,14,14,0,12,16,11,5,11,AGUSTUS
SULAWESI BARAT,MAMASA,BUNTUMALANGKA,SALUTAMBUN,47,38,34,11,4,4,3,19,4,7,10,9,6,5,1,1,29,23,6,22,19,11,8,9,18,18,0,10,AGUSTUS
SULAWESI BARAT,MAMASA,BUNTUMALANGKA,ARALLE TIMUR,39,34,2,0,0,0,0,0,1,0,2,0,4,2,2,0,33,33,0,21,17,12,5,1,12,9,3,7,AGUSTUS
SULAWESI BARAT,MAMASA,MAMASA,MAMASA,59,49,29,14,2,2,1,7,1,17,0,26,0,0,0,0,16,6,10,6,2,2,0,0,30,30,0,10,AGUSTUS
SULAWESI BARAT,MAMASA,MAMASA,RAMBUSARATU,56,24,7,4,2,2,2,0,5,0,6,1,5,2,3,0,13,12,1,12,6,5,1,5,9,2,7,5,AGUSTUS
SULAWESI BARAT,MAMASA,MAMASA,OSANGO,55,49,49,31,25,2,1,37,7,3,21,26,11,8,3,6,26,26,0,8,11,1,10,0,38,38,0,6,AGUSTUS
SULAWESI BARAT,MAMASA,MAMASA,LAMBANAN,37,56,43,39,21,5,2,19,22,0,11,24,4,3,1,2,36,29,7,9,23,16,7,10,39,2,37,26,AGUSTUS
SULAWESI BARAT,MAMASA,MAMASA,LEMBANA SALULO,32,40,6,2,1,1,1,3,0,0,5,1,0,0,0,0,26,24,2,5,22,16,6,12,24,19,5,9,AGUSTUS
SULAWESI BARAT,MAMASA,MAMASA,TAUPE,78,26,24,2,2,1,1,11,6,2,19,4,7,6,1,6,19,19,0,13,10,6,4,6,6,5,1,5,AGUSTUS
SULAWESI BARAT,MAMASA,MAMASA,BUNTU BUDA,44,13,8,7,0,0,0,3,3,0,4,3,3,0,3,0,12,5,7,4,3,3,0,3,11,2,9,8,AGUSTUS
SULAWESI BARAT,MAMASA,MAMASA,TONDOK BAKARU,43,20,20,16,1,0,0,17,0,1,4,16,7,7,0,2,19,8,11,3,16,15,1,6,18,11,7,15,AGUSTUS
SULAWESI BARAT,MAMASA,MAMASA,PEBASSIAN,80,38,17,15,3,1,1,14,0,2,14,0,8,0,8,0,13,5,8,4,10,8,2,5,26,0,26,8,AGUSTUS
SULAWESI BARAT,MAMASA,MAMASA,MAMBULILING,56,41,17,11,3,3,3,12,1,1,15,1,9,3,6,1,23,7,16,7,12,11,1,2,36,3,33,27,AGUSTUS
SULAWESI BARAT,MAMASA,MAMASA,BOMBONG LAMBE,57,32,32,10,3,3,3,19,3,0,16,11,6,2,4,0,18,17,1,17,4,2,2,0,21,16,5,10,AGUSTUS
SULAWESI BARAT,MAMASA,MAMASA,BUBUN BATU,76,35,18,7,3,1,0,4,3,8,9,3,3,1,2,1,16,5,11,4,5,0,5,0,4,1,3,1,AGUSTUS
SULAWESI BARAT,MAMASA,MAMBI,MAMBI,41,23,6,6,2,2,0,5,1,0,5,1,1,0,1,0,11,7,4,4,7,2,5,0,21,15,6,15,AGUSTUS
SULAWESI BARAT,MAMASA,MAMBI,TALIPUKKI,84,50,14,13,0,0,0,5,4,2,4,4,0,0,0,0,10,6,4,4,10,7,3,3,40,32,8,19,AGUSTUS
SULAWESI BARAT,MAMASA,MAMBI,RANTEBULAHAN,81,44,11,3,2,2,1,7,3,0,10,1,12,2,10,2,41,7,34,7,22,21,1,0,50,45,5,35,AGUSTUS
SULAWESI BARAT,MAMASA,MAMBI,SONDONGLAYU,90,70,11,6,6,3,2,8,1,0,2,1,4,0,4,0,36,14,22,2,36,17,19,11,0,0,0,0,AGUSTUS
SULAWESI BARAT,MAMASA,MAMBI,SALUBANUA,96,64,8,8,3,2,2,6,0,0,4,3,19,14,5,8,59,8,51,7,11,8,3,4,36,30,6,21,AGUSTUS
SULAWESI BARAT,MAMASA,MAMBI,TAPALINA,95,52,39,36,24,11,4,31,4,0,15,9,2,0,2,0,31,10,21,10,30,29,1,4,64,6,58,45,AGUSTUS
SULAWESI BARAT,MAMASA,MAMBI,SENDANA,52,16,7,2,2,0,0,2,3,2,7,0,7,0,7,0,15,15,0,0,14,13,1,11,12,0,12,3,AGUSTUS
SULAWESI BARAT,MAMASA,MAMBI,PAMOSEAN,69,65,22,14,4,1,0,5,13,2,15,3,7,2,5,1,38,37,1,30,36,33,3,0,65,23,42,61,AGUSTUS
SULAWESI BARAT,MAMASA,MAMBI,SELUMAKA,87,42,22,2,0,0,0,13,5,1,7,9,17,3,14,3,41,11,30,2,4,0,4,0,23,6,17,17,AGUSTUS
SULAWESI BARAT,MAMASA,MAMBI,BUJUNG MANURUNG,81,50,14,9,5,0,0,13,0,1,8,1,2,1,1,0,48,26,22,26,21,1,20,0,7,3,4,3,AGUSTUS
SULAWESI BARAT,MAMASA,MAMBI,SALU ALO,81,51,19,1,1,0,0,3,2,6,6,9,8,1,7,0,14,13,1,8,4,0,4,0,2,2,0,2,AGUSTUS
SULAWESI BARAT,MAMASA,MAMBI,INDOBANUA,60,59,37,6,3,0,0,21,5,3,22,7,11,3,8,2,37,7,30,1,11,9,2,8,23,8,15,12,AGUSTUS
SULAWESI BARAT,MAMASA,MAMBI,SALUDURIAN,44,18,2,2,2,1,0,2,0,0,1,1,6,2,4,0,14,7,7,3,4,0,4,0,4,2,2,3,AGUSTUS
SULAWESI BARAT,MAMASA,MEHALAAN,MEHALAAN,39,16,2,2,1,0,0,0,2,0,2,0,6,1,5,1,15,15,0,7,3,2,1,0,0,0,0,0,AGUSTUS
SULAWESI BARAT,MAMASA,MEHALAAN,BOTTENG,60,56,14,3,1,1,0,3,7,2,11,0,8,0,8,0,46,15,31,6,25,16,9,11,57,56,1,56,AGUSTUS
SULAWESI BARAT,MAMASA,MEHALAAN,SALUKONTA,81,39,20,10,4,2,1,1,4,5,20,0,14,4,10,0,28,9,19,6,3,1,2,1,18,9,9,4,AGUSTUS
SULAWESI BARAT,MAMASA,MEHALAAN,MESAKADA,57,13,10,5,1,0,0,0,4,1,2,7,10,6,4,5,10,7,3,6,5,3,2,3,0,0,0,0,AGUSTUS
SULAWESI BARAT,MAMASA,MEHALAAN,MEHALAAN BARAT,58,71,7,2,2,0,0,7,0,0,1,5,2,2,0,0,70,53,17,24,0,0,0,0,36,8,28,30,AGUSTUS
SULAWESI BARAT,MAMASA,MEHALAAN,SALUAHOK,50,79,42,39,21,9,9,32,1,0,37,1,5,3,2,2,49,29,20,0,23,8,15,1,25,22,3,16,AGUSTUS
SULAWESI BARAT,MAMASA,MEHALAAN,SALUBALO,39,66,12,10,5,1,1,2,8,0,5,1,0,0,0,0,65,65,0,52,60,16,44,16,9,8,1,3,AGUSTUS
SULAWESI BARAT,MAMASA,MEHALAAN,PASSEMBUK,64,25,12,3,3,2,2,0,8,2,10,0,1,0,1,0,15,8,7,6,10,1,9,1,23,16,7,8,AGUSTUS
SULAWESI BARAT,MAMASA,MEHALAAN,KONDO,62,47,0,0,0,0,0,0,0,0,0,0,10,2,8,2,31,20,11,15,9,4,5,1,24,2,22,20,AGUSTUS
SULAWESI BARAT,MAMASA,MEHALAAN,LEKO SUKAMAJU,90,29,1,0,0,0,0,0,1,0,0,1,12,9,3,7,22,7,15,3,4,0,4,0,9,4,5,9,AGUSTUS
SULAWESI BARAT,MAMASA,MEHALAAN,ULUMEA,77,75,24,22,5,3,0,6,10,2,2,3,14,1,13,1,70,30,40,1,35,30,5,6,52,50,2,25,AGUSTUS
SULAWESI BARAT,MAMASA,MESSAWA,MESSAWA,71,10,5,0,0,0,0,0,5,0,2,0,9,0,9,0,10,8,2,4,9,4,5,0,9,6,3,0,AGUSTUS
SULAWESI BARAT,MAMASA,MESSAWA,RIPPUNG,52,41,15,1,0,0,0,11,2,0,15,0,2,1,1,1,15,15,0,10,12,1,11,0,14,7,7,0,AGUSTUS
SULAWESI BARAT,MAMASA,MESSAWA,MAKUANG,50,33,29,20,13,0,0,7,0,17,10,15,2,1,1,1,30,23,7,5,2,0,2,0,23,20,3,15,AGUSTUS
SULAWESI BARAT,MAMASA,MESSAWA,SEPANG,66,22,14,0,0,0,0,1,13,0,13,1,8,2,6,0,12,12,0,0,5,5,0,0,15,2,13,14,AGUSTUS
SULAWESI BARAT,MAMASA,MESSAWA,MALIMBONG,52,53,26,26,4,4,3,22,0,0,3,11,3,2,1,2,18,18,0,7,5,2,3,2,25,1,24,8,AGUSTUS
SULAWESI BARAT,MAMASA,MESSAWA,MATANDE,72,45,10,8,4,4,2,8,0,0,1,7,0,0,0,0,36,29,7,15,22,12,10,2,14,12,2,8,AGUSTUS
SULAWESI BARAT,MAMASA,MESSAWA,SIPAI,60,16,10,6,6,4,2,5,3,0,7,3,0,0,0,0,13,5,8,2,3,3,0,1,7,3,4,1,AGUSTUS
SULAWESI BARAT,MAMASA,MESSAWA,PASMA MAMBU,40,68,64,44,31,14,6,45,13,0,27,29,1,0,1,0,45,7,38,6,9,6,3,5,19,3,16,17,AGUSTUS
SULAWESI BARAT,MAMASA,MESSAWA,TANETE BATU,61,47,6,4,4,3,2,4,0,0,2,0,7,2,5,2,43,29,14,12,4,2,2,0,29,2,27,16,AGUSTUS
SULAWESI BARAT,MAMASA,NOSU,NOSU,31,44,29,19,15,6,1,15,3,8,14,15,0,0,0,0,41,39,2,11,3,1,2,1,14,6,8,7,AGUSTUS
SULAWESI BARAT,MAMASA,NOSU,MINANGA,65,12,6,6,2,0,0,1,5,0,5,0,10,6,4,5,12,9,3,0,1,1,0,0,8,2,6,8,AGUSTUS
SULAWESI BARAT,MAMASA,NOSU,BATUPAPAN,42,14,13,4,3,2,0,13,0,0,1,3,3,2,1,2,12,6,6,5,5,1,4,0,11,2,9,6,AGUSTUS
SULAWESI BARAT,MAMASA,NOSU,MASEWWE,61,22,20,10,9,3,2,6,6,6,3,11,0,0,0,0,17,9,8,2,1,1,0,1,15,0,15,2,AGUSTUS
SULAWESI BARAT,MAMASA,NOSU,SIWI,49,40,11,5,0,0,0,1,1,4,11,0,4,0,4,0,19,14,5,11,16,7,9,2,9,8,1,8,AGUSTUS
SULAWESI BARAT,MAMASA,NOSU,MINANGA TIMUR,86,26,22,7,5,4,3,19,0,0,2,0,10,10,0,9,18,6,12,0,13,5,8,3,6,3,3,0,AGUSTUS
SULAWESI BARAT,MAMASA,NOSU,PARINDING,62,65,2,0,0,0,0,0,2,0,1,0,2,1,1,0,65,26,39,8,49,45,4,15,24,5,19,16,AGUSTUS
SULAWESI BARAT,MAMASA,PANA,PANA,85,11,9,9,0,0,0,0,8,0,4,0,15,12,3,0,11,9,2,5,11,11,0,3,3,2,1,2,AGUSTUS
SULAWESI BARAT,MAMASA,PANA,MANIPI,73,21,15,2,0,0,0,14,0,1,13,1,1,0,1,0,11,7,4,1,3,1,2,1,14,13,1,3,AGUSTUS
SULAWESI BARAT,MAMASA,PANA,MAMULLU,76,21,5,5,4,4,3,1,0,1,1,4,1,1,0,1,11,10,1,5,4,1,3,0,6,5,1,4,AGUSTUS
SULAWESI BARAT,MAMASA,PANA,SAPAN,84,11,1,0,0,0,0,0,0,1,0,0,12,8,4,3,11,5,6,2,3,0,3,0,9,6,3,4,AGUSTUS
SULAWESI BARAT,MAMASA,PANA,DATUBARINGAN,32,79,6,1,1,0,0,0,0,2,1,3,5,2,3,2,79,71,8,11,40,20,20,11,36,35,1,18,AGUSTUS
SULAWESI BARAT,MAMASA,PANA,PANURA,86,32,19,14,2,0,0,2,15,2,12,4,9,4,5,2,26,20,6,15,26,0,26,0,16,11,5,0,AGUSTUS
SULAWESI BARAT,MAMASA,PANA,TALLANG BULAWAN,69,43,29,24,12,6,1,24,3,0,17,1,6,0,6,0,21,18,3,13,10,3,7,2,5,2,3,4,AGUSTUS
SULAWESI BARAT,MAMASA,PANA,KARAKA,84,63,33,21,11,11,5,22,0,6,14,2,7,3,4,1,50,27,23,4,14,10,4,0,44,25,19,22,AGUSTUS
SULAWESI BARAT,MAMASA,PANA,ULUSALU,44,65,40,10,4,4,0,6,25,7,20,20,2,0,2,0,33,22,11,17,8,3,5,3,34,13,21,33,AGUSTUS
SULAWESI BARAT,MAMASA,PANA,WERI,80,23,11,4,4,0,0,9,1,1,6,1,13,13,0,3,20,18,2,4,1,1,0,1,2,1,1,2,AGUSTUS
SULAWESI BARAT,MAMASA,PANA,SALUTAMBUN,73,47,1,0,0,0,0,1,0,0,1,0,8,1,7,0,34,17,17,13,25,21,4,7,18,3,15,4,AGUSTUS
SULAWESI BARAT,MAMASA,PANA,SALOAN,98,51,47,40,35,6,4,42,1,0,24,22,16,8,8,1,39,7,32,6,11,7,4,7,31,2,29,26,AGUSTUS
SULAWESI BARAT,MAMASA,PANA,ULUSALU INDAH,54,46,40,17,4,2,0,14,14,10,16,24,0,0,0,0,27,13,14,10,4,0,4,0,17,12,5,7,AGUSTUS
SULAWESI BARAT,MAMASA,RANTEBULAHAN TIMUR,SALUMOKANAN,33,47,41,18,7,6,5,11,20,3,2,30,6,0,6,0,15,7,8,6,7,6,1,1,35,7,28,34,AGUSTUS
SULAWESI BARAT,MAMASA,RANTEBULAHAN TIMUR,SALUMOKANAN BARAT,84,36,20,19,16,7,4,0,2,10,11,1,12,0,12,0,17,14,3,3,12,0,12,0,35,13,22,30,AGUSTUS
SULAWESI BARAT,MAMASA,RANTEBULAHAN TIMUR,BUANGIN,98,13,2,1,0,0,0,1,1,0,2,0,14,11,3,3,11,5,6,3,6,6,0,2,13,3,10,8,AGUSTUS
SULAWESI BARAT,MAMASA,RANTEBULAHAN TIMUR,BAMBANG BUDA,37,19,11,5,1,1,1,7,1,2,2,3,2,2,0,0,13,8,5,4,0,0,0,0,1,1,0,0,AGUSTUS
SULAWESI BARAT,MAMASA,RANTEBULAHAN TIMUR,LEKO,44,33,21,12,2,2,0,7,4,10,4,16,2,1,1,1,18,8,10,0,12,2,10,0,2,0,2,1,AGUSTUS
SULAWESI BARAT,MAMASA,RANTEBULAHAN TIMUR,KIRAK,68,18,0,0,0,0,0,0,0,0,0,0,12,9,3,3,14,7,7,0,9,2,7,1,6,1,5,5,AGUSTUS
SULAWESI BARAT,MAMASA,RANTEBULAHAN TIMUR,SALUMOKANAN UTARA,97,30,10,3,3,1,1,5,3,1,7,2,5,3,2,2,12,5,7,5,7,6,1,0,4,4,0,1,AGUSTUS
SULAWESI BARAT,MAMASA,RANTEBULAHAN TIMUR,SAMPALE,82,72,21,5,1,0,0,20,1,0,12,8,10,10,0,10,16,9,7,7,6,3,3,2,12,4,8,9,AGUSTUS
SULAWESI BARAT,MAMASA,SESENAPADANG,OROBUA,97,64,46,37,28,15,5,31,3,5,42,2,8,2,6,2,64,60,4,59,21,3,18,0,14,5,9,12,AGUSTUS
SULAWESI BARAT,MAMASA,SESENAPADANG,PALADAN,82,38,6,6,1,0,0,3,3,0,5,1,16,3,13,3,27,17,10,4,25,12,13,7,43,10,33,1,AGUSTUS
SULAWESI BARAT,MAMASA,SESENAPADANG,OROBUA TIMUR,100,29,9,8,0,0,0,8,1,0,3,4,5,1,4,0,29,12,17,7,1,0,1,0,13,10,3,3,AGUSTUS
SULAWESI BARAT,MAMASA,SESENAPADANG,RANTE PUANG,48,33,31,26,7,3,1,27,0,1,9,13,4,3,1,2,24,13,11,10,22,12,10,2,39,6,33,39,AGUSTUS
SULAWESI BARAT,MAMASA,SESENAPADANG,SATENETEAN,67,21,11,6,4,1,0,2,7,1,2,3,6,3,3,3,17,5,12,3,0,0,0,0,8,1,7,6,AGUSTUS
SULAWESI BARAT,MAMASA,SESENAPADANG,LISUAN ADA,97,17,5,3,2,1,0,2,2,1,3,2,5,0,5,0,13,10,3,9,3,1,2,0,9,0,9,8,AGUSTUS
SULAWESI BARAT,MAMASA,SESENAPADANG,OROBUA SELATAN,78,48,30,11,11,4,2,26,2,0,20,2,1,1,0,1,11,11,0,10,7,0,7,0,24,15,9,3,AGUSTUS
SULAWESI BARAT,MAMASA,SESENAPADANG,MALANGKENA PADANG,50,50,42,23,19,3,3,39,0,0,16,17,1,1,0,0,16,6,10,5,8,2,6,0,23,11,12,16,AGUSTUS
SULAWESI BARAT,MAMASA,SESENAPADANG,MALIMBONG,81,58,56,55,16,1,1,43,7,3,44,8,5,4,1,1,14,9,5,1,4,1,3,1,28,3,25,19,AGUSTUS
SULAWESI BARAT,MAMASA,SESENAPADANG,MARAMPAN OROBUA,38,34,33,1,1,0,0,29,4,0,16,7,3,2,1,1,34,34,0,32,17,7,10,0,36,12,24,6,AGUSTUS
SULAWESI BARAT,MAMASA,SUMARORONG,SUMARORONG,86,50,21,12,11,2,2,16,2,0,5,12,1,0,1,0,43,42,1,40,32,29,3,14,22,15,7,8,AGUSTUS
SULAWESI BARAT,MAMASA,SUMARORONG,TABONE,92,34,19,7,5,5,3,15,1,0,6,3,12,5,7,1,22,14,8,8,3,0,3,0,17,3,14,12,AGUSTUS
SULAWESI BARAT,MAMASA,SUMARORONG,BATANG URU,54,71,32,27,24,15,9,6,15,2,7,13,7,3,4,0,25,12,13,11,17,12,5,6,19,0,19,2,AGUSTUS
SULAWESI BARAT,MAMASA,SUMARORONG,SASAKAN,91,47,13,9,9,3,2,6,2,2,11,1,2,0,2,0,39,9,30,1,31,23,8,23,48,33,15,11,AGUSTUS
SULAWESI BARAT,MAMASA,SUMARORONG,TADISI,86,39,11,5,2,1,0,3,8,0,6,4,10,0,10,0,12,9,3,7,6,1,5,0,18,6,12,18,AGUSTUS
SULAWESI BARAT,MAMASA,SUMARORONG,SIBANAWA,73,12,0,0,0,0,0,0,0,0,0,0,9,0,9,0,12,9,3,0,2,1,1,0,5,0,5,1,AGUSTUS
SULAWESI BARAT,MAMASA,SUMARORONG,BATANGNGURU TIMUR,69,17,7,1,1,0,0,3,0,3,3,2,0,0,0,0,14,8,6,4,3,3,0,1,0,0,0,0,AGUSTUS
SULAWESI BARAT,MAMASA,SUMARORONG,SALUBALO,89,10,5,2,2,2,0,0,2,2,5,0,6,2,4,2,10,8,2,8,7,7,0,4,13,10,3,4,AGUSTUS
SULAWESI BARAT,MAMASA,SUMARORONG,BANEA,42,47,45,45,2,1,1,31,8,0,40,0,2,2,0,1,12,8,4,0,5,5,0,4,28,25,3,4,AGUSTUS
SULAWESI BARAT,MAMASA,SUMARORONG,RANTE KAMASE,57,32,19,16,7,4,1,9,5,0,0,0,5,5,0,4,32,23,9,19,30,21,9,18,29,8,21,17,AGUSTUS
SULAWESI BARAT,MAMASA,TABANG,TABANG,89,69,53,37,13,12,0,1,15,17,33,20,7,7,0,4,48,40,8,39,36,0,36,0,2,1,1,1,AGUSTUS
SULAWESI BARAT,MAMASA,TABANG,TADOKALUA,72,78,65,55,9,5,1,60,1,0,44,12,0,0,0,0,65,61,4,56,29,26,3,16,81,15,66,42,AGUSTUS
SULAWESI BARAT,MAMASA,TABANG,TABANG BARAT,31,41,21,20,7,0,0,0,11,2,14,7,2,1,1,1,16,9,7,7,4,2,2,1,11,5,6,2,AGUSTUS
SULAWESI BARAT,MAMASA,TABANG,MASUPU,76,80,6,5,3,1,1,4,0,1,1,0,9,9,0,1,64,5,59,5,8,0,8,0,32,15,17,23,AGUSTUS
SULAWESI BARAT,MAMASA,TABANG,KALAMA,57,64,61,2,2,2,2,54,5,0,0,54,2,1,1,1,57,16,41,13,24,7,17,6,68,45,23,26,AGUSTUS
SULAWESI BARAT,MAMASA,TABANG,BAKADISURA,30,24,17,10,7,6,2,13,1,1,2,8,2,1,1,1,14,8,6,7,8,1,7,0,0,0,0,0,AGUSTUS
SULAWESI BARAT,MAMASA,TABANG,SALUKONA,41,80,9,4,0,0,0,1,3,0,1,7,6,6,0,2,13,8,5,2,7,6,1,0,27,16,11,7,AGUSTUS
SULAWESI BARAT,MAMASA,TABULAHAN,LAKAHANG,46,46,17,16,2,1,0,8,2,0,4,8,6,6,0,1,30,8,22,1,5,5,0,3,27,25,2,4,AGUSTUS
SULAWESI BARAT,MAMASA,TABULAHAN,PERIANGAN,100,29,7,2,2,2,1,5,0,1,4,0,10,5,5,5,17,15,2,2,3,2,1,1,18,17,1,0,AGUSTUS
SULAWESI BARAT,MAMASA,TABULAHAN,MALATIRO,81,18,9,8,3,2,1,2,3,0,8,0,15,10,5,1,17,11,6,5,12,4,8,4,21,10,11,9,AGUSTUS
SULAWESI BARAT,MAMASA,TABULAHAN,TABULAHAN,71,19,15,8,8,7,2,10,0,3,9,2,13,3,10,2,15,11,4,5,4,1,3,1,6,6,0,4,AGUSTUS
SULAWESI BARAT,MAMASA,TABULAHAN,SALULEANG,60,24,0,0,0,0,0,0,0,0,0,0,4,2,2,0,21,21,0,6,8,0,8,0,4,4,0,1,AGUSTUS
SULAWESI BARAT,MAMASA,TABULAHAN,TAMPAK KURRA,93,62,21,4,1,1,1,18,0,0,6,3,14,5,9,5,10,8,2,5,4,3,1,2,27,12,15,8,AGUSTUS
SULAWESI BARAT,MAMASA,TABULAHAN,GANDANG DEWATA,51,28,4,1,1,1,0,2,0,2,0,4,6,5,1,2,27,26,1,0,12,0,12,0,14,14,0,7,AGUSTUS
SULAWESI BARAT,MAMASA,TABULAHAN,BURANA,91,38,24,14,3,2,2,21,0,0,15,8,3,2,1,1,25,16,9,5,9,1,8,1,30,19,11,7,AGUSTUS
SULAWESI BARAT,MAMASA,TABULAHAN,SALUBAKKA,49,65,41,10,2,2,0,41,0,0,31,6,4,2,2,2,56,43,13,42,56,39,17,17,91,82,9,84,AGUSTUS
SULAWESI BARAT,MAMASA,TABULAHAN,PANGANDARAN,74,23,12,8,0,0,0,8,2,1,2,9,12,3,9,1,22,11,11,1,3,3,0,3,11,0,11,1,AGUSTUS
SULAWESI BARAT,MAMASA,TABULAHAN,TALOPAK,53,76,43,41,36,25,19,9,13,0,22,10,7,4,3,2,69,66,3,23,0,0,0,0,26,8,18,11,AGUSTUS
SULAWESI BARAT,MAMASA,TABULAHAN,PEU',82,42,3,3,1,0,0,3,0,0,2,1,6,4,2,3,33,25,8,23,14,2,12,0,2,2,0,2,AGUSTUS
SULAWESI BARAT,MAMASA,TABULAHAN,TIMORO,93,32,8,0,0,0,0,6,1,1,0,6,11,8,3,4,18,10,8,3,11,8,3,6,8,2,6,3,AGUSTUS
SULAWESI BARAT,MAMASA,TABULAHAN,LAKAHANG UTAMA,99,31,27,7,4,4,3,2,13,2,24,1,18,9,9,3,12,11,1,5,12,8,4,6,5,4,1,1,AGUSTUS
SULAWESI BARAT,MAMASA,TANDUK KALUA,MINAKE,37,55,50,38,27,21,21,17,0,1,8,39,5,3,2,1,38,23,15,6,5,4,1,4,18,13,5,10,AGUSTUS
SULAWESI BARAT,MAMASA,TANDUK KALUA,MALABO,87,32,0,0,0,0,0,0,0,0,0,0,4,1,3,1,29,18,11,17,7,6,1,2,20,7,13,9,AGUSTUS
SULAWESI BARAT,MAMASA,TANDUK KALUA,SINDAGAMANIK,96,13,3,0,0,0,0,1,2,0,3,0,11,1,10,0,12,11,1,0,9,0,9,0,4,4,0,1,AGUSTUS
SULAWESI BARAT,MAMASA,TANDUK KALUA,PARONDOBULAWAN,33,48,2,2,0,0,0,2,0,0,2,0,6,3,3,1,48,27,21,5,14,4,10,4,22,4,18,11,AGUSTUS
SULAWESI BARAT,MAMASA,TANDUK KALUA,TAMALANTIK,79,59,23,0,0,0,0,6,11,2,4,16,2,2,0,2,55,39,16,12,26,21,5,18,50,43,7,23,AGUSTUS
SULAWESI BARAT,MAMASA,TANDUK KALUA,MANNABABA,64,72,13,9,5,1,0,2,4,3,11,0,12,11,1,9,64,59,5,37,23,3,20,0,49,9,40,16,AGUSTUS
SULAWESI BARAT,MAMASA,TANDUK KALUA,MESAKADA,79,70,19,17,16,12,8,9,1,1,17,2,8,2,6,2,28,14,14,9,11,6,5,1,40,5,35,1,AGUSTUS
SULAWESI BARAT,MAMASA,TANDUK KALUA,BALLABATU,54,65,59,4,1,0,0,48,8,3,58,0,6,5,1,0,25,12,13,9,24,24,0,16,9,4,5,4,AGUSTUS
SULAWESI BARAT,MAMASA,TANDUK KALUA,PAMBE,73,50,22,7,0,0,0,22,0,0,3,10,12,0,12,0,25,16,9,15,14,10,4,0,11,5,6,10,AGUSTUS
SULAWESI BARAT,MAMASA,TANDUK KALUA,SALURANO,41,50,9,3,2,0,0,1,3,3,3,5,5,5,0,4,16,10,6,0,12,1,11,1,14,14,0,11,AGUSTUS
SULAWESI BARAT,MAMASA,TANDUK KALUA,TALIMBUNG,96,33,9,2,0,0,0,4,5,0,6,3,10,0,10,0,22,16,6,4,11,9,2,4,14,13,1,9,AGUSTUS
SULAWESI BARAT,MAMASA,TANDUK KALUA,KANAN,60,13,4,3,0,0,0,3,0,0,2,0,1,0,1,0,10,8,2,1,2,2,0,0,3,1,2,3,AGUSTUS
SULAWESI BARAT,MAMASA,TAWALIAN,TAWALIAN,96,32,32,21,17,7,1,30,0,0,21,6,19,0,19,0,20,16,4,16,11,6,5,3,24,8,16,3,AGUSTUS
SULAWESI BARAT,MAMASA,TAWALIAN,TAWALIAN TIMUR,45,46,6,2,1,1,0,2,2,1,6,0,8,6,2,1,45,23,22,20,31,26,5,6,44,21,23,9,AGUSTUS
SULAWESI BARAT,MAMASA,TAWALIAN,KARIANGO,58,45,23,0,0,0,0,12,0,5,14,1,6,4,2,4,27,13,14,4,5,1,4,0,31,19,12,13,AGUSTUS
SULAWESI BARAT,MAMASA,TAWALIAN,RANTETANGNGA,97,50,8,4,0,0,0,5,2,1,3,3,2,1,1,0,34,25,9,6,11,7,4,5,40,0,40,30,AGUSTUS
SULAWESI BARAT,POLEWALI MANDAR,ALLU,PETOOSANG,70,46,14,4,4,3,2,5,5,2,6,4,2,0,2,0,26,25,1,25,20,9,11,7,48,9,39,48,AGUSTUS
SULAWESI BARAT,POLEWALI MANDAR,ALLU,MOMBI,62,74,24,21,18,8,7,5,12,0,24,0,4,1,3,0,55,17,38,16,10,7,3,1,11,10,1,10,AGUSTUS
SULAWESI BARAT,POLEWALI MANDAR,ALLU,KALUMAMMANG,41,25,9,0,0,0,0,3,6,0,0,3,2,0,2,0,11,10,1,5,8,3,5,2,2,2,0,0,AGUSTUS
SULAWESI BARAT,POLEWALI MANDAR,ALLU,PAO-PAO,65,41,16,13,12,11,8,3,3,0,1,10,5,4,1,2,21,16,5,4,3,0,3,0,0,0,0,0,AGUSTUS
SULAWESI BARAT,POLEWALI MANDAR,ALLU,PUPPU URING,32,61,58,14,0,0,0,33,14,2,50,6,1,0,1,0,33,31,2,10,23,12,11,2,5,3,2,4,AGUSTUS
SULAWESI BARAT,POLEWALI MANDAR,ALLU,SARAGIAN,83,32,15,0,0,0,0,4,9,2,8,2,15,15,0,7,23,19,4,8,14,14,0,5,23,17,6,6,AGUSTUS
SULAWESI BARAT,POLEWALI MANDAR,ALLU,SAYOANG,44,28,13,6,0,0,0,11,0,0,9,3,8,7,1,3,25,14,11,1,6,0,6,0,25,5,20,22,AGUSTUS
SULAWESI BARAT,POLEWALI MANDAR,ALLU,ALU,46,42,35,19,1,1,1,20,5,8,21,13,4,3,1,1,39,24,15,0,22,13,9,0,32,1,31,15,AGUSTUS
SULAWESI BARAT,POLEWALI MANDAR,ANREAPI,ANREAPI,53,80,70,45,19,9,6,22,29,4,35,1,10,9,1,6,71,60,11,28,0,0,0,0,53,6,47,29,AGUSTUS
SULAWESI BARAT,POLEWALI MANDAR,ANREAPI,DUAMPANUA,83,19,13,5,3,3,3,8,1,0,13,0,11,2,9,1,19,18,1,7,18,13,5,6,14,5,9,1,AGUSTUS
SULAWESI BARAT,POLEWALI MANDAR,ANREAPI,KELAPA DUA,59,70,70,60,23,13,8,34,14,13,70,0,5,2,3,0,23,20,3,9,22,22,0,13,62,32,30,58,AGUSTUS
SULAWESI BARAT,POLEWALI MANDAR,ANREAPI,PAPPANDANGAN,37,67,31,26,17,17,1,8,1,17,6,5,5,4,1,2,44,26,18,21,39,20,19,3,67,4,63,4,AGUSTUS
SULAWESI BARAT,POLEWALI MANDAR,ANREAPI,KUNYI,82,80,77,31,8,2,0,28,18,6,38,14,2,0,2,0,42,32,10,17,20,3,17,3,21,11,10,4,AGUSTUS
SULAWESI BARAT,POLEWALI MANDAR,BALANIPA,BALANIPA,38,67,48,17,11,3,1,22,12,12,6,32,0,0,0,0,59,40,19,39,13,12,1,1,9,4,5,2,AGUSTUS
SULAWESI BARAT,POLEWALI MANDAR,BALANIPA,TAMMAJARRA,66,19,13,0,0,0,0,1,4,3,12,0,4,4,0,0,11,7,4,1,5,0,5,0,4,0,4,4,AGUSTUS
SULAWESI BARAT,POLEWALI MANDAR,BALANIPA,TAMANGGALLE,83,74,70,68,30,7,3,41,9,10,64,0,6,5,1,2,42,24,18,6,20,6,14,1,56,53,3,5,AGUSTUS
SULAWESI BARAT,POLEWALI MANDAR,BALANIPA,MOSSO,74,28,25,9,2,0,0,10,10,1,3,11,14,3,11,3,28,16,12,2,19,18,1,5,32,4,28,1,AGUSTUS
SULAWESI BARAT,POLEWALI MANDAR,BALANIPA,GALUNG TULUK,40,35,24,22,9,6,1,20,1,2,15,5,2,2,0,1,31,15,16,5,12,7,5,1,23,8,15,23,AGUSTUS
SULAWESI BARAT,POLEWALI MANDAR,BALANIPA,SABANG SUBIK,76,66,12,12,2,0,0,5,0,4,6,2,3,2,1,0,63,17,46,11,5,5,0,4,9,7,2,2,AGUSTUS
SULAWESI BARAT,POLEWALI MANDAR,BALANIPA,PAMBUSUANG,75,40,14,9,1,0,0,8,3,2,11,1,6,3,3,2,26,24,2,18,0,0,0,0,25,9,16,11,AGUSTUS
SULAWESI BARAT,POLEWALI MANDAR,BALANIPA,BALA,98,53,39,10,0,0,0,0,22,13,22,7,16,3,13,0,47,22,25,22,32,10,22,1,41,3,38,16,AGUSTUS
SULAWESI BARAT,POLEWALI MANDAR,BALANIPA,LAMBANAN,79,33,8,4,1,0,0,7,0,1,6,0,14,3,11,3,15,5,10,4,12,6,6,5,34,6,28,21,AGUSTUS
SULAWESI BARAT,POLEWALI MANDAR,BALANIPA,LEGO,89,36,23,23,2,0,0,11,1,0,9,9,0,0,0,0,26,19,7,17,11,7,4,6,33,14,19,28,AGUSTUS
SULAWESI BARAT,POLEWALI MANDAR,BALANIPA,PALLIS,59,76,13,1,1,1,0,10,1,1,13,0,1,0,1,0,62,32,30,27,13,8,5,4,11,10,1,0,AGUSTUS
SULAWESI BARAT,POLEWALI MANDAR,BINUANG,AMASSANGAN,93,44,31,9,1,1,1,3,0,4,29,1,6,4,2,2,18,5,13,2,4,0,4,0,29,11,18,9,AGUSTUS
SULAWESI BARAT,POLEWALI MANDAR,BINUANG,TONYAMAN,50,38,9,1,0,0,0,9,0,0,0,6,10,0,10,0,30,8,22,8,12,0,12,0,37,8,29,19,AGUSTUS
SULAWESI BARAT,POLEWALI MANDAR,BINUANG,KUAJANG,43,48,24,8,6,1,1,1,21,1,11,8,8,4,4,3,32,29,3,16,29,24,5,20,54,51,3,34,AGUSTUS
SULAWESI BARAT,POLEWALI MANDAR,BINUANG,PAKU,56,27,14,8,3,2,2,6,0,1,11,1,5,0,5,0,15,11,4,11,5,3,2,2,7,7,0,4,AGUSTUS
SULAWESI BARAT,POLEWALI MANDAR,BINUANG,MIRRING,70,31,28,9,3,1,1,0,23,3,16,6,7,7,0,7,10,9,1,1,1,1,0,1,7,3,4,2,AGUSTUS
SULAWESI BARAT,POLEWALI MANDAR,BINUANG,BATETANGNGA,35,11,3,1,0,0,0,0,0,3,0,1,1,1,0,0,11,8,3,7,4,2,2,0,3,1,2,1,AGUSTUS
SULAWESI BARAT,POLEWALI MANDAR,BINUANG,MAMMI,80,52,47,38,2,1,1,27,6,0,43,0,15,14,1,5,26,25,1,14,23,1,22,0,44,31,13,34,AGUSTUS
SULAWESI BARAT,POLEWALI MANDAR,BINUANG,KALEOK,55,57,14,3,1,0,0,3,5,2,13,1,8,3,5,0,47,34,13,29,12,1,11,0,33,1,32,0,AGUSTUS
SULAWESI BARAT,POLEWALI MANDAR,BINUANG,AMOLA,55,64,5,1,1,1,1,0,1,2,1,4,6,1,5,1,43,35,8,24,22,15,7,15,1,0,1,1,AGUSTUS
SULAWESI BARAT,POLEWALI MANDAR,BINUANG,REA,40,71,23,4,3,1,1,2,17,3,11,9,6,2,4,2,45,9,36,7,36,21,15,18,75,8,67,64,AGUSTUS
SULAWESI BARAT,POLEWALI MANDAR,BULO,BULO,30,27,14,8,0,0,0,10,2,1,1,12,6,0,6,0,27,7,20,6,26,8,18,3,30,5,25,1,AGUSTUS
SULAWESI BARAT,POLEWALI MANDAR,BULO,PULLIWA,51,70,66,23,17,12,3,41,13,6,30,10,10,2,8,2,48,10,38,10,37,22,15,15,77,18,59,6,AGUSTUS
SULAWESI BARAT,POLEWALI MANDAR,BULO,PATAMBANUA,100,71,32,12,10,5,0,29,2,1,5,6,20,19,1,2,21,18,3,13,21,1,20,1,16,14,2,11,AGUSTUS
SULAWESI BARAT,POLEWALI MANDAR,BULO,KAROMBANG,67,16,1,0,0,0,0,0,1,0,1,0,0,0,0,0,14,8,6,0,4,2,2,1,2,2,0,2,AGUSTUS
SULAWESI BARAT,POLEWALI MANDAR,BULO,DAALA TIMUR,93,13,6,2,0,0,0,1,2,0,4,0,5,1,4,1,13,8,5,4,5,0,5,0,2,2,0,2,AGUSTUS
SULAWESI BARAT,POLEWALI MANDAR,BULO,LENGGO,58,74,1,1,1,0,0,0,0,1,1,0,6,1,5,1,28,22,6,5,16,4,12,2,12,11,1,1,AGUSTUS
SULAWESI BARAT,POLEWALI MANDAR,BULO,SABURA,100,77,52,17,4,3,2,47,0,0,5,14,9,5,4,0,46,45,1,5,25,21,4,2,3,1,2,3,AGUSTUS
SULAWESI BARAT,POLEWALI MANDAR,BULO,SEPPORRAKI,53,34,17,3,3,3,2,13,1,0,4,3,6,1,5,1,12,6,6,5,0,0,0,0,9,4,5,8,AGUSTUS
SULAWESI BARAT,POLEWALI MANDAR,BULO,IHING,92,14,14,5,5,3,3,11,0,0,12,1,16,0,16,0,13,8,5,7,11,10,1,9,5,0,5,3,AGUSTUS
SULAWESI BARAT,POLEWALI MANDAR,CAMPALAGIAN,PAPPANG,38,60,60,1,0,0,0,38,20,2,52,4,6,6,0,0,18,17,1,17,2,1,1,1,43,0,43,25,AGUSTUS
SULAWESI BARAT,POLEWALI MANDAR,CAMPALAGIAN,LALIKO,87,25,12,9,5,4,4,2,4,0,6,2,2,1,1,0,17,12,5,3,10,6,4,2,12,7,5,12,AGUSTUS
SULAWESI BARAT,POLEWALI MANDAR,CAMPALAGIAN,BONDE,75,71,55,20,11,4,4,49,1,0,5,49,2,0,2,0,66,12,54,0,60,35,25,12,97,28,69,62,AGUSTUS
SULAWESI BARAT,POLEWALI MANDAR,CAMPALAGIAN,KATUMBANGAN LEMO,82,11,5,0,0,0,0,3,1,1,4,1,2,2,0,2,11,5,6,0,3,0,3,0,6,6,0,1,AGUSTUS
SULAWESI BARAT,POLEWALI MANDAR,CAMPALAGIAN,PANYAMPA,61,18,15,7,2,2,1,6,0,2,14,1,0,0,0,0,18,7,11,3,5,5,0,5,0,0,0,0,AGUSTUS
SULAWESI BARAT,POLEWALI MANDAR,CAMPALAGIAN,SURUANG,43,17,14,10,2,0,0,8,6,0,8,1,1,0,1,0,17,10,7,10,8,3,5,0,19,9,10,7,AGUSTUS
SULAWESI BARAT,POLEWALI MANDAR,CAMPALAGIAN,LAMPOKO,76,45,13,10,2,1,1,2,0,3,0,6,9,5,4,2,23,15,8,7,5,0,5,0,33,4,29,15,AGUSTUS
SULAWESI BARAT,POLEWALI MANDAR,CAMPALAGIAN,KATUMBANGAN,56,31,29,4,4,2,1,15,1,8,12,9,7,2,5,2,18,10,8,1,4,2,2,0,23,0,23,21,AGUSTUS
SULAWESI BARAT,POLEWALI MANDAR,CAMPALAGIAN,LAPEO,37,70,1,0,0,0,0,1,0,0,1,0,4,1,3,1,49,21,28,1,43,13,30,3,77,74,3,17,AGUSTUS
SULAWESI BARAT,POLEWALI MANDAR,CAMPALAGIAN,PARAPPE,57,64,31,4,1,0,0,21,1,1,29,0,9,1,8,1,11,6,5,1,0,0,0,0,8,4,4,5,AGUSTUS
SULAWESI BARAT,POLEWALI MANDAR,CAMPALAGIAN,ONGKO,32,66,23,13,3,1,0,21,1,0,16,7,6,5,1,2,46,14,32,8,16,14,2,8,33,26,7,18,AGUSTUS
SULAWESI BARAT,POLEWALI MANDAR,CAMPALAGIAN,KENJE,74,19,19,2,1,0,0,3,8,7,8,1,12,4,8,4,13,10,3,9,10,1,9,1,0,0,0,0,AGUSTUS
SULAWESI BARAT,POLEWALI MANDAR,CAMPALAGIAN,SUMARRANG,49,55,31,29,27,17,6,20,0,0,26,3,4,0,4,0,45,27,18,6,11,11,0,6,31,11,20,16,AGUSTUS
SULAWESI BARAT,POLEWALI MANDAR,CAMPALAGIAN,BOTTO,83,30,11,0,0,0,0,10,0,0,7,0,5,0,5,0,14,9,5,5,13,4,9,2,29,7,22,20,AGUSTUS
SULAWESI BARAT,POLEWALI MANDAR,CAMPALAGIAN,GATTUNGAN,72,34,1,0,0,0,0,0,0,0,1,0,5,5,0,3,14,9,5,3,4,3,1,0,1,0,1,1,AGUSTUS
SULAWESI BARAT,POLEWALI MANDAR,CAMPALAGIAN,PADANG TIMUR,70,14,5,5,0,0,0,4,1,0,2,3,7,5,2,1,10,6,4,2,3,0,3,0,5,4,1,2,AGUSTUS
SULAWESI BARAT,POLEWALI MANDAR,CAMPALAGIAN,PADANG,57,39,9,0,0,0,0,5,3,0,0,6,11,11,0,6,11,9,2,1,9,7,2,2,22,10,12,21,AGUSTUS
SULAWESI BARAT,POLEWALI MANDAR,CAMPALAGIAN,LAGI-AGI,32,27,16,5,0,0,0,14,1,1,0,14,4,4,0,1,17,5,12,5,6,3,3,1,6,5,1,3,AGUSTUS
SULAWESI BARAT,POLEWALI MANDAR,LIMBORO,LIMBORO,100,41,23,15,12,7,5,8,2,2,9,7,10,6,4,1,18,18,0,1,10,9,1,4,0,0,0,0,AGUSTUS
SULAWESI BARAT,POLEWALI MANDAR,LIMBORO,LEMBANG LEMBANG,33,13,13,7,4,1,1,11,1,0,3,2,5,2,3,2,13,8,5,1,9,8,1,2,2,0,2,1,AGUSTUS
SULAWESI BARAT,POLEWALI MANDAR,LIMBORO,TANDASURA,80,21,1,0,0,0,0,1,0,0,0,0,15,7,8,1,11,6,5,5,1,0,1,0,10,2,8,2,AGUSTUS
SULAWESI BARAT,POLEWALI MANDAR,LIMBORO,SAMASUNDU,62,55,40,22,8,1,0,13,26,1,18,22,9,7,2,7,42,33,9,16,19,6,13,2,15,14,1,15,AGUSTUS
SULAWESI BARAT,POLEWALI MANDAR,LIMBORO,NAPO,39,69,67,62,9,6,4,10,38,13,21,16,2,2,0,2,22,14,8,2,16,10,6,9,23,1,22,12,AGUSTUS
SULAWESI BARAT,POLEWALI MANDAR,LIMBORO,TODANG TODANG,42,21,7,2,0,0,0,6,0,0,4,3,2,0,2,0,20,5,15,1,15,7,8,0,17,14,3,1,AGUSTUS
SULAWESI BARAT,POLEWALI MANDAR,LIMBORO,PENDULANGAN,76,53,27,27,10,4,1,22,3,1,11,4,4,3,1,3,18,13,5,8,18,9,9,4,41,12,29,36,AGUSTUS
SULAWESI BARAT,POLEWALI MANDAR,LIMBORO,RENGGEANG,65,24,0,0,0,0,0,0,0,0,0,0,4,0,4,0,23,11,12,10,4,2,2,0,16,0,16,1,AGUSTUS
SULAWESI BARAT,POLEWALI MANDAR,LIMBORO,SALARRI,41,23,19,6,2,2,1,10,6,1,16,0,6,2,4,1,21,21,0,0,18,4,14,4,10,10,0,5,AGUSTUS
SULAWESI BARAT,POLEWALI MANDAR,LIMBORO,TANGAN BARU,49,65,64,30,26,0,0,48,12,1,53,10,2,1,1,0,24,19,5,11,9,4,5,4,25,5,20,1,AGUSTUS
SULAWESI BARAT,POLEWALI MANDAR,LIMBORO,PALECE,30,66,60,10,1,1,0,11,47,0,39,17,1,0,1,0,36,26,10,17,34,19,15,16,74,5,69,46,AGUSTUS
SULAWESI BARAT,POLEWALI MANDAR,LUYO,BATUPANGA,57,25,16,13,8,6,3,0,11,1,12,3,3,2,1,2,18,7,11,1,14,7,7,2,30,20,10,28,AGUSTUS
SULAWESI BARAT,POLEWALI MANDAR,LUYO,MAMBU,89,43,23,9,1,1,0,1,10,2,17,0,16,6,10,2,23,6,17,4,15,10,5,5,40,9,31,21,AGUSTUS
SULAWESI BARAT,POLEWALI MANDAR,LUYO,TENGGELANG,66,52,6,5,2,2,1,3,2,0,3,3,2,2,0,0,39,12,27,9,8,8,0,8,32,27,5,3,AGUSTUS
SULAWESI BARAT,POLEWALI MANDAR,LUYO,BARU,55,20,12,10,6,6,6,0,1,2,5,6,0,0,0,0,20,5,15,3,13,10,3,8,15,5,10,9,AGUSTUS
SULAWESI BARAT,POLEWALI MANDAR,LUYO,PUSSUI,72,52,8,0,0,0,0,2,6,0,5,0,0,0,0,0,47,45,2,33,19,0,19,0,13,3,10,12,AGUSTUS
SULAWESI BARAT,POLEWALI MANDAR,LUYO,MAPILI BARAT,37,72,38,10,8,1,1,3,1,3,37,0,2,0,2,0,58,50,8,19,15,7,8,6,59,45,14,16,AGUSTUS
SULAWESI BARAT,POLEWALI MANDAR,LUYO,SAMBALI WALI,41,43,17,4,0,0,0,8,7,2,7,4,6,2,4,2,22,14,8,1,9,7,2,2,29,0,29,1,AGUSTUS
SULAWESI BARAT,POLEWALI MANDAR,LUYO,BATUPANGA DAALA,94,11,4,0,0,0,0,0,4,0,4,0,6,3,3,3,10,6,4,0,7,7,0,0,7,4,3,6,AGUSTUS
SULAWESI BARAT,POLEWALI MANDAR,LUYO,LUYO,83,14,4,0,0,0,0,2,0,0,2,2,16,12,4,2,11,5,6,1,5,1,4,1,12,0,12,7,AGUSTUS
SULAWESI BARAT,POLEWALI MANDAR,LUYO,PUSSUI BARAT,60,57,18,0,0,0,0,16,2,0,14,4,12,3,9,0,49,39,10,12,40,36,4,31,28,20,8,0,AGUSTUS
SULAWESI BARAT,POLEWALI MANDAR,LUYO,PUCCADI,50,65,24,20,1,0,0,7,17,0,20,0,5,5,0,3,55,5,50,4,17,11,6,4,37,27,10,18,AGUSTUS
SULAWESI BARAT,POLEWALI MANDAR,MAPILLI,MAPILI,98,21,5,3,1,0,0,1,0,2,5,0,8,7,1,7,12,7,5,1,5,3,2,0,15,15,0,8,AGUSTUS
SULAWESI BARAT,POLEWALI MANDAR,MAPILLI,UGIBARU,55,73,67,40,5,0,0,30,37,0,9,15,8,4,4,1,52,5,47,2,20,9,11,6,2,2,0,0,AGUSTUS
SULAWESI BARAT,POLEWALI MANDAR,MAPILLI,RUMPA,41,78,74,64,19,6,4,30,27,3,66,7,3,0,3,0,38,30,8,7,5,0,5,0,55,31,24,5,AGUSTUS
SULAWESI BARAT,POLEWALI MANDAR,MAPILLI,KURMA,49,63,40,13,0,0,0,23,16,0,20,20,5,5,0,4,11,7,4,4,11,9,2,0,11,0,11,0,AGUSTUS
SULAWESI BARAT,POLEWALI MANDAR,MAPILLI,BUKU,86,58,16,1,0,0,0,15,1,0,8,0,17,11,6,9,56,34,22,7,24,18,6,0,64,48,16,10,AGUSTUS
SULAWESI BARAT,POLEWALI MANDAR,MAPILLI,BONNE BONNE,90,23,12,0,0,0,0,6,1,3,9,3,4,0,4,0,20,15,5,8,13,4,9,2,18,5,13,16,AGUSTUS
SULAWESI BARAT,POLEWALI MANDAR,MAPILLI,BEROANGIN,98,12,12,11,10,2,2,9,1,0,4,6,12,7,5,5,12,6,6,4,1,1,0,1,8,5,3,1,AGUSTUS
SULAWESI BARAT,POLEWALI MANDAR,MAPILLI,SEGERANG,61,21,9,4,3,2,2,6,1,0,0,0,8,1,7,0,21,21,0,20,1,1,0,1,11,6,5,7,AGUSTUS
SULAWESI BARAT,POLEWALI MANDAR,MAPILLI,BONRA,85,78,31,21,10,7,6,3,10,5,24,2,3,0,3,0,59,44,15,29,13,10,3,9,14,0,14,13,AGUSTUS
SULAWESI BARAT,POLEWALI MANDAR,MAPILLI,SATTOKO,94,22,21,5,3,0,0,15,0,1,4,8,12,7,5,2,10,5,5,1,9,3,6,2,15,4,11,15,AGUSTUS
SULAWESI BARAT,POLEWALI MANDAR,MAPILLI,RAPPANG BARAT,77,66,20,18,10,5,3,1,9,4,10,2,14,6,8,2,62,45,17,14,59,17,42,10,3,2,1,3,AGUSTUS
SULAWESI BARAT,POLEWALI MANDAR,MAPILLI,LANDI KANUSUANG,57,59,8,6,5,0,0,2,0,0,4,3,2,2,0,0,23,7,16,0,10,2,8,1,10,8,2,6,AGUSTUS
SULAWESI BARAT,POLEWALI MANDAR,MATAKALI,MATAKALI,95,52,50,42,5,2,2,22,7,4,4,15,8,1,7,0,21,18,3,7,16,9,7,1,29,27,2,21,AGUSTUS
SULAWESI BARAT,POLEWALI MANDAR,MATAKALI,PETAMPANUA,60,67,33,0,0,0,0,15,12,2,32,1,7,1,6,1,39,35,4,16,22,4,18,0,56,51,5,30,AGUSTUS
SULAWESI BARAT,POLEWALI MANDAR,MATAKALI,BARUMBUNG,66,75,59,32,27,8,6,53,0,0,40,4,3,1,2,0,23,16,7,5,2,1,1,0,0,0,0,0,AGUSTUS
SULAWESI BARAT,POLEWALI MANDAR,MATAKALI,PASIANG,44,20,12,4,4,1,1,10,0,1,3,8,7,4,3,1,18,6,12,4,13,4,9,0,11,0,11,8,AGUSTUS
SULAWESI BARAT,POLEWALI MANDAR,MATAKALI,TONROLIMA,69,50,46,35,9,4,3,33,10,0,42,3,4,2,2,2,30,8,22,8,24,12,12,1,7,6,1,7,AGUSTUS
SULAWESI BARAT,POLEWALI MANDAR,MATAKALI,INDOMAKKOMBONG,38,56,12,7,3,3,2,4,6,0,4,6,5,5,0,2,11,10,1,5,0,0,0,0,3,2,1,2,AGUSTUS
SULAWESI BARAT,POLEWALI MANDAR,MATAKALI,BUNGA-BUNGA,99,77,9,5,0,0,0,5,3,1,9,0,9,7,2,2,17,14,3,14,9,0,9,0,21,8,13,4,AGUSTUS
SULAWESI BARAT,POLEWALI MANDAR,MATANGNGA,MATANGNGA,39,78,4,2,0,0,0,4,0,0,4,0,1,0,1,0,22,5,17,1,1,1,0,1,6,5,1,6,AGUSTUS
SULAWESI BARAT,POLEWALI MANDAR,MATANGNGA,LILLI,71,38,36,34,8,3,1,33,1,1,36,0,11,1,10,1,11,11,0,7,10,5,5,3,35,9,26,35,AGUSTUS
SULAWESI BARAT,POLEWALI MANDAR,MATANGNGA,RANGOAN,82,69,24,19,14,5,2,6,13,0,13,4,3,2,1,0,66,51,15,33,37,18,19,18,65,58,7,19,AGUSTUS
SULAWESI BARAT,POLEWALI MANDAR,MATANGNGA,TAPUA,95,60,30,28,15,14,11,8,6,4,24,5,1,0,1,0,13,13,0,2,5,0,5,0,9,2,7,1,AGUSTUS
SULAWESI BARAT,POLEWALI MANDAR,MATANGNGA,MAMBU TAPUA,47,47,22,7,1,1,0,10,7,2,6,5,7,5,2,5,10,8,2,3,5,4,1,1,33,11,22,9,AGUSTUS
SULAWESI BARAT,POLEWALI MANDAR,MATANGNGA,BA'BA TAPUA,68,38,29,2,0,0,0,4,17,1,10,0,6,2,4,0,10,7,3,6,8,1,7,1,32,1,31,27,AGUSTUS
SULAWESI BARAT,POLEWALI MANDAR,MATANGNGA,KATIMBANG,76,67,7,6,6,4,0,5,1,1,5,0,5,4,1,2,53,11,42,6,34,22,12,22,13,9,4,6,AGUSTUS
SULAWESI BARAT,POLEWALI MANDAR,POLEWALI,POLEWALI,57,11,10,7,2,1,1,1,1,5,1,5,7,5,2,5,10,7,3,4,3,1,2,1,4,2,2,2,AGUSTUS
SULAWESI BARAT,POLEWALI MANDAR,POLEWALI,WATTANG,54,77,49,26,13,8,3,43,3,0,38,0,2,0,2,0,45,14,31,9,3,1,2,1,14,13,1,4,AGUSTUS
SULAWESI BARAT,POLEWALI MANDAR,POLEWALI,SULEWATANG,71,78,21,5,5,2,0,7,3,4,7,5,6,0,6,0,58,18,40,1,19,0,19,0,70,62,8,28,AGUSTUS
SULAWESI BARAT,POLEWALI MANDAR,POLEWALI,LANTORA,81,36,27,15,2,0,0,24,0,1,22,5,12,6,6,4,20,18,2,14,17,1,16,0,20,15,5,7,AGUSTUS
SULAWESI BARAT,POLEWALI MANDAR,POLEWALI,TAKATIDUNG,35,62,48,28,15,12,6,32,6,1,40,1,2,0,2,0,11,5,6,4,8,4,4,0,4,4,0,4,AGUSTUS
SULAWESI BARAT,POLEWALI MANDAR,POLEWALI,PEKKABATA,81,43,33,26,15,14,14,11,3,4,32,1,1,1,0,0,41,22,19,17,34,28,6,8,47,38,9,1,AGUSTUS
SULAWESI BARAT,POLEWALI MANDAR,POLEWALI,MADATE,32,69,59,54,31,12,8,2,1,21,6,45,2,1,1,0,13,7,6,2,3,3,0,2,31,31,0,1,AGUSTUS
SULAWESI BARAT,POLEWALI MANDAR,POLEWALI,MANDING,86,22,13,12,6,6,2,4,7,0,2,8,10,2,8,0,19,6,13,1,2,0,2,0,8,1,7,1,AGUSTUS
SULAWESI BARAT,POLEWALI MANDAR,POLEWALI,DARMA,37,79,26,11,11,5,3,18,0,1,11,12,3,0,3,0,70,62,8,11,27,20,7,18,29,22,7,25,AGUSTUS
SULAWESI BARAT,POLEWALI MANDAR,TAPANGO,PELITAKAN,51,66,66,55,14,14,5,20,3,14,18,11,4,3,1,2,43,13,30,3,35,27,8,8,23,12,11,21,AGUSTUS
SULAWESI BARAT,POLEWALI MANDAR,TAPANGO,TAPANGO,77,24,10,8,1,0,0,7,1,0,0,5,13,3,10,1,17,10,7,6,15,7,8,2,31,8,23,12,AGUSTUS
SULAWESI BARAT,POLEWALI MANDAR,TAPANGO,RAPPANG,54,68,32,4,2,2,2,24,6,0,23,0,0,0,0,0,67,6,61,4,18,6,12,2,62,17,45,14,AGUSTUS
SULAWESI BARAT,POLEWALI MANDAR,TAPANGO,DAKKA,78,79,40,24,14,10,6,6,21,5,23,11,10,5,5,5,30,16,14,6,12,5,7,5,8,8,0,5,AGUSTUS
SULAWESI BARAT,POLEWALI MANDAR,TAPANGO,BATU,51,19,19,15,7,3,1,12,0,1,7,4,10,0,10,0,16,14,2,4,5,1,4,0,2,2,0,2,AGUSTUS
SULAWESI BARAT,POLEWALI MANDAR,TAPANGO,RISO,71,55,42,39,31,27,23,9,6,4,30,4,7,1,6,1,15,15,0,13,2,2,0,2,25,12,13,2,AGUSTUS
SULAWESI BARAT,POLEWALI MANDAR,TAPANGO,PALATTA,71,24,6,5,4,2,1,2,1,2,1,4,0,0,0,0,14,6,8,1,3,1,2,1,4,2,2,3,AGUSTUS
SULAWESI BARAT,POLEWALI MANDAR,TAPANGO,TAPANGO BARAT,30,23,3,3,3,1,0,3,0,0,2,0,3,1,2,0,20,15,5,6,16,16,0,8,21,2,19,0,AGUSTUS
SULAWESI BARAT,POLEWALI MANDAR,TAPANGO,KURRAK,96,47,33,26,11,5,1,12,16,3,24,4,13,12,1,2,47,27,20,25,39,12,27,3,32,19,13,25,AGUSTUS
SULAWESI BARAT,POLEWALI MANDAR,TAPANGO,BUSSU,67,37,27,10,0,0,0,26,0,1,25,0,12,8,4,3,35,35,0,18,29,1,28,1,5,5,0,3,AGUSTUS
SULAWESI BARAT,POLEWALI MANDAR,TAPANGO,TUTTULA,35,80,77,40,6,2,0,37,10,22,63,9,7,5,2,2,61,47,14,45,21,5,16,1,7,2,5,0,AGUSTUS
SULAWESI BARAT,POLEWALI MANDAR,TAPANGO,JAMBU MALEA,70,65,40,9,3,2,1,22,15,2,34,5,6,2,4,0,29,22,7,8,4,4,0,4,26,13,13,9,AGUSTUS
SULAWESI BARAT,POLEWALI MANDAR,TAPANGO,KALIMBUA,75,28,24,5,1,1,1,4,8,0,14,4,4,3,1,0,26,20,6,6,3,1,2,0,17,13,4,1,AGUSTUS
SULAWESI BARAT,POLEWALI MANDAR,TAPANGO,BANATO REJO,41,10,9,5,0,0,0,3,2,1,9,0,6,4,2,4,10,8,2,3,0,0,0,0,7,5,2,1,AGUSTUS
SULAWESI BARAT,POLEWALI MANDAR,TINAMBUNG,TINAMBUNG,80,75,3,0,0,0,0,0,0,0,1,2,5,4,1,3,45,25,20,24,1,1,0,1,7,7,0,6,AGUSTUS
SULAWESI BARAT,POLEWALI MANDAR,TINAMBUNG,KARAMA,63,63,53,1,0,0,0,46,6,0,13,10,8,7,1,5,48,15,33,2,6,0,6,0,12,7,5,7,AGUSTUS
SULAWESI BARAT,POLEWALI MANDAR,TINAMBUNG,TANGNGA TANGNGA,83,73,22,6,3,0,0,16,3,1,12,2,2,2,0,1,20,17,3,15,18,11,7,5,55,2,53,43,AGUSTUS
SULAWESI BARAT,POLEWALI MANDAR,TINAMBUNG,LEKOPADIS,72,74,45,31,17,2,2,22,10,9,15,8,7,6,1,5,14,12,2,10,0,0,0,0,37,4,33,32,AGUSTUS
SULAWESI BARAT,POLEWALI MANDAR,TINAMBUNG,GALUNG LOMBOK,93,13,12,1,1,0,0,1,10,0,3,2,18,5,13,5,12,10,2,4,6,1,5,0,5,5,0,0,AGUSTUS
SULAWESI BARAT,POLEWALI MANDAR,TINAMBUNG,TANDUNG,99,20,0,0,0,0,0,0,0,0,0,0,19,1,18,1,15,6,9,5,0,0,0,0,9,8,1,8,AGUSTUS
SULAWESI BARAT,POLEWALI MANDAR,TINAMBUNG,BATULAYA,30,37,20,13,0,0,0,20,0,0,9,4,6,4,2,1,18,12,6,2,10,10,0,6,16,0,16,7,AGUSTUS
SULAWESI BARAT,POLEWALI MANDAR,TINAMBUNG,SEPABATU,33,26,15,5,2,0,0,0,14,1,13,0,2,0,2,0,21,8,13,7,7,2,5,1,18,15,3,13,AGUSTUS
SULAWESI BARAT,POLEWALI MANDAR,TUTAR,TARAMANU,59,30,21,13,11,0,0,0,8,0,9,7,9,8,1,1,29,11,18,0,9,6,3,1,20,1,19,19,AGUSTUS
SULAWESI BARAT,POLEWALI MANDAR,TUTAR,AMBOPADANG,89,49,11,7,0,0,0,11,0,0,6,2,17,2,15,1,29,24,5,1,12,5,7,2,26,22,4,11,AGUSTUS
SULAWESI BARAT,POLEWALI MANDAR,TUTAR,TUBBI,34,49,40,40,22,8,6,6,0,10,3,5,0,0,0,0,48,35,13,22,28,6,22,1,44,40,4,17,AGUSTUS
SULAWESI BARAT,POLEWALI MANDAR,TUTAR,RATTE,87,50,46,35,0,0,0,2,22,4,14,21,10,6,4,6,31,18,13,9,16,11,5,3,13,12,1,13,AGUSTUS
SULAWESI BARAT,POLEWALI MANDAR,TUTAR,BESOANGIN,46,29,19,16,1,0,0,7,10,1,16,1,8,6,2,6,28,25,3,0,2,0,2,0,4,0,4,4,AGUSTUS
SULAWESI BARAT,POLEWALI MANDAR,TUTAR,PIRIANG TAPIKO,51,53,24,6,3,0,0,20,1,3,2,2,3,2,1,0,38,37,1,7,31,24,7,24,63,10,53,36,AGUSTUS
SULAWESI BARAT,POLEWALI MANDAR,TUTAR,PEBURRU,87,48,47,8,1,0,0,37,0,8,31,15,13,12,1,8,14,11,3,8,11,8,3,8,3,0,3,3,AGUSTUS
SULAWESI BARAT,POLEWALI MANDAR,TUTAR,TALOBA,61,10,6,4,3,2,2,2,0,2,5,0,3,2,1,1,10,10,0,1,7,7,0,1,12,12,0,1,AGUSTUS
SULAWESI BARAT,POLEWALI MANDAR,TUTAR,POLLEWANI,58,39,38,28,26,15,6,7,22,1,38,0,2,1,1,0,12,8,4,8,7,4,3,3,8,0,8,3,AGUSTUS
SULAWESI BARAT,POLEWALI MANDAR,TUTAR,ARABUA,35,33,12,4,2,2,2,6,3,0,4,7,5,1,4,1,21,14,7,4,17,6,11,4,7,5,2,6,AGUSTUS
SULAWESI BARAT,POLEWALI MANDAR,TUTAR,BESOANGIN UTARA,74,56,40,14,13,2,1,24,4,7,13,22,4,2,2,1,32,25,7,12,4,1,3,1,42,7,35,33,AGUSTUS
SULAWESI BARAT,POLEWALI MANDAR,TUTAR,PODA,30,47,4,0,0,0,0,2,1,1,1,1,3,1,2,1,25,24,1,8,2,2,0,0,34,30,4,32,AGUSTUS
SULAWESI BARAT,POLEWALI MANDAR,TUTAR,TARAMANU TUA,97,24,18,7,7,0,0,11,7,0,5,13,0,0,0,0,24,15,9,14,14,11,3,9,15,15,0,9,AGUSTUS
SULAWESI BARAT,POLEWALI MANDAR,WONOMULYO,SIDODADI,52,49,23,10,4,4,3,17,2,0,4,15,6,6,0,2,29,8,21,3,11,0,11,0,24,11,13,9,AGUSTUS
SULAWESI BARAT,POLEWALI MANDAR,WONOMULYO,SIDOREJO,46,41,30,1,1,0,0,7,13,9,6,12,3,0,3,0,12,5,7,2,3,0,3,0,15,14,1,1,AGUSTUS
SULAWESI BARAT,POLEWALI MANDAR,WONOMULYO,SUMBEREJO,85,63,6,2,0,0,0,4,0,0,2,0,0,0,0,0,41,8,33,0,0,0,0,0,39,15,24,5,AGUSTUS
SULAWESI BARAT,POLEWALI MANDAR,WONOMULYO,BUMIAYU,46,20,6,2,1,1,1,2,0,2,3,2,0,0,0,0,11,10,1,9,3,1,2,0,16,13,3,1,AGUSTUS
SULAWESI BARAT,POLEWALI MANDAR,WONOMULYO,KEBUNSARI,98,56,9,5,4,0,0,0,9,0,4,5,5,0,5,0,33,22,11,17,20,12,8,3,3,1,2,1,AGUSTUS
SULAWESI BARAT,POLEWALI MANDAR,WONOMULYO,BANUA BARU,92,79,0,0,0,0,0,0,0,0,0,0,8,6,2,4,65,49,16,49,9,0,9,0,46,13,33,15,AGUSTUS
SULAWESI BARAT,POLEWALI MANDAR,WONOMULYO,NEPO,72,40,20,19,11,0,0,20,0,0,16,0,10,0,10,0,29,14,15,0,21,7,14,5,36,23,13,28,AGUSTUS
SULAWESI BARAT,POLEWALI MANDAR,WONOMULYO,SUGIHWARAS,51,23,0,0,0,0,0,0,0,0,0,0,3,1,2,0,19,17,2,1,8,0,8,0,24,15,9,13,AGUSTUS
SULAWESI BARAT,POLEWALI MANDAR,WONOMULYO,CAMPURJO,92,39,14,1,0,0,0,13,1,0,9,4,10,3,7,2,33,27,6,14,8,0,8,0,33,14,19,19,AGUSTUS
SULAWESI BARAT,POLEWALI MANDAR,WONOMULYO,BUMIMULYO,57,67,27,9,2,2,0,0,8,5,7,6,1,0,1,0,33,21,12,5,25,13,12,13,49,48,1,8,AGUSTUS
SULAWESI BARAT,POLEWALI MANDAR,WONOMULYO,TUMPILING,55,65,45,1,0,0,0,14,29,1,37,5,11,6,5,1,12,7,5,6,1,1,0,0,46,11,35,42,AGUSTUS
SULAWESI BARAT,POLEWALI MANDAR,WONOMULYO,BAKKA-BAKKA,41,51,8,5,2,1,0,8,0,0,8,0,6,3,3,3,49,49,0,48,49,46,3,30,68,12,56,45,AGUSTUS
SULAWESI BARAT,POLEWALI MANDAR,WONOMULYO,ARJO SARI,69,51,13,9,3,0,0,9,0,0,0,5,8,1,7,0,21,17,4,7,13,2,11,0,46,16,30,22,AGUSTUS
SULAWESI BARAT,POLEWALI MANDAR,WONOMULYO,GALESON,65,23,10,2,2,2,2,6,2,0,8,0,9,6,3,2,23,18,5,18,20,4,16,1,14,7,7,10,AGUSTUS
SULAWESI BARAT,MAMUJU,MAMUJU,BINANGA,87,66,20,6,0,0,0,13,5,0,4,5,17,14,3,5,36,18,18,8,9,7,2,0,55,45,10,18,AGUSTUS
SULAWESI BARAT,MAMUJU,MAMUJU,MAMUNYU,33,73,28,16,0,0,0,15,3,1,25,0,2,1,1,0,20,13,7,0,13,5,8,5,16,11,5,16,AGUSTUS
SULAWESI BARAT,MAMUJU,MAMUJU,KAREMA,70,41,2,0,0,0,0,1,1,0,1,0,7,2,5,1,11,10,1,5,0,0,0,0,22,18,4,6,AGUSTUS
SULAWESI BARAT,MAMUJU,MAMUJU,RIMUKU,81,78,41,24,23,17,16,21,1,1,40,1,1,1,0,0,36,32,4,31,0,0,0,0,41,41,0,9,AGUSTUS
SULAWESI BARAT,MAMUJU,MAMUJU,BAMBU,93,75,25,22,22,20,5,0,13,2,23,0,16,1,15,0,14,11,3,1,1,0,1,0,42,6,36,15,AGUSTUS
SULAWESI BARAT,MAMUJU,MAMUJU,KARAMPUANG,95,41,0,0,0,0,0,0,0,0,0,0,19,16,3,16,37,9,28,3,30,15,15,0,3,1,2,2,AGUSTUS
SULAWESI BARAT,MAMUJU,MAMUJU,TADUI,94,30,9,8,0,0,0,3,1,0,0,5,1,1,0,0,11,10,1,9,11,6,5,2,18,13,5,18,AGUSTUS
SULAWESI BARAT,MAMUJU,MAMUJU,BATU PANNU,81,78,57,52,21,5,3,16,3,13,37,17,9,1,8,1,56,15,41,14,45,22,23,20,33,3,30,29,AGUSTUS
SULAWESI BARAT,MAMUJU,TAPALANG,GALUNG,64,12,4,1,1,1,1,2,1,0,0,0,7,1,6,1,12,8,4,3,11,5,6,0,18,14,4,0,AGUSTUS
SULAWESI BARAT,MAMUJU,TAPALANG,KASAMBANG,80,77,28,20,4,1,0,21,2,0,0,3,10,6,4,5,60,45,15,12,0,0,0,0,46,36,10,40,AGUSTUS
SULAWESI BARAT,MAMUJU,TAPALANG,DAYANGINNA,79,54,23,13,11,0,0,15,6,1,0,21,6,0,6,0,34,9,25,6,34,14,20,13,59,55,4,51,AGUSTUS
SULAWESI BARAT,MAMUJU,TAPALANG,OROBATU,53,21,2,0,0,0,0,1,1,0,2,0,5,1,4,0,19,15,4,5,14,7,7,1,25,1,24,24,AGUSTUS
SULAWESI BARAT,MAMUJU,TAPALANG,TAKANDEANG,91,15,10,3,2,0,0,6,2,2,8,2,9,4,5,4,12,8,4,1,12,4,8,2,10,6,4,5,AGUSTUS
SULAWESI BARAT,MAMUJU,TAPALANG,BELA,34,58,14,12,8,3,1,7,1,4,1,3,3,2,1,0,48,14,34,13,15,9,6,3,8,7,1,2,AGUSTUS
SULAWESI BARAT,MAMUJU,TAPALANG,TAAN,58,25,5,2,1,0,0,2,2,1,4,1,6,2,4,2,16,8,8,2,14,4,10,2,22,8,14,19,AGUSTUS
SULAWESI BARAT,MAMUJU,TAPALANG,TAMPALANG,86,75,64,49,25,3,1,37,11,11,54,9,1,0,1,0,48,38,10,35,14,2,12,2,28,1,27,13,AGUSTUS
SULAWESI BARAT,MAMUJU,TAPALANG,RANTEDODA,51,22,21,3,2,0,0,11,6,3,5,13,9,5,4,1,17,11,6,10,15,1,14,1,25,14,11,11,AGUSTUS
SULAWESI BARAT,MAMUJU,TAPALANG,KOPEANG,54,74,59,12,11,1,1,17,27,13,25,29,9,8,1,3,33,33,0,21,27,9,18,0,32,8,24,11,AGUSTUS
SULAWESI BARAT,MAMUJU,KALUKKU,SINYONYOI,91,16,1,1,0,0,0,0,0,1,0,0,10,10,0,4,13,11,2,9,6,5,1,4,14,10,4,10,AGUSTUS
SULAWESI BARAT,MAMUJU,KALUKKU,BEBANGA,69,25,20,0,0,0,0,18,0,1,9,11,9,5,4,3,15,6,9,6,9,3,6,1,22,1,21,16,AGUSTUS
SULAWESI BARAT,MAMUJU,KALUKKU,KALUKKU,95,63,32,13,6,2,1,19,8,0,10,1,12,10,2,8,26,14,12,1,23,20,3,5,1,0,1,1,AGUSTUS
SULAWESI BARAT,MAMUJU,KALUKKU,SINYONYOI SELATAN,41,39,12,0,0,0,0,2,9,0,1,1,8,2,6,0,10,10,0,3,4,0,4,0,0,0,0,0,AGUSTUS
SULAWESI BARAT,MAMUJU,KALUKKU,SONDOANG,98,26,20,14,13,10,1,13,4,2,7,9,2,0,2,0,24,15,9,2,6,5,1,2,9,9,0,0,AGUSTUS
SULAWESI BARAT,MAMUJU,KALUKKU,BERU-BERU,66,48,7,6,4,0,0,3,3,1,6,1,3,2,1,1,15,13,2,8,7,4,3,1,25,12,13,19,AGUSTUS
SULAWESI BARAT,MAMUJU,KALUKKU,BELANG BELANG,100,15,15,9,8,3,2,4,4,0,10,3,6,0,6,0,15,14,1,1,2,1,1,0,8,5,3,7,AGUSTUS
SULAWESI BARAT,MAMUJU,KALUKKU,KABULOANG,46,29,6,5,1,0,0,6,0,0,1,2,4,1,3,0,21,11,10,0,7,2,5,2,7,5,2,0,AGUSTUS
SULAWESI BARAT,MAMUJU,KALUKKU,KEANG,85,17,2,0,0,0,0,2,0,0,0,2,6,4,2,2,13,12,1,7,10,4,6,0,15,13,2,8,AGUSTUS
SULAWESI BARAT,MAMUJU,KALUKKU,POKKANG,39,22,15,0,0,0,0,0,14,1,3,4,1,1,0,1,17,9,8,2,3,1,2,1,8,7,1,2,AGUSTUS
SULAWESI BARAT,MAMUJU,KALUKKU,GULILING,80,49,42,18,5,0,0,11,0,6,27,3,13,2,11,1,46,12,34,1,21,1,20,1,22,1,21,0,AGUSTUS
SULAWESI BARAT,MAMUJU,KALUKKU,UHAIMATE,68,21,6,2,0,0,0,5,1,0,2,0,0,0,0,0,18,11,7,8,18,10,8,5,5,0,5,5,AGUSTUS
SULAWESI BARAT,MAMUJU,KALUKKU,KALUKKU BARAT,45,76,57,25,4,2,2,39,2,0,8,3,0,0,0,0,19,14,5,2,19,1,18,0,49,37,12,31,AGUSTUS
SULAWESI BARAT,MAMUJU,KALUKKU,PAMMULUKANG,82,62,12,8,8,1,1,2,1,7,9,3,5,2,3,0,22,5,17,3,21,7,14,6,24,16,8,5,AGUSTUS
SULAWESI BARAT,MAMUJU,KALUMPANG,KALUMPANG,80,47,14,10,10,3,0,8,5,1,9,5,11,3,8,3,19,18,1,17,13,4,9,0,16,1,15,4,AGUSTUS
SULAWESI BARAT,MAMUJU,KALUMPANG,KARATAUN,80,18,5,5,5,1,1,3,1,0,3,0,11,1,10,0,13,12,1,8,11,4,7,1,6,0,6,3,AGUSTUS
SULAWESI BARAT,MAMUJU,KALUMPANG,KARAMA,40,45,2,0,0,0,0,0,1,0,0,0,0,0,0,0,14,10,4,7,10,1,9,0,8,4,4,1,AGUSTUS
SULAWESI BARAT,MAMUJU,KALUMPANG,SIRAUN,72,34,33,1,1,1,0,31,1,0,31,1,11,3,8,1,14,10,4,3,13,5,8,1,1,0,1,1,AGUSTUS
SULAWESI BARAT,MAMUJU,KALUMPANG,TUMOGA,91,26,16,2,2,0,0,10,4,2,14,2,13,12,1,10,10,7,3,7,10,5,5,0,28,1,27,9,AGUSTUS
SULAWESI BARAT,MAMUJU,KALUMPANG,SALUMAKKI,69,24,16,4,2,1,0,11,3,1,6,7,13,12,1,10,11,7,4,6,11,11,0,8,20,17,3,9,AGUSTUS
SULAWESI BARAT,MAMUJU,KALUMPANG,POLIO,35,31,24,23,7,6,3,7,13,1,16,6,1,1,0,1,23,22,1,15,2,0,2,0,17,12,5,3,AGUSTUS
SULAWESI BARAT,MAMUJU,KALUMPANG,LIMBONG,34,57,37,32,22,9,7,21,5,0,8,21,4,2,2,1,32,12,20,2,26,24,2,12,1,0,1,1,AGUSTUS
SULAWESI BARAT,MAMUJU,KALUMPANG,SANDAPANG,84,53,6,6,2,1,1,5,0,0,1,4,1,0,1,0,12,11,1,4,2,0,2,0,27,26,1,20,AGUSTUS
SULAWESI BARAT,MAMUJU,KALUMPANG,KONDO BULO,77,54,51,35,23,0,0,22,14,6,38,9,0,0,0,0,30,7,23,6,0,0,0,0,13,1,12,0,AGUSTUS
SULAWESI BARAT,MAMUJU,KALUMPANG,MAKKALIKI,82,15,11,5,5,4,3,3,5,0,1,0,9,6,3,0,10,9,1,7,7,5,2,2,16,3,13,12,AGUSTUS
SULAWESI BARAT,MAMUJU,KALUMPANG,BATU MAKKADA,88,75,38,20,16,7,6,20,10,1,14,9,13,9,4,8,21,17,4,8,21,7,14,0,19,0,19,14,AGUSTUS
SULAWESI BARAT,MAMUJU,KALUMPANG,LASA',30,54,25,15,8,5,3,0,6,7,1,18,6,6,0,4,44,20,24,19,20,17,3,0,5,4,1,2,AGUSTUS
SULAWESI BARAT,MAMUJU,PAPALANG,TOABO,70,17,6,3,1,0,0,5,1,0,4,2,11,6,5,3,10,7,3,2,5,0,5,0,3,2,1,0,AGUSTUS
SULAWESI BARAT,MAMUJU,PAPALANG,PAPALANG,75,80,44,6,2,0,0,0,30,4,44,0,3,2,1,2,47,40,7,30,10,4,6,4,11,6,5,6,AGUSTUS
SULAWESI BARAT,MAMUJU,PAPALANG,BONDA,66,68,24,16,11,4,0,14,8,2,7,8,1,0,1,0,15,8,7,1,2,1,1,0,11,7,4,9,AGUSTUS
SULAWESI BARAT,MAMUJU,PAPALANG,TOPORE,67,32,24,24,23,10,2,0,10,11,0,3,3,3,0,1,23,11,12,9,13,13,0,6,23,13,10,13,AGUSTUS
SULAWESI BARAT,MAMUJU,PAPALANG,SALUKAYU,78,51,21,19,5,4,3,10,2,4,5,11,12,3,9,0,10,5,5,2,3,3,0,3,11,5,6,10,AGUSTUS
SULAWESI BARAT,MAMUJU,PAPALANG,SUKADAMAI,31,34,23,17,15,6,4,14,1,4,23,0,1,0,1,0,26,19,7,14,13,6,7,4,26,26,0,17,AGUSTUS
SULAWESI BARAT,MAMUJU,PAPALANG,BODA-BODA,86,70,56,42,25,14,13,41,1,0,5,0,7,6,1,1,16,12,4,8,1,1,0,0,48,32,16,0,AGUSTUS
SULAWESI BARAT,MAMUJU,PAPALANG,SISANGO,95,72,1,0,0,0,0,1,0,0,1,0,8,4,4,1,66,58,8,5,31,15,16,0,53,39,14,1,AGUSTUS
SULAWESI BARAT,MAMUJU,PAPALANG,BATU AMPA,43,15,3,2,1,1,0,0,1,1,3,0,4,1,3,0,10,10,0,8,10,8,2,3,6,3,3,0,AGUSTUS
SULAWESI BARAT,MAMUJU,SAMPAGA,BUNDE,52,26,9,3,1,1,1,6,1,1,7,0,9,0,9,0,17,11,6,11,12,9,3,7,30,18,12,15,AGUSTUS
SULAWESI BARAT,MAMUJU,SAMPAGA,KALONDING,70,50,33,9,9,7,4,16,2,2,11,19,8,6,2,5,10,8,2,8,9,5,4,1,6,4,2,2,AGUSTUS
SULAWESI BARAT,MAMUJU,SAMPAGA,TARAILU,86,24,24,14,0,0,0,15,5,1,2,11,3,0,3,0,18,7,11,2,3,0,3,0,3,3,0,0,AGUSTUS
SULAWESI BARAT,MAMUJU,SAMPAGA,SAMPAGA,82,60,6,5,5,5,2,2,0,0,6,0,8,2,6,1,54,5,49,0,20,1,19,0,24,12,12,6,AGUSTUS
SULAWESI BARAT,MAMUJU,SAMPAGA,TANAMBUAH,30,55,34,28,19,2,0,21,12,1,14,10,2,1,1,1,28,6,22,6,20,3,17,2,19,6,13,8,AGUSTUS
SULAWESI BARAT,MAMUJU,SAMPAGA,SALUBARANA,37,64,36,8,1,0,0,27,8,1,22,0,7,7,0,1,13,10,3,8,1,0,1,0,28,8,20,5,AGUSTUS
SULAWESI BARAT,MAMUJU,SAMPAGA,LOSSO,66,40,2,0,0,0,0,0,0,1,2,0,5,1,4,0,31,26,5,8,13,12,1,6,36,10,26,33,AGUSTUS
SULAWESI BARAT,MAMUJU,TOMMO,TOMMO,55,55,46,13,2,1,1,8,32,3,34,0,8,5,3,0,32,6,26,6,14,5,9,2,7,4,3,4,AGUSTUS
SULAWESI BARAT,MAMUJU,TOMMO,CAMPALOGA,49,78,32,25,19,3,0,20,4,2,20,6,9,9,0,3,72,62,10,6,55,35,20,3,57,32,25,55,AGUSTUS
SULAWESI BARAT,MAMUJU,TOMMO,BUANA SAKTI,97,69,33,18,16,16,15,4,0,1,25,0,8,1,7,0,28,7,21,3,16,16,0,3,7,3,4,6,AGUSTUS
SULAWESI BARAT,MAMUJU,TOMMO,TAMEMONGGA,55,49,5,5,2,1,1,4,0,0,3,1,6,0,6,0,31,17,14,12,29,23,6,9,41,31,10,8,AGUSTUS
SULAWESI BARAT,MAMUJU,TOMMO,TAMEJARRA,94,25,12,0,0,0,0,10,2,0,4,3,4,1,3,1,20,14,6,8,15,7,8,3,18,8,10,18,AGUSTUS
SULAWESI BARAT,MAMUJU,TOMMO,RANTEMARIO,38,49,40,26,13,2,1,11,23,3,39,1,6,3,3,1,37,25,12,25,31,19,12,17,8,3,5,7,AGUSTUS
SULAWESI BARAT,MAMUJU,TOMMO,MALINO,80,25,10,4,1,0,0,5,4,0,5,4,14,8,6,8,12,12,0,12,7,5,2,1,16,7,9,2,AGUSTUS
SULAWESI BARAT,MAMUJU,TOMMO,KAKULLASANG,31,72,26,20,9,3,0,26,0,0,17,6,1,0,1,0,60,46,14,43,45,17,28,11,58,47,11,36,AGUSTUS
SULAWESI BARAT,MAMUJU,TOMMO,LELING,50,58,42,17,17,3,0,21,15,3,3,24,6,2,4,1,11,9,2,2,10,5,5,4,28,13,15,17,AGUSTUS
SULAWESI BARAT,MAMUJU,TOMMO,KALEPU,96,67,33,7,1,0,0,24,7,1,24,4,18,17,1,7,57,55,2,40,46,25,21,23,20,11,9,15,AGUSTUS
SULAWESI BARAT,MAMUJU,TOMMO,SANDANA,41,39,27,26,3,1,0,18,9,0,11,3,8,6,2,3,17,11,6,9,15,6,9,6,27,26,1,25,AGUSTUS
SULAWESI BARAT,MAMUJU,TOMMO,LELING BARAT,54,38,11,10,1,0,0,8,0,0,0,0,0,0,0,0,20,9,11,4,10,9,1,6,19,17,2,1,AGUSTUS
SULAWESI BARAT,MAMUJU,TOMMO,LELING UTARA,78,11,2,0,0,0,0,1,1,0,0,1,14,10,4,7,11,5,6,0,10,0,10,0,13,12,1,10,AGUSTUS
SULAWESI BARAT,MAMUJU,TOMMO,SALUDENGEN,40,17,3,3,0,0,0,2,0,1,2,0,2,1,1,0,14,9,5,0,1,1,0,0,7,1,6,1,AGUSTUS
SULAWESI BARAT,MAMUJU,SIMBORO DAN KEPULAUAN,SIMBORO,96,34,18,1,1,1,1,8,5,4,4,8,14,0,14,0,34,34,0,3,8,2,6,0,27,12,15,8,AGUSTUS
SULAWESI BARAT,MAMUJU,SIMBORO DAN KEPULAUAN,RANGAS,54,58,38,30,11,6,0,4,20,14,24,6,5,0,5,0,16,15,1,7,2,2,0,0,38,15,23,6,AGUSTUS
SULAWESI BARAT,MAMUJU,SIMBORO DAN KEPULAUAN,BOTTENG,68,75,17,11,5,5,3,14,0,0,15,2,9,4,5,1,50,31,19,4,36,21,15,6,67,27,40,44,AGUSTUS
SULAWESI BARAT,MAMUJU,SIMBORO DAN KEPULAUAN,SALETTO,41,77,72,37,3,1,1,45,11,6,63,9,6,4,2,2,58,58,0,2,57,10,47,5,8,4,4,5,AGUSTUS
SULAWESI BARAT,MAMUJU,SIMBORO DAN KEPULAUAN,SUMARE,59,11,10,2,2,0,0,5,0,1,2,1,10,10,0,7,11,9,2,8,6,0,6,0,3,3,0,2,AGUSTUS
SULAWESI BARAT,MAMUJU,SIMBORO DAN KEPULAUAN,BOTTENG UTARA,69,27,11,8,7,5,4,0,6,1,11,0,10,4,6,0,24,21,3,0,12,5,7,2,7,0,7,2,AGUSTUS
SULAWESI BARAT,MAMUJU,SIMBORO DAN KEPULAUAN,TAPANDULLU,65,56,0,0,0,0,0,0,0,0,0,0,10,7,3,7,40,29,11,17,17,16,1,8,15,4,11,10,AGUSTUS
SULAWESI BARAT,MAMUJU,SIMBORO DAN KEPULAUAN,PATI'DI,92,17,4,3,0,0,0,3,0,1,4,0,3,3,0,2,12,8,4,4,10,10,0,1,15,9,6,6,AGUSTUS
SULAWESI BARAT,MAMUJU,TAPALANG BARAT,DUNGKAIT,86,74,18,7,4,3,3,3,5,3,2,9,8,3,5,1,13,12,1,11,8,4,4,4,42,3,39,17,AGUSTUS
SULAWESI BARAT,MAMUJU,TAPALANG BARAT,LEBANI,37,23,10,3,2,2,2,6,1,1,7,3,2,1,1,0,13,13,0,11,8,0,8,0,20,6,14,18,AGUSTUS
SULAWESI BARAT,MAMUJU,TAPALANG BARAT,LABUANG RANO,64,32,13,8,5,4,3,2,6,1,0,5,5,5,0,2,23,10,13,0,17,5,12,3,1,1,0,0,AGUSTUS
SULAWESI BARAT,MAMUJU,TAPALANG BARAT,PASABU,30,71,54,14,7,1,0,35,2,4,51,1,6,5,1,3,46,5,41,1,13,12,1,3,7,6,1,5,AGUSTUS
SULAWESI BARAT,MAMUJU,TAPALANG BARAT,TANETE PAO,82,34,22,8,8,1,0,4,15,0,16,5,12,7,5,6,15,12,3,10,1,0,1,0,16,12,4,6,AGUSTUS
SULAWESI BARAT,MAMUJU,TAPALANG BARAT,PANGASAAN,33,54,10,1,0,0,0,7,2,0,1,9,3,3,0,3,25,8,17,2,7,4,3,4,7,0,7,5,AGUSTUS
SULAWESI BARAT,MAMUJU,TAPALANG BARAT,AHU,99,53,9,5,3,2,1,2,6,0,4,3,9,8,1,5,14,8,6,0,0,0,0,0,17,12,5,13,AGUSTUS
SULAWESI BARAT,MAMUJU,BONEHAU,BONEHAU,74,67,34,24,16,4,1,2,21,4,18,6,10,6,4,3,60,11,49,1,55,18,37,11,7,7,0,5,AGUSTUS
SULAWESI BARAT,MAMUJU,BONEHAU,SALUTIWO,34,26,3,1,1,0,0,1,0,2,0,2,0,0,0,0,22,17,5,7,6,3,3,3,12,2,10,5,AGUSTUS
SULAWESI BARAT,MAMUJU,BONEHAU,BUTTUADA,45,56,55,0,0,0,0,47,7,0,17,23,4,0,4,0,29,24,5,0,17,3,14,1,37,10,27,35,AGUSTUS
SULAWESI BARAT,MAMUJU,BONEHAU,TAMALEA,39,15,14,1,1,0,0,5,9,0,0,8,4,4,0,2,11,5,6,5,9,4,5,2,8,5,3,2,AGUSTUS
SULAWESI BARAT,MAMUJU,BONEHAU,LUMIKA,63,70,6,1,0,0,0,6,0,0,4,0,4,4,0,1,56,17,39,10,14,9,5,8,28,27,1,8,AGUSTUS
SULAWESI BARAT,MAMUJU,BONEHAU,MAPPU,44,47,32,0,0,0,0,9,4,12,0,27,8,0,8,0,15,15,0,2,10,9,1,1,28,27,1,9,AGUSTUS
SULAWESI BARAT,MAMUJU,BONEHAU,BANUADA,56,46,5,5,5,1,1,1,1,2,2,1,10,10,0,10,26,17,9,10,25,0,25,0,51,32,19,38,AGUSTUS
SULAWESI BARAT,MAMUJU,BONEHAU,HINUA,81,63,6,2,0,0,0,5,0,0,3,1,14,6,8,2,51,32,19,5,24,13,11,4,58,48,10,58,AGUSTUS
SULAWESI BARAT,MAMUJU,BONEHAU,KINATANG,97,43,4,4,3,1,1,0,3,0,1,3,5,2,3,0,42,11,31,3,30,10,20,0,30,5,25,9,AGUSTUS
SULAWESI BARAT,MAMUJU,KEP. BALA BALAKANG,BALA BALAKANG,87,36,18,1,0,0,0,14,4,0,17,1,1,0,1,0,17,5,12,2,7,4,3,1,30,17,13,27,AGUSTUS
SULAWESI BARAT,MAMUJU,KEP. BALA BALAKANG,BALA-BALAKANG TIMUR,49,16,8,4,0,0,0,8,0,0,1,1,6,1,5,1,12,8,4,7,5,3,2,0,13,7,6,3,AGUSTUS
SULAWESI BARAT,MAMUJU TENGAH,TOBADAK,MAHAHE,81,58,43,14,1,0,0,21,21,0,3,0,4,3,1,0,27,23,4,11,15,14,1,10,41,3,38,33,SEPTEMBER
SULAWESI BARAT,MAMUJU TENGAH,TOBADAK,SALOBAJA,80,41,17,10,1,0,0,11,0,4,0,5,4,2,2,2,39,27,12,20,6,1,5,1,24,24,0,14,SEPTEMBER
SULAWESI BARAT,MAMUJU TENGAH,TOBADAK,TOBADAK,79,66,9,9,1,0,0,9,0,0,0,1,8,4,4,1,27,23,4,17,3,1,2,0,14,3,11,7,SEPTEMBER
SULAWESI BARAT,MAMUJU TENGAH,TOBADAK,PALONGAAN,55,13,9,5,4,4,2,5,1,1,8,1,5,4,1,2,12,9,3,7,6,0,6,0,7,3,4,0,SEPTEMBER
SULAWESI BARAT,MAMUJU TENGAH,TOBADAK,BATU PARIGI,76,32,1,0,0,0,0,1,0,0,1,0,6,5,1,2,26,18,8,17,12,5,7,5,22,8,14,17,SEPTEMBER
SULAWESI BARAT,MAMUJU TENGAH,TOBADAK,BAMBADARU,58,39,37,7,5,3,1,1,29,4,13,22,6,3,3,3,38,19,19,6,27,10,17,10,49,18,31,17,SEPTEMBER
SULAWESI BARAT,MAMUJU TENGAH,TOBADAK,SEJATI,75,10,10,5,4,1,1,5,0,1,2,6,9,1,8,1,10,9,1,7,10,6,4,5,10,6,4,5,SEPTEMBER
SULAWESI BARAT,MAMUJU TENGAH,TOBADAK,SALOADAK,64,53,20,2,2,1,1,8,8,1,15,2,2,2,0,2,42,40,2,2,24,6,18,3,54,10,44,12,SEPTEMBER
SULAWESI BARAT,MAMUJU TENGAH,PANGALE,POLO PANGALE,62,28,19,6,0,0,0,1,5,3,0,0,9,4,5,0,14,14,0,2,7,6,1,6,4,3,1,3,SEPTEMBER
SULAWESI BARAT,MAMUJU TENGAH,PANGALE,PANGALE,60,30,4,4,2,0,0,0,3,0,4,0,9,5,4,3,13,5,8,1,3,0,3,0,1,1,0,0,SEPTEMBER
SULAWESI BARAT,MAMUJU TENGAH,PANGALE,SARTANAMAJU,96,36,25,4,2,2,0,17,3,5,0,18,4,0,4,0,22,15,7,6,10,8,2,1,21,15,6,7,SEPTEMBER
SULAWESI BARAT,MAMUJU TENGAH,PANGALE,POLO LERENG,80,60,45,29,21,1,0,26,16,0,35,6,14,7,7,6,51,10,41,10,22,4,18,2,13,10,3,2,SEPTEMBER
SULAWESI BARAT,MAMUJU TENGAH,PANGALE,KUO,95,17,13,9,3,2,2,8,1,2,8,3,13,12,1,8,13,13,0,13,8,7,1,0,7,3,4,3,SEPTEMBER
SULAWESI BARAT,MAMUJU TENGAH,PANGALE,POLO CAMBA,35,30,3,0,0,0,0,0,1,0,2,1,6,3,3,2,30,5,25,5,29,11,18,2,25,1,24,3,SEPTEMBER
SULAWESI BARAT,MAMUJU TENGAH,PANGALE,LAMBA-LAMBA,46,77,38,21,16,9,0,1,29,0,18,2,4,1,3,0,50,21,29,8,43,31,12,1,29,15,14,20,SEPTEMBER
SULAWESI BARAT,MAMUJU TENGAH,PANGALE,KOMBILING,45,76,43,0,0,0,0,30,6,3,28,8,9,7,2,6,57,15,42,14,6,4,2,1,48,43,5,2,SEPTEMBER
SULAWESI BARAT,MAMUJU TENGAH,PANGALE,LEMO-LEMO,98,57,32,14,11,4,1,1,26,2,20,8,8,6,2,5,52,10,42,9,40,30,10,11,14,10,4,3,SEPTEMBER
SULAWESI BARAT,MAMUJU TENGAH,BUDONG-BUDONG,BABANA,94,59,13,2,2,2,0,3,7,3,9,1,16,16,0,9,47,7,40,2,38,19,19,1,12,1,11,10,SEPTEMBER
SULAWESI BARAT,MAMUJU TENGAH,BUDONG-BUDONG,LUMU,52,25,20,11,3,2,1,2,0,11,10,0,2,2,0,2,19,16,3,0,19,7,12,4,26,10,16,12,SEPTEMBER
SULAWESI BARAT,MAMUJU TENGAH,BUDONG-BUDONG,PONTANAKAYANG,44,55,33,31,9,5,1,11,5,4,13,14,8,0,8,0,38,36,2,14,5,5,0,3,39,17,22,3,SEPTEMBER
SULAWESI BARAT,MAMUJU TENGAH,BUDONG-BUDONG,SALOGATTA,51,47,6,6,0,0,0,4,1,1,6,0,3,0,3,0,21,17,4,11,4,3,1,1,29,23,6,17,SEPTEMBER
SULAWESI BARAT,MAMUJU TENGAH,BUDONG-BUDONG,KIRE,32,22,20,4,2,1,1,13,2,4,7,1,2,0,2,0,20,10,10,0,9,8,1,5,10,8,2,7,SEPTEMBER
SULAWESI BARAT,MAMUJU TENGAH,BUDONG-BUDONG,TINALI,46,13,11,8,0,0,0,1,3,0,10,0,9,9,0,8,10,9,1,2,3,3,0,1,10,8,2,3,SEPTEMBER
SULAWESI BARAT,MAMUJU TENGAH,BUDONG-BUDONG,SALUMANURUNG,31,51,32,23,11,5,3,19,2,2,11,6,1,1,0,1,10,7,3,2,2,0,2,0,15,15,0,9,SEPTEMBER
SULAWESI BARAT,MAMUJU TENGAH,BUDONG-BUDONG,PASAPA,81,35,16,3,3,1,0,1,5,10,7,7,12,4,8,3,30,6,24,6,3,3,0,0,1,1,0,0,SEPTEMBER
SULAWESI BARAT,MAMUJU TENGAH,BUDONG-BUDONG,BOJO,96,67,12,1,1,0,0,5,5,1,6,1,5,0,5,0,48,39,9,19,38,9,29,9,39,18,21,36,SEPTEMBER
SULAWESI BARAT,MAMUJU TENGAH,BUDONG-BUDONG,BARAKKANG,36,63,28,15,13,13,9,1,2,9,12,8,4,1,3,0,55,40,15,30,21,14,7,13,21,18,3,3,SEPTEMBER
SULAWESI BARAT,MAMUJU TENGAH,BUDONG-BUDONG,LEMBAH HADA,34,76,17,3,0,0,0,15,1,0,9,8,2,0,2,0,56,6,50,0,37,15,22,11,61,2,59,15,SEPTEMBER
SULAWESI BARAT,MAMUJU TENGAH,TOPOYO,BUDONG-BUDONG,90,67,10,9,8,3,3,6,1,0,3,0,5,3,2,0,30,23,7,6,12,9,3,7,19,14,5,2,SEPTEMBER
SULAWESI BARAT,MAMUJU TENGAH,TOPOYO,TOPOYO,60,72,45,9,8,3,1,42,1,1,3,41,7,1,6,0,52,9,43,8,34,29,5,9,15,1,14,3,SEPTEMBER
SULAWESI BARAT,MAMUJU TENGAH,TOPOYO,TUMBU,40,78,30,21,20,13,3,13,9,1,30,0,0,0,0,0,49,17,32,5,12,8,4,3,19,15,4,2,SEPTEMBER
SULAWESI BARAT,MAMUJU TENGAH,TOPOYO,KABUBU,93,54,23,5,4,2,0,8,14,0,1,20,9,6,3,6,46,7,39,3,16,7,9,2,37,19,18,22,SEPTEMBER
SULAWESI BARAT,MAMUJU TENGAH,TOPOYO,WAEPUTEH,72,23,14,4,3,1,0,8,2,2,1,11,0,0,0,0,18,14,4,5,17,0,17,0,6,2,4,5,SEPTEMBER
SULAWESI BARAT,MAMUJU TENGAH,TOPOYO,TANGKOU,73,36,2,2,2,0,0,2,0,0,0,2,1,0,1,0,25,12,13,4,8,1,7,1,12,3,9,9,SEPTEMBER
SULAWESI BARAT,MAMUJU TENGAH,TOPOYO,TABOLANG,31,31,26,3,2,1,0,23,3,0,4,21,1,0,1,0,28,15,13,15,26,14,12,0,38,28,10,11,SEPTEMBER
SULAWESI BARAT,MAMUJU TENGAH,TOPOYO,PARAILI,48,10,4,2,1,0,0,1,3,0,0,2,8,2,6,1,10,8,2,6,0,0,0,0,1,0,1,1,SEPTEMBER
SULAWESI BARAT,MAMUJU TENGAH,TOPOYO,SALUPANGKANG,80,26,23,17,14,5,3,14,0,4,1,14,11,11,0,8,22,10,12,1,7,1,6,1,0,0,0,0,SEPTEMBER
SULAWESI BARAT,MAMUJU TENGAH,TOPOYO,SALUPANGKANG IV,91,67,32,4,1,1,1,1,20,10,23,0,7,2,5,0,55,52,3,48,47,25,22,17,40,6,34,8,SEPTEMBER
SULAWESI BARAT,MAMUJU TENGAH,TOPOYO,TAPPILINA,36,68,66,43,8,2,1,0,7,31,52,6,0,0,0,0,65,39,26,39,33,15,18,7,3,0,3,2,SEPTEMBER
SULAWESI BARAT,MAMUJU TENGAH,TOPOYO,BAMBAMANURUNG,68,68,37,14,10,0,0,18,18,1,24,7,8,8,0,2,55,17,38,16,18,6,12,2,8,6,2,7,SEPTEMBER
SULAWESI BARAT,MAMUJU TENGAH,TOPOYO,SALULEKBO,32,20,8,6,1,1,0,4,4,0,8,0,5,2,3,2,13,13,0,4,7,4,3,1,7,5,2,2,SEPTEMBER
SULAWESI BARAT,MAMUJU TENGAH,TOPOYO,PANGALLOANG,90,75,52,33,27,16,4,8,29,7,23,1,9,5,4,3,58,53,5,27,0,0,0,0,50,36,14,28,SEPTEMBER
SULAWESI BARAT,MAMUJU TENGAH,TOPOYO,SINABATTA,96,13,8,5,5,2,1,1,3,1,3,1,9,4,5,0,11,7,4,0,8,6,2,2,7,1,6,6,SEPTEMBER
SULAWESI BARAT,MAMUJU TENGAH,KAROSSA,KAROSSA,40,12,12,11,1,0,0,1,8,2,6,2,6,2,4,2,12,5,7,3,1,0,1,0,0,0,0,0,SEPTEMBER
SULAWESI BARAT,MAMUJU TENGAH,KAROSSA,TASOKKO,65,20,8,0,0,0,0,5,3,0,8,0,2,0,2,0,16,14,2,1,8,8,0,0,15,1,14,2,SEPTEMBER
SULAWESI BARAT,MAMUJU TENGAH,KAROSSA,LARA,35,68,48,21,21,9,7,0,4,18,31,7,1,1,0,0,41,26,15,1,8,6,2,0,45,27,18,8,SEPTEMBER
SULAWESI BARAT,MAMUJU TENGAH,KAROSSA,KADAILA,92,37,9,4,2,2,2,5,1,1,0,3,1,1,0,1,11,11,0,9,0,0,0,0,7,0,7,5,SEPTEMBER
SULAWESI BARAT,MAMUJU TENGAH,KAROSSA,KAYU CALLA,57,30,1,1,0,0,0,1,0,0,1,0,9,6,3,3,30,22,8,13,5,0,5,0,21,3,18,4,SEPTEMBER
SULAWESI BARAT,MAMUJU TENGAH,KAROSSA,LEMBAH HOPO,83,45,10,8,4,4,0,6,1,0,9,0,4,0,4,0,40,14,26,8,35,8,27,0,17,6,11,17,SEPTEMBER
SULAWESI BARAT,MAMUJU TENGAH,KAROSSA,BENGGAULU,81,64,11,7,3,3,0,6,2,2,2,6,5,5,0,1,11,7,4,7,10,10,0,2,54,19,35,32,SEPTEMBER
SULAWESI BARAT,MAMUJU TENGAH,KAROSSA,SUKA MAJU,37,33,5,2,2,1,1,0,3,0,1,1,6,0,6,0,28,18,10,6,8,8,0,3,14,1,13,1,SEPTEMBER
SULAWESI BARAT,MAMUJU TENGAH,KAROSSA,KAMBUNONG,90,43,9,4,2,2,1,5,3,0,6,2,14,14,0,7,38,17,21,1,23,0,23,0,27,18,9,0,SEPTEMBER
SULAWESI BARAT,MAMUJU TENGAH,KAROSSA,SALUBIRO,67,79,26,21,13,3,1,24,1,0,20,1,5,3,2,1,29,22,7,17,13,5,8,0,49,11,38,33,SEPTEMBER
SULAWESI BARAT,MAMUJU TENGAH,KAROSSA,SANJANGO,30,46,12,3,2,1,1,1,3,3,11,0,1,0,1,0,19,18,1,9,2,2,0,0,18,7,11,13,SEPTEMBER
SULAWESI BARAT,PASANGKAYU,BAMBAIRA,TAMPAURE,98,55,32,9,3,0,0,32,0,0,28,4,9,0,9,0,28,28,0,1,15,11,4,10,28,5,23,26,SEPTEMBER
SULAWESI BARAT,PASANGKAYU,BAMBAIRA,BAMBAIRA,44,66,21,14,5,1,1,9,8,0,16,3,2,0,2,0,46,22,24,2,38,5,33,0,65,62,3,46,SEPTEMBER
SULAWESI BARAT,PASANGKAYU,BAMBAIRA,KASOLOANG,76,55,5,4,1,1,0,1,0,1,1,2,6,3,3,0,18,10,8,2,6,6,0,2,3,2,1,0,SEPTEMBER
SULAWESI BARAT,PASANGKAYU,BAMBAIRA,KALUKU NANGKA,58,37,36,21,0,0,0,9,4,11,33,0,11,8,3,7,20,8,12,6,16,8,8,1,3,1,2,0,SEPTEMBER
SULAWESI BARAT,PASANGKAYU,BAMBALAMOTU,RANDOMAYANG,47,80,75,12,5,3,1,13,60,1,27,11,0,0,0,0,39,20,19,2,29,2,27,1,34,20,14,6,SEPTEMBER
SULAWESI BARAT,PASANGKAYU,BAMBALAMOTU,BAMBALAMOTU,77,40,9,0,0,0,0,4,2,3,2,3,9,2,7,2,17,14,3,6,17,16,1,9,31,30,1,14,SEPTEMBER
SULAWESI BARAT,PASANGKAYU,BAMBALAMOTU,POLEWALI,71,46,13,10,5,5,0,5,5,3,3,6,4,4,0,3,10,8,2,4,3,1,2,0,30,10,20,1,SEPTEMBER
SULAWESI BARAT,PASANGKAYU,BAMBALAMOTU,PANGIANG,64,63,49,7,0,0,0,45,1,0,10,5,3,2,1,2,42,12,30,1,9,2,7,2,16,16,0,5,SEPTEMBER
SULAWESI BARAT,PASANGKAYU,BAMBALAMOTU,KALOLA,53,33,11,11,9,5,5,6,0,0,5,0,10,9,1,5,19,5,14,0,5,0,5,0,1,0,1,1,SEPTEMBER
SULAWESI BARAT,PASANGKAYU,BAMBALAMOTU,WULAI,46,18,12,3,3,1,1,10,1,0,4,0,4,2,2,1,14,14,0,5,2,2,0,0,11,6,5,4,SEPTEMBER
SULAWESI BARAT,PASANGKAYU,BARAS,BARAS,76,25,24,20,8,8,4,18,2,0,21,1,12,6,6,1,22,15,7,15,22,12,10,8,7,1,6,7,SEPTEMBER
SULAWESI BARAT,PASANGKAYU,BARAS,BULU PARIGI,86,11,1,0,0,0,0,1,0,0,1,0,10,1,9,0,11,5,6,5,10,6,4,5,2,2,0,2,SEPTEMBER
SULAWESI BARAT,PASANGKAYU,BARAS,BALANTI,83,39,19,4,2,1,0,15,1,2,12,4,16,15,1,2,27,14,13,8,10,9,1,5,30,8,22,26,SEPTEMBER
SULAWESI BARAT,PASANGKAYU,BARAS,MOTU,70,24,6,3,3,2,2,4,0,0,1,2,2,0,2,0,22,6,16,5,10,0,10,0,15,2,13,11,SEPTEMBER
SULAWESI BARAT,PASANGKAYU,BARAS,TOWONI,80,11,4,3,2,0,0,3,0,0,1,2,13,11,2,4,11,9,2,3,1,1,0,1,8,4,4,8,SEPTEMBER
SULAWESI BARAT,PASANGKAYU,BARAS,KASANO,62,11,0,0,0,0,0,0,0,0,0,0,8,4,4,0,10,9,1,7,5,0,5,0,9,0,9,4,SEPTEMBER
SULAWESI BARAT,PASANGKAYU,BULU TABA,SUMBER SARI,99,30,12,8,0,0,0,0,10,0,10,1,9,0,9,0,17,5,12,1,14,10,4,2,0,0,0,0,SEPTEMBER
SULAWESI BARAT,PASANGKAYU,BULU TABA,LELEJAE,67,19,10,2,2,2,1,3,4,0,9,0,6,5,1,2,12,9,3,3,7,5,2,0,10,7,3,7,SEPTEMBER
SULAWESI BARAT,PASANGKAYU,BULU TABA,BUKIT HARAPAN,36,13,7,3,3,2,0,5,0,1,6,0,3,0,3,0,12,9,3,5,12,3,9,2,11,2,9,8,SEPTEMBER
SULAWESI BARAT,PASANGKAYU,BULU TABA,LILIMORI,98,41,38,19,7,6,6,12,1,15,36,2,12,10,2,2,18,8,10,5,7,6,1,0,35,22,13,19,SEPTEMBER
SULAWESI BARAT,PASANGKAYU,BULU TABA,KARAVE,65,41,13,8,7,4,0,8,0,0,8,3,3,2,1,2,19,6,13,1,0,0,0,0,22,16,6,13,SEPTEMBER
SULAWESI BARAT,PASANGKAYU,BULU TABA,KASTABUANA,67,75,71,15,1,0,0,39,14,3,34,32,9,6,3,5,73,39,34,1,56,25,31,13,99,84,15,53,SEPTEMBER
SULAWESI BARAT,PASANGKAYU,BULU TABA,OMPI,100,24,20,4,1,1,0,7,9,0,11,1,14,7,7,0,23,18,5,1,11,7,4,7,9,6,3,0,SEPTEMBER
SULAWESI BARAT,PASANGKAYU,DAPURANG,DAPURANG,52,21,10,5,0,0,0,7,1,1,2,7,9,3,6,3,18,10,8,5,1,1,0,0,8,4,4,0,SEPTEMBER
SULAWESI BARAT,PASANGKAYU,DAPURANG,BENGGAULU,67,76,40,3,0,0,0,2,28,0,37,2,11,9,2,9,64,20,44,2,43,32,11,30,69,22,47,22,SEPTEMBER
SULAWESI BARAT,PASANGKAYU,DAPURANG,TIRTABUANA,34,55,19,10,9,1,0,8,5,1,4,14,2,1,1,1,24,23,1,17,14,8,6,6,17,10,7,15,SEPTEMBER
SULAWESI BARAT,PASANGKAYU,DAPURANG,BULU BONGGU,79,22,1,0,0,0,0,1,0,0,1,0,4,0,4,0,21,8,13,3,11,0,11,0,5,1,4,0,SEPTEMBER
SULAWESI BARAT,PASANGKAYU,DAPURANG,SARASA,55,22,17,1,1,1,0,14,0,2,0,10,5,3,2,1,20,9,11,4,6,2,4,1,0,0,0,0,SEPTEMBER
SULAWESI BARAT,PASANGKAYU,DURIPOKU,TAMMARUNANG,53,31,10,6,5,2,2,2,4,1,3,2,4,1,3,0,10,5,5,1,10,0,10,0,0,0,0,0,SEPTEMBER
SULAWESI BARAT,PASANGKAYU,DURIPOKU,SAPTANAJAYA,81,31,13,9,4,0,0,2,3,0,6,4,13,11,2,3,12,6,6,0,10,10,0,0,19,1,18,18,SEPTEMBER
SULAWESI BARAT,PASANGKAYU,DURIPOKU,TARANGGI,59,19,12,5,3,1,0,6,6,0,11,0,9,1,8,1,11,8,3,7,4,3,1,3,3,1,2,3,SEPTEMBER
SULAWESI BARAT,PASANGKAYU,DURIPOKU,SIPAKAINGA,30,46,2,0,0,0,0,1,1,0,2,0,1,0,1,0,25,6,19,1,25,13,12,10,3,0,3,3,SEPTEMBER
SULAWESI BARAT,PASANGKAYU,LARIANG,KULU,100,23,19,6,4,2,1,13,0,2,7,3,13,7,6,5,14,11,3,2,11,11,0,1,11,2,9,3,SEPTEMBER
SULAWESI BARAT,PASANGKAYU,LARIANG,PARABU,95,14,11,2,0,0,0,3,5,0,8,0,14,13,1,8,12,11,1,3,2,2,0,1,11,5,6,3,SEPTEMBER
SULAWESI BARAT,PASANGKAYU,LARIANG,KENANGAN,75,68,34,24,13,0,0,32,1,1,5,0,6,4,2,2,67,46,21,14,53,35,18,33,47,14,33,41,SEPTEMBER
SULAWESI BARAT,PASANGKAYU,LARIANG,BAJAWALI,98,63,57,34,17,16,4,15,26,3,10,5,11,1,10,1,40,19,21,10,24,19,5,11,58,30,28,17,SEPTEMBER
SULAWESI BARAT,PASANGKAYU,LARIANG,SINGGANI,94,35,21,5,1,0,0,14,2,1,9,10,2,2,0,1,28,7,21,1,19,1,18,0,38,34,4,10,SEPTEMBER
SULAWESI BARAT,PASANGKAYU,LARIANG,BATU MATORU,57,13,7,3,3,3,0,7,0,0,5,2,4,2,2,2,12,5,7,4,7,3,4,0,7,5,2,5,SEPTEMBER
SULAWESI BARAT,PASANGKAYU,LARIANG,BAMBAKORO,48,23,1,0,0,0,0,0,0,1,1,0,7,1,6,1,14,13,1,0,10,10,0,5,13,2,11,3,SEPTEMBER
SULAWESI BARAT,PASANGKAYU,PASANGKAYU,KARYA BERSAMA,82,39,18,5,3,1,0,7,11,0,14,2,15,4,11,2,24,16,8,5,21,4,17,1,11,10,1,5,SEPTEMBER
SULAWESI BARAT,PASANGKAYU,PASANGKAYU,AKO,98,48,32,2,2,2,0,9,9,12,10,9,7,7,0,1,16,8,8,8,4,3,1,2,24,19,5,23,SEPTEMBER
SULAWESI BARAT,PASANGKAYU,PASANGKAYU,PASANGKAYU,47,54,45,33,24,22,14,24,1,0,43,0,3,3,0,0,38,14,24,4,25,13,12,5,2,1,1,1,SEPTEMBER
SULAWESI BARAT,PASANGKAYU,PASANGKAYU,MARTAJAYA,87,25,10,8,8,5,3,6,1,0,3,1,12,11,1,11,22,22,0,21,14,1,13,1,29,10,19,8,SEPTEMBER
SULAWESI BARAT,PASANGKAYU,PASANGKAYU,PAKAVA,42,54,31,16,11,0,0,10,21,0,22,7,1,1,0,0,36,23,13,9,24,9,15,7,30,28,2,0,SEPTEMBER
SULAWESI BARAT,PASANGKAYU,PASANGKAYU,GUNUNG SARI,84,22,10,10,10,6,2,6,2,0,2,3,10,2,8,1,18,11,7,4,6,4,2,0,13,9,4,2,SEPTEMBER
SULAWESI BARAT,PASANGKAYU,PEDONGGA,MALEI,97,14,10,2,0,0,0,8,2,0,6,0,6,5,1,5,13,11,2,10,12,3,9,1,0,0,0,0,SEPTEMBER
SULAWESI BARAT,PASANGKAYU,PEDONGGA,PEDANDA,71,19,7,7,2,2,2,4,0,0,4,1,12,8,4,3,12,9,3,8,6,4,2,3,2,2,0,2,SEPTEMBER
SULAWESI BARAT,PASANGKAYU,PEDONGGA,BATU OGE,77,54,7,7,7,2,1,2,2,1,7,0,9,9,0,9,47,7,40,2,7,5,2,1,10,9,1,1,SEPTEMBER
SULAWESI BARAT,PASANGKAYU,PEDONGGA,MARTASARI,67,33,13,7,0,0,0,13,0,0,2,2,10,6,4,4,18,11,7,3,0,0,0,0,17,4,13,10,SEPTEMBER
SULAWESI BARAT,PASANGKAYU,SARJO,SARJO,41,46,46,45,19,16,10,5,28,1,16,24,1,0,1,0,26,5,21,0,19,5,14,4,37,21,16,16,SEPTEMBER
SULAWESI BARAT,PASANGKAYU,SARJO,MAPONU,55,56,22,12,3,3,3,18,1,0,19,0,2,2,0,2,16,13,3,3,12,9,3,4,45,21,24,18,SEPTEMBER
SULAWESI BARAT,PASANGKAYU,SARJO,LETAWA,30,77,54,22,7,2,0,53,1,0,50,2,2,1,1,0,18,6,12,0,18,16,2,0,45,25,20,30,SEPTEMBER
SULAWESI BARAT,PASANGKAYU,SARJO,SARUDE,73,23,0,0,0,0,0,0,0,0,0,0,10,4,6,0,11,8,3,0,0,0,0,0,9,0,9,7,SEPTEMBER
SULAWESI BARAT,PASANGKAYU,SARUDU,DODA,93,72,6,1,1,1,0,4,2,0,2,2,0,0,0,0,70,44,26,20,70,9,61,5,20,4,16,16,SEPTEMBER
SULAWESI BARAT,PASANGKAYU,SARUDU,SARUDU,94,61,37,33,31,19,2,22,4,1,28,0,5,1,4,1,23,12,11,10,2,0,2,0,32,2,30,0,SEPTEMBER
SULAWESI BARAT,PASANGKAYU,SARUDU,BULU MARIO,77,22,21,4,2,0,0,15,2,2,6,8,9,1,8,0,14,11,3,8,11,4,7,0,21,15,6,4,SEPTEMBER
SULAWESI BARAT,PASANGKAYU,SARUDU,KUMASARI,84,10,0,0,0,0,0,0,0,0,0,0,0,0,0,0,10,10,0,9,1,0,1,0,3,1,2,1,SEPTEMBER
SULAWESI BARAT,PASANGKAYU,SARUDU,PATIKA,75,19,3,2,1,1,0,0,0,3,3,0,3,1,2,1,15,13,2,9,3,0,3,0,10,5,5,3,SEPTEMBER
SULAWESI BARAT,PASANGKAYU,TIKKE RAYA,MAKMUR JAYA,65,15,2,1,1,1,1,0,1,0,1,0,11,1,10,0,10,8,2,7,2,2,0,2,6,6,0,4,SEPTEMBER
SULAWESI BARAT,PASANGKAYU,TIKKE RAYA,LARIANG,85,37,1,0,0,0,0,0,0,0,1,0,3,2,1,1,24,13,11,2,0,0,0,0,24,3,21,16,SEPTEMBER
SULAWESI BARAT,PASANGKAYU,TIKKE RAYA,TIKKE,46,25,15,6,1,1,1,10,3,0,5,2,0,0,0,0,19,14,5,6,10,4,6,4,24,22,2,24,SEPTEMBER
SULAWESI BARAT,PASANGKAYU,TIKKE RAYA,PAJALELE,60,67,61,48,22,10,5,49,0,5,21,3,5,0,5,0,46,14,32,1,18,11,7,10,48,39,9,35,SEPTEMBER
SULAWESI BARAT,PASANGKAYU,TIKKE RAYA,JENGENG RAYA,86,25,15,5,5,3,0,7,6,2,14,0,1,0,1,0,11,9,2,2,5,1,4,0,16,11,5,3,SEPTEMBER
SULAWESI BARAT,MAJENE,BANGGAE,BANGGAE,44,63,26,23,7,3,2,7,16,0,5,10,3,2,1,0,34,21,13,6,25,18,7,0,27,13,14,5,SEPTEMBER
SULAWESI BARAT,MAJENE,BANGGAE,BARU,82,43,33,24,11,10,8,19,6,0,8,11,10,10,0,2,36,8,28,4,33,5,28,5,61,28,33,3,SEPTEMBER
SULAWESI BARAT,MAJENE,BANGGAE,PANGALI ALI,34,53,35,21,17,17,7,9,2,9,15,6,5,3,2,3,28,27,1,11,4,3,1,1,26,24,2,20,SEPTEMBER
SULAWESI BARAT,MAJENE,BANGGAE,TOTOLI,82,18,4,1,1,0,0,3,0,0,4,0,1,0,1,0,14,6,8,5,3,3,0,0,12,3,9,3,SEPTEMBER
SULAWESI BARAT,MAJENE,BANGGAE,RANGAS,71,37,14,8,3,3,2,6,3,2,2,5,10,8,2,6,30,17,13,0,6,2,4,0,5,1,4,3,SEPTEMBER
SULAWESI BARAT,MAJENE,BANGGAE,GALUNG,70,23,19,10,8,0,0,17,2,0,18,0,2,2,0,2,15,14,1,2,14,6,8,6,25,8,17,18,SEPTEMBER
SULAWESI BARAT,MAJENE,BANGGAE,PALIPI SOREANG,81,55,36,13,12,5,2,0,10,7,24,7,16,1,15,0,55,38,17,25,39,39,0,24,60,60,0,10,SEPTEMBER
SULAWESI BARAT,MAJENE,BANGGAE,PAMBOBORANG,56,20,19,5,2,2,0,9,8,0,6,3,7,5,2,0,18,5,13,5,17,8,9,2,10,0,10,9,SEPTEMBER
SULAWESI BARAT,MAJENE,BANGGAE TIMUR,BAURUNG,35,42,34,9,6,1,1,5,27,0,29,4,6,1,5,1,21,21,0,0,13,12,1,5,0,0,0,0,SEPTEMBER
SULAWESI BARAT,MAJENE,BANGGAE TIMUR,BARUGA,37,37,13,7,0,0,0,2,9,1,6,2,2,2,0,1,23,19,4,14,7,2,5,2,14,5,9,2,SEPTEMBER
SULAWESI BARAT,MAJENE,BANGGAE TIMUR,BARUGA DHUA,98,12,7,3,2,0,0,5,1,0,6,1,6,5,1,4,11,8,3,2,2,2,0,0,2,2,0,1,SEPTEMBER
SULAWESI BARAT,MAJENE,BANGGAE TIMUR,LABUANG,34,35,19,7,3,0,0,11,1,2,11,5,2,2,0,1,20,17,3,9,6,3,3,1,27,27,0,26,SEPTEMBER
SULAWESI BARAT,MAJENE,BANGGAE TIMUR,TANDE,30,72,31,16,15,8,0,3,8,4,23,8,2,1,1,0,50,11,39,3,44,9,35,8,17,2,15,15,SEPTEMBER
SULAWESI BARAT,MAJENE,BANGGAE TIMUR,LEMBANG,87,29,8,0,0,0,0,0,4,1,7,1,7,3,4,3,15,8,7,6,6,3,3,2,24,7,17,10,SEPTEMBER
SULAWESI BARAT,MAJENE,BANGGAE TIMUR,LABUANG UTARA,64,13,1,0,0,0,0,0,1,0,0,0,8,3,5,3,12,9,3,5,0,0,0,0,9,8,1,0,SEPTEMBER
SULAWESI BARAT,MAJENE,BANGGAE TIMUR,TANDE TIMUR,84,65,1,0,0,0,0,1,0,0,0,1,6,5,1,0,19,18,1,12,14,10,4,10,29,0,29,28,SEPTEMBER
SULAWESI BARAT,MAJENE,BANGGAE TIMUR,BUTTU BARUGA,34,51,6,5,3,0,0,5,1,0,0,1,0,0,0,0,18,8,10,5,13,10,3,2,10,4,6,10,SEPTEMBER
SULAWESI BARAT,MAJENE,MALUNDA,MALUNDA,97,17,0,0,0,0,0,0,0,0,0,0,18,1,17,1,17,7,10,2,2,0,2,0,12,4,8,5,SEPTEMBER
SULAWESI BARAT,MAJENE,MALUNDA,LAMUNGANG BATU,39,80,32,27,14,2,2,17,11,2,30,0,2,0,2,0,19,17,2,4,3,1,2,1,8,5,3,0,SEPTEMBER
SULAWESI BARAT,MAJENE,MALUNDA,BAMBANGAN,98,36,34,5,0,0,0,22,3,0,17,3,2,2,0,0,28,15,13,3,3,0,3,0,12,11,1,0,SEPTEMBER
SULAWESI BARAT,MAJENE,MALUNDA,LOMBANG,30,34,13,12,3,3,3,4,0,6,0,6,3,3,0,0,32,29,3,24,12,9,3,9,24,13,11,23,SEPTEMBER
SULAWESI BARAT,MAJENE,MALUNDA,LOMBONG,71,11,0,0,0,0,0,0,0,0,0,0,2,2,0,0,11,8,3,4,6,1,5,1,13,7,6,13,SEPTEMBER
SULAWESI BARAT,MAJENE,MALUNDA,MEKKATTA,39,73,11,5,1,1,0,8,0,0,7,0,7,6,1,4,32,23,9,2,6,6,0,4,44,33,11,25,SEPTEMBER
SULAWESI BARAT,MAJENE,MALUNDA,MALIAYA,92,37,26,1,1,0,0,3,17,0,24,2,18,3,15,3,35,26,9,7,33,21,12,1,24,16,8,7,SEPTEMBER
SULAWESI BARAT,MAJENE,MALUNDA,LOMBANG TIMUR,49,10,5,5,2,2,2,1,0,2,1,3,1,0,1,0,10,7,3,0,0,0,0,0,6,1,5,6,SEPTEMBER
SULAWESI BARAT,MAJENE,MALUNDA,SALUTAHONGAN,61,66,17,1,0,0,0,3,9,2,13,0,9,6,3,5,32,22,10,4,18,16,2,5,21,3,18,5,SEPTEMBER
SULAWESI BARAT,MAJENE,MALUNDA,LOMBONG TIMUR,45,56,5,0,0,0,0,2,3,0,4,0,6,1,5,0,41,39,2,6,14,7,7,6,7,5,2,2,SEPTEMBER
SULAWESI BARAT,MAJENE,MALUNDA,MEKKATTA SELATAN,47,55,16,16,13,13,5,1,7,2,9,4,2,0,2,0,46,40,6,39,6,1,5,0,19,18,1,5,SEPTEMBER
SULAWESI BARAT,MAJENE,MALUNDA,KAYUANGIN,94,36,0,0,0,0,0,0,0,0,0,0,18,16,2,10,32,23,9,7,3,0,3,0,0,0,0,0,SEPTEMBER
SULAWESI BARAT,MAJENE,PAMBOANG,LALAMPANUA,69,21,5,2,0,0,0,3,0,0,2,0,1,1,0,0,13,12,1,7,0,0,0,0,12,2,10,1,SEPTEMBER
SULAWESI BARAT,MAJENE,PAMBOANG,SIRINDU,81,24,13,8,8,5,3,6,1,2,3,1,2,1,1,0,18,14,4,2,3,0,3,0,18,12,6,7,SEPTEMBER
SULAWESI BARAT,MAJENE,PAMBOANG,ADOLANG,47,24,15,12,2,1,1,5,0,5,12,0,7,4,3,3,24,10,14,6,18,15,3,0,25,9,16,23,SEPTEMBER
SULAWESI BARAT,MAJENE,PAMBOANG,BABABULO,58,75,32,22,22,18,5,12,6,7,20,7,9,3,6,0,12,5,7,1,1,1,0,1,4,3,1,4,SEPTEMBER
SULAWESI BARAT,MAJENE,PAMBOANG,BONDE,48,58,37,1,0,0,0,16,9,9,29,7,1,0,1,0,17,6,11,5,11,4,7,1,38,24,14,29,SEPTEMBER
SULAWESI BARAT,MAJENE,PAMBOANG,BETTENG,57,30,16,11,7,7,0,2,5,4,16,0,1,1,0,1,17,9,8,9,7,4,3,1,12,6,6,12,SEPTEMBER
SULAWESI BARAT,MAJENE,PAMBOANG,SIMBANG,90,42,35,33,27,12,3,7,19,1,4,13,12,6,6,3,24,6,18,1,3,1,2,0,25,6,19,20,SEPTEMBER
SULAWESI BARAT,MAJENE,PAMBOANG,BONDE UTARA,93,45,18,14,14,2,2,3,10,0,10,3,14,6,8,0,15,9,6,0,3,1,2,0,9,3,6,1,SEPTEMBER
SULAWESI BARAT,MAJENE,PAMBOANG,BABABULO UTARA,34,37,37,28,28,5,2,16,0,10,11,2,2,0,2,0,14,14,0,4,3,1,2,1,9,7,2,8,SEPTEMBER
SULAWESI BARAT,MAJENE,PAMBOANG,BUTTU PAMBOANG,64,45,17,9,5,1,1,9,7,0,14,0,8,1,7,0,18,14,4,6,6,5,1,0,14,4,10,6,SEPTEMBER
SULAWESI BARAT,MAJENE,PAMBOANG,BANUA ADOLANG,85,53,52,12,7,3,2,25,24,1,38,7,7,2,5,0,23,13,10,2,14,6,8,0,26,6,20,21,SEPTEMBER
SULAWESI BARAT,MAJENE,PAMBOANG,ADOLANG DHUA,51,35,18,17,14,10,5,11,0,0,5,8,7,5,2,5,11,6,5,5,7,0,7,0,22,21,1,2,SEPTEMBER
SULAWESI BARAT,MAJENE,PAMBOANG,TINAMBUNG,36,57,42,3,2,2,1,24,7,0,39,2,2,1,1,0,41,19,22,18,2,1,1,0,18,5,13,2,SEPTEMBER
SULAWESI BARAT,MAJENE,PAMBOANG,PESULOANG,77,74,6,6,2,0,0,0,3,3,4,2,5,1,4,0,30,13,17,11,11,11,0,1,35,34,1,21,SEPTEMBER
SULAWESI BARAT,MAJENE,PAMBOANG,BALOMBONG,46,47,28,5,2,1,0,27,1,0,23,0,2,0,2,0,38,31,7,25,37,22,15,18,45,38,7,15,SEPTEMBER
SULAWESI BARAT,MAJENE,SENDANA,MOSSO,65,74,7,3,0,0,0,2,2,1,3,3,4,2,2,1,66,55,11,0,52,28,24,1,53,6,47,19,SEPTEMBER
SULAWESI BARAT,MAJENE,SENDANA,MOSSO DHUA,68,17,15,7,1,1,0,14,1,0,15,0,10,9,1,9,12,12,0,0,8,1,7,0,4,1,3,1,SEPTEMBER
SULAWESI BARAT,MAJENE,SENDANA,TOTOLISI SENDANA,65,50,24,8,7,1,1,4,15,3,12,12,4,4,0,1,22,10,12,5,19,14,5,0,32,26,6,19,SEPTEMBER
SULAWESI BARAT,MAJENE,SENDANA,TALLUBANUA,66,16,10,9,6,6,3,4,1,1,6,0,2,0,2,0,14,10,4,9,5,0,5,0,16,8,8,0,SEPTEMBER
SULAWESI BARAT,MAJENE,SENDANA,LALATEDZONG,73,49,44,39,24,15,7,11,10,1,37,5,8,6,2,2,38,9,29,5,14,10,4,10,21,15,6,16,SEPTEMBER
SULAWESI BARAT,MAJENE,SENDANA,BINANGA,71,55,26,20,19,14,0,11,5,6,20,5,6,2,4,0,18,17,1,12,2,1,1,1,8,6,2,1,SEPTEMBER
SULAWESI BARAT,MAJENE,SENDANA,PUTTADA,39,50,12,4,3,1,0,9,3,0,3,1,3,0,3,0,33,5,28,1,23,5,18,3,58,3,55,18,SEPTEMBER
SULAWESI BARAT,MAJENE,SENDANA,PAMINGGALAN,45,57,18,4,1,1,1,8,1,1,12,6,6,4,2,1,19,9,10,4,7,7,0,4,9,5,4,0,SEPTEMBER
SULAWESI BARAT,MAJENE,SENDANA,LEPPANGANG,92,77,38,7,0,0,0,9,11,10,4,24,18,8,10,1,57,41,16,15,48,0,48,0,14,10,4,11,SEPTEMBER
SULAWESI BARAT,MAJENE,SENDANA,PUNDAU,95,79,38,31,31,25,24,4,7,2,1,25,17,10,7,1,51,5,46,0,51,10,41,9,36,34,2,24,SEPTEMBER
SULAWESI BARAT,MAJENE,SENDANA,SENDANA,41,20,11,9,9,9,0,7,4,0,4,7,4,0,4,0,16,5,11,0,5,1,4,0,16,1,15,7,SEPTEMBER
SULAWESI BARAT,MAJENE,SENDANA,BANUA SENDANA,95,59,7,0,0,0,0,7,0,0,7,0,19,2,17,2,49,36,13,3,15,13,2,9,13,2,11,4,SEPTEMBER
SULAWESI BARAT,MAJENE,SENDANA,TALLUBANUA UTARA,44,20,4,1,0,0,0,0,3,1,0,1,2,1,1,0,19,18,1,10,14,11,3,4,16,3,13,5,SEPTEMBER
SULAWESI BARAT,MAJENE,SENDANA,LIMBORO RAMBU-RAMBU,65,21,2,0,0,0,0,1,0,0,0,0,6,0,6,0,14,12,2,8,8,7,1,3,4,0,4,1,SEPTEMBER
SULAWESI BARAT,MAJENE,SENDANA,LIMBUA,98,44,3,3,0,0,0,2,0,0,2,1,11,6,5,1,19,6,13,6,16,0,16,0,33,33,0,1,SEPTEMBER
SULAWESI BARAT,MAJENE,SENDANA,BUKIT SAMANG,33,11,7,7,1,1,1,5,0,0,0,4,6,4,2,2,11,9,2,6,7,3,4,0,14,0,14,6,SEPTEMBER
SULAWESI BARAT,MAJENE,TAMMERODO SENDANA,SEPPONG,99,16,14,13,5,2,2,11,1,0,10,0,12,12,0,6,12,7,5,2,1,0,1,0,7,7,0,1,SEPTEMBER
SULAWESI BARAT,MAJENE,TAMMERODO SENDANA,TAMMERODO,47,69,9,7,2,0,0,8,0,1,4,4,0,0,0,0,22,17,5,0,15,15,0,3,18,16,2,10,SEPTEMBER
SULAWESI BARAT,MAJENE,TAMMERODO SENDANA,ULIDANG,32,72,2,2,1,1,1,0,0,0,1,1,3,3,0,3,41,5,36,4,5,2,3,2,8,7,1,8,SEPTEMBER
SULAWESI BARAT,MAJENE,TAMMERODO SENDANA,TALLAMBALAO,42,43,21,7,3,0,0,14,6,0,17,0,1,1,0,1,12,5,7,3,8,6,2,0,26,25,1,17,SEPTEMBER
SULAWESI BARAT,MAJENE,TAMMERODO SENDANA,TAMMERODO UTARA,92,60,60,24,24,24,1,15,40,0,29,8,9,0,9,0,16,5,11,5,16,0,16,0,25,2,23,12,SEPTEMBER
SULAWESI BARAT,MAJENE,TAMMERODO SENDANA,MANYAMBA,96,55,31,14,6,1,0,31,0,0,4,18,8,0,8,0,15,6,9,4,4,0,4,0,31,17,14,5,SEPTEMBER
SULAWESI BARAT,MAJENE,TAMMERODO SENDANA,AWO,33,78,40,17,4,4,1,11,13,14,12,18,3,1,2,0,10,6,4,1,5,1,4,1,35,16,19,26,SEPTEMBER
SULAWESI BARAT,MAJENE,TUBO SENDANA,ONANG,43,45,41,37,13,10,1,0,24,14,6,2,4,2,2,2,31,30,1,20,14,1,13,0,15,0,15,0,SEPTEMBER
SULAWESI BARAT,MAJENE,TUBO SENDANA,TUBO,91,31,0,0,0,0,0,0,0,0,0,0,12,5,7,3,31,26,5,14,23,17,6,0,30,27,3,1,SEPTEMBER
SULAWESI BARAT,MAJENE,TUBO SENDANA,ONANG UTARA,40,30,4,3,0,0,0,0,1,1,2,2,2,2,0,1,16,10,6,3,8,3,5,2,24,4,20,8,SEPTEMBER
SULAWESI BARAT,MAJENE,TUBO SENDANA,TUBO SELATAN,69,58,57,49,32,0,0,3,14,2,30,16,9,5,4,0,36,23,13,22,7,0,7,0,10,6,4,9,SEPTEMBER
SULAWESI BARAT,MAJENE,TUBO SENDANA,BONDE BONDE,66,65,40,21,19,14,12,22,5,1,8,12,8,7,1,6,15,11,4,7,9,9,0,2,38,29,9,13,SEPTEMBER
SULAWESI BARAT,MAJENE,TUBO SENDANA,TUBO TENGAH,62,23,21,14,14,6,0,12,0,7,7,12,5,2,3,1,12,12,0,0,3,0,3,0,15,4,11,12,SEPTEMBER
SULAWESI BARAT,MAJENE,TUBO SENDANA,TUBO POANG,98,73,53,25,16,5,0,42,4,4,38,0,12,10,2,5,66,54,12,22,16,13,3,4,59,27,32,55,SEPTEMBER
SULAWESI BARAT,MAJENE,ULUMANDA,KABIRAAN,86,59,7,5,3,3,2,4,0,0,0,6,3,3,0,2,32,30,2,29,9,6,3,5,13,9,4,12,SEPTEMBER
SULAWESI BARAT,MAJENE,ULUMANDA,SAMBABO,45,53,7,2,0,0,0,1,4,2,2,1,4,1,3,1,51,40,11,34,31,20,11,17,64,6,58,52,SEPTEMBER
SULAWESI BARAT,MAJENE,ULUMANDA,TANDEALLO,83,24,0,0,0,0,0,0,0,0,0,0,12,10,2,9,21,10,11,0,2,2,0,1,7,0,7,0,SEPTEMBER
SULAWESI BARAT,MAJENE,ULUMANDA,ULUMANDA,97,72,59,58,35,30,0,20,24,4,36,16,15,1,14,1,58,41,17,7,11,0,11,0,45,40,5,33,SEPTEMBER
SULAWESI BARAT,MAJENE,ULUMANDA,SALUTAMBUNG,79,21,5,1,1,1,0,0,3,1,2,2,9,2,7,1,11,10,1,6,8,8,0,6,2,1,1,1,SEPTEMBER
SULAWESI BARAT,MAJENE,ULUMANDA,POPENGA,78,44,40,9,6,0,0,17,23,0,21,2,15,10,5,7,23,8,15,1,4,3,1,2,31,14,17,0,SEPTEMBER
SULAWESI BARAT,MAJENE,ULUMANDA,SULAI,46,32,15,4,4,0,0,14,0,0,2,7,8,0,8,0,14,13,1,9,3,1,2,0,11,10,1,5,SEPTEMBER
SULAWESI BARAT,MAJENE,ULUMANDA,PANGGALO,34,57,10,5,0,0,0,7,3,0,4,0,2,1,1,0,43,8,35,0,36,28,8,24,35,26,9,2,SEPTEMBER
SULAWESI BARAT,MAMASA,ARALLE,ARALLE,34,22,15,5,1,1,1,10,2,1,3,0,2,2,0,1,14,7,7,5,8,1,7,1,20,11,9,3,SEPTEMBER
SULAWESI BARAT,MAMASA,ARALLE,RALLE ANAK,79,57,23,4,4,0,0,11,3,8,21,0,7,0,7,0,47,41,6,36,7,3,4,3,25,4,21,23,SEPTEMBER
SULAWESI BARAT,MAMASA,ARALLE,PANETEAN,69,43,34,0,0,0,0,19,0,6,31,3,9,5,4,4,27,6,21,2,17,1,16,1,9,7,2,2,SEPTEMBER
SULAWESI BARAT,MAMASA,ARALLE,UHAILANU,69,77,54,35,13,5,4,21,23,1,27,4,0,0,0,0,21,9,12,7,4,3,1,1,55,3,52,49,SEPTEMBER
SULAWESI BARAT,MAMASA,ARALLE,ARALLE UTARA,54,78,14,9,1,0,0,13,1,0,0,1,7,5,2,3,44,40,4,28,40,7,33,2,33,25,8,20,SEPTEMBER
SULAWESI BARAT,MAMASA,ARALLE,UHAIDAHO,95,55,52,3,1,0,0,29,16,5,31,3,0,0,0,0,52,48,4,4,35,3,32,2,4,0,4,4,SEPTEMBER
SULAWESI BARAT,MAMASA,ARALLE,BARURU,52,63,62,15,1,0,0,62,0,0,35,17,0,0,0,0,59,9,50,8,20,0,20,0,53,2,51,52,SEPTEMBER
SULAWESI BARAT,MAMASA,ARALLE,RALLEANAK UTARA,30,73,19,18,12,0,0,7,0,1,10,0,5,3,2,0,59,30,29,20,15,9,6,1,59,50,9,56,SEPTEMBER
SULAWESI BARAT,MAMASA,ARALLE,PAMOSEANG PANGGA,76,21,9,0,0,0,0,3,5,0,6,2,6,4,2,3,17,7,10,3,15,6,9,1,21,20,1,7,SEPTEMBER
SULAWESI BARAT,MAMASA,ARALLE,KALABE,97,77,27,23,18,9,3,10,3,7,22,3,0,0,0,0,50,48,2,46,40,14,26,2,59,47,12,39,SEPTEMBER
SULAWESI BARAT,MAMASA,ARALLE,ARALLE SELATAN,99,24,1,1,1,1,1,0,0,0,0,0,18,1,17,0,15,7,8,0,4,4,0,0,20,9,11,20,SEPTEMBER
SULAWESI BARAT,MAMASA,ARALLE,HAHANGAN,61,37,32,27,6,0,0,4,7,19,4,4,3,0,3,0,29,16,13,9,23,20,3,15,28,12,16,28,SEPTEMBER
SULAWESI BARAT,MAMASA,BALLA,BALLA,39,18,1,0,0,0,0,1,0,0,1,0,3,2,1,2,15,5,10,0,12,1,11,0,23,6,17,6,SEPTEMBER
SULAWESI BARAT,MAMASA,BALLA,BALLA BARAT,36,76,11,4,0,0,0,0,3,3,2,3,7,2,5,0,32,27,5,17,2,0,2,0,16,2,14,15,SEPTEMBER
SULAWESI BARAT,MAMASA,BALLA,BALLA SATANETEAN,74,75,50,11,1,0,0,11,16,18,25,5,3,0,3,0,49,20,29,17,2,2,0,0,9,6,3,2,SEPTEMBER
SULAWESI BARAT,MAMASA,BALLA,BALLA TUMUKA,49,32,9,3,3,3,2,5,0,1,7,0,0,0,0,0,27,5,22,4,15,5,10,3,26,17,9,7,SEPTEMBER
SULAWESI BARAT,MAMASA,BALLA,SEPAKUAN,71,27,17,9,0,0,0,12,5,0,6,9,0,0,0,0,17,6,11,2,8,1,7,1,3,2,1,3,SEPTEMBER
SULAWESI BARAT,MAMASA,BALLA,PIDARA,32,63,22,10,3,2,2,6,0,12,3,1,6,6,0,1,19,9,10,6,5,1,4,0,7,0,7,7,SEPTEMBER
SULAWESI BARAT,MAMASA,BALLA,BAMBAPUANG,68,44,43,9,3,0,0,21,4,10,14,29,0,0,0,0,43,42,1,42,37,30,7,19,51,8,43,13,SEPTEMBER
SULAWESI BARAT,MAMASA,BALLA,BALLA TIMUR,47,67,44,14,11,10,0,19,24,0,31,5,2,1,1,1,53,6,47,3,44,33,11,12,72,33,39,56,SEPTEMBER
SULAWESI BARAT,MAMASA,BAMBANG,MOKALLANG,97,51,19,10,3,0,0,0,5,1,7,8,5,4,1,2,36,8,28,5,25,9,16,8,47,12,35,30,SEPTEMBER
SULAWESI BARAT,MAMASA,BAMBANG,MASOSO,99,22,22,19,5,0,0,7,5,0,13,6,17,12,5,6,10,5,5,3,6,3,3,1,12,6,6,1,SEPTEMBER
SULAWESI BARAT,MAMASA,BAMBANG,SALUASSING,48,50,5,1,1,1,0,0,1,2,3,2,6,6,0,2,21,7,14,4,11,11,0,7,23,11,12,4,SEPTEMBER
SULAWESI BARAT,MAMASA,BAMBANG,SALUBULO,40,79,60,20,13,2,0,47,13,0,53,1,0,0,0,0,67,47,20,3,25,9,16,3,4,3,1,2,SEPTEMBER
SULAWESI BARAT,MAMASA,BAMBANG,SALUKADI,41,30,24,1,1,0,0,21,3,0,5,17,1,0,1,0,29,14,15,9,17,16,1,8,17,16,1,7,SEPTEMBER
SULAWESI BARAT,MAMASA,BAMBANG,SALUKEPOPOK,65,10,3,2,0,0,0,3,0,0,0,2,9,2,7,2,10,5,5,3,0,0,0,0,5,2,3,0,SEPTEMBER
SULAWESI BARAT,MAMASA,BAMBANG,ULUMAMBI BARAT,93,14,9,8,4,4,3,3,2,0,7,0,17,0,17,0,14,14,0,6,6,0,6,0,11,6,5,1,SEPTEMBER
SULAWESI BARAT,MAMASA,BAMBANG,LIMBADEBATA,91,22,4,3,1,1,0,4,0,0,2,1,9,0,9,0,15,11,4,5,9,9,0,5,0,0,0,0,SEPTEMBER
SULAWESI BARAT,MAMASA,BAMBANG,TANETE TOMBA,62,70,45,32,22,4,0,30,1,5,40,2,5,2,3,0,16,16,0,5,14,13,1,5,46,31,15,28,SEPTEMBER
SULAWESI BARAT,MAMASA,BAMBANG,BAMBANG,71,40,13,7,5,2,0,10,3,0,12,0,13,2,11,2,28,12,16,11,9,7,2,6,1,0,1,1,SEPTEMBER
SULAWESI BARAT,MAMASA,BAMBANG,RANTELEMO,71,45,25,25,13,2,1,19,2,3,21,1,7,6,1,1,43,26,17,1,33,26,7,5,42,23,19,42,SEPTEMBER
SULAWESI BARAT,MAMASA,BAMBANG,SALUDENGEN,87,68,36,15,15,8,6,28,2,0,4,25,8,6,2,5,47,15,32,8,35,31,4,10,39,8,31,28,SEPTEMBER
SULAWESI BARAT,MAMASA,BAMBANG,ULUMAMBI,71,17,2,2,2,1,0,0,1,1,1,1,14,14,0,7,13,6,7,4,2,2,0,2,3,0,3,2,SEPTEMBER
SULAWESI BARAT,MAMASA,BAMBANG,BAMBANG TIMUR,72,73,52,40,19,11,10,34,3,3,33,0,4,0,4,0,61,37,24,8,9,5,4,1,34,16,18,26,SEPTEMBER
SULAWESI BARAT,MAMASA,BAMBANG,MINANGA,66,13,5,2,0,0,0,4,0,1,1,2,7,3,4,3,10,8,2,5,8,4,4,3,7,1,6,2,SEPTEMBER
SULAWESI BARAT,MAMASA,BAMBANG,SIKAMASE,43,46,22,21,11,1,1,2,12,1,8,13,0,0,0,0,18,12,6,12,0,0,0,0,14,1,13,10,SEPTEMBER
SULAWESI BARAT,MAMASA,BAMBANG,RANTETARIMA,44,13,3,2,1,0,0,1,2,0,2,1,3,0,3,0,12,8,4,2,3,1,2,1,7,5,2,4,SEPTEMBER
SULAWESI BARAT,MAMASA,BAMBANG,SALURURU,53,59,35,1,1,0,0,3,25,0,21,5,4,0,4,0,16,15,1,3,16,0,16,0,3,1,2,3,SEPTEMBER
SULAWESI BARAT,MAMASA,BAMBANG,SALUTABANG,56,21,18,9,2,0,0,11,7,0,2,14,7,2,5,2,14,14,0,6,1,0,1,0,2,0,2,2,SEPTEMBER
SULAWESI BARAT,MAMASA,BAMBANG,BALATANA,62,17,6,5,5,1,1,1,0,0,2,3,3,1,2,1,15,12,3,0,7,3,4,2,5,2,3,3,SEPTEMBER
SULAWESI BARAT,MAMASA,BUNTUMALANGKA,BUNTUMALANGKA,66,52,49,3,3,1,1,20,10,8,0,8,3,1,2,1,11,9,2,9,11,0,11,0,24,12,12,12,SEPTEMBER
SULAWESI BARAT,MAMASA,BUNTUMALANGKA,RANTEBERAN,34,74,40,6,0,0,0,32,8,0,30,8,4,2,2,2,31,20,11,2,11,8,3,6,36,6,30,14,SEPTEMBER
SULAWESI BARAT,MAMASA,BUNTUMALANGKA,KEBANGA,67,11,1,1,1,0,0,1,0,0,1,0,8,3,5,3,11,9,2,9,3,3,0,0,3,1,2,2,SEPTEMBER
SULAWESI BARAT,MAMASA,BUNTUMALANGKA,SALURINDU,79,42,36,27,20,14,1,15,3,5,11,20,3,2,1,1,38,13,25,11,25,0,25,0,24,23,1,0,SEPTEMBER
SULAWESI BARAT,MAMASA,BUNTUMALANGKA,TAORA,44,19,8,7,6,1,0,2,4,0,4,2,1,0,1,0,16,12,4,12,11,6,5,5,9,5,4,0,SEPTEMBER
SULAWESI BARAT,MAMASA,BUNTUMALANGKA,KABAE,42,32,29,17,0,0,0,14,6,3,4,0,4,3,1,2,17,10,7,10,5,3,2,1,3,0,3,2,SEPTEMBER
SULAWESI BARAT,MAMASA,BUNTUMALANGKA,SALUTAMBUN BARAT,84,67,64,44,36,6,0,26,3,18,11,14,3,2,1,1,20,12,8,12,6,5,1,4,26,26,0,21,SEPTEMBER
SULAWESI BARAT,MAMASA,BUNTUMALANGKA,PENATANGAN,37,47,21,20,1,1,1,8,3,0,9,3,2,0,2,0,38,15,23,9,21,18,3,17,2,2,0,1,SEPTEMBER
SULAWESI BARAT,MAMASA,BUNTUMALANGKA,SALUTAMBUN TIMUR,100,41,7,5,2,1,1,6,0,0,4,0,9,4,5,4,30,9,21,9,19,17,2,14,3,0,3,0,SEPTEMBER
SULAWESI BARAT,MAMASA,BUNTUMALANGKA,SALUTAMBUN,75,15,12,6,4,3,2,7,1,2,5,2,3,2,1,2,11,11,0,3,3,0,3,0,0,0,0,0,SEPTEMBER
SULAWESI BARAT,MAMASA,BUNTUMALANGKA,ARALLE TIMUR,44,12,6,4,3,3,3,1,0,0,6,0,3,0,3,0,11,7,4,3,8,7,1,4,11,3,8,0,SEPTEMBER
SULAWESI BARAT,MAMASA,MAMASA,MAMASA,67,73,30,9,2,2,2,26,0,2,27,0,8,1,7,0,57,29,28,26,11,2,9,2,42,28,14,2,SEPTEMBER
SULAWESI BARAT,MAMASA,MAMASA,RAMBUSARATU,40,70,61,1,1,1,0,47,4,6,40,18,1,1,0,1,12,7,5,4,6,1,5,1,51,45,6,9,SEPTEMBER
SULAWESI BARAT,MAMASA,MAMASA,OSANGO,44,31,28,1,0,0,0,23,4,0,7,17,5,2,3,1,26,12,14,11,5,1,4,0,18,12,6,0,SEPTEMBER
SULAWESI BARAT,MAMASA,MAMASA,LAMBANAN,90,65,55,37,20,2,0,34,15,1,45,7,5,3,2,0,11,11,0,7,3,3,0,0,43,31,12,16,SEPTEMBER
SULAWESI BARAT,MAMASA,MAMASA,LEMBANA SALULO,57,36,22,3,2,0,0,1,9,5,7,15,1,0,1,0,28,22,6,4,15,2,13,1,14,7,7,13,SEPTEMBER
SULAWESI BARAT,MAMASA,MAMASA,TAUPE,61,62,1,0,0,0,0,0,0,0,0,0,5,2,3,0,28,28,0,28,1,1,0,1,7,0,7,6,SEPTEMBER
SULAWESI BARAT,MAMASA,MAMASA,BUNTU BUDA,95,35,31,1,0,0,0,18,1,9,18,7,15,15,0,7,16,9,7,8,12,1,11,1,30,11,19,5,SEPTEMBER
SULAWESI BARAT,MAMASA,MAMASA,TONDOK BAKARU,63,20,13,13,1,1,1,3,1,2,9,2,5,5,0,1,19,17,2,2,0,0,0,0,3,0,3,1,SEPTEMBER
SULAWESI BARAT,MAMASA,MAMASA,PEBASSIAN,94,52,13,6,0,0,0,7,3,1,8,1,17,17,0,4,31,6,25,2,23,2,21,2,21,13,8,16,SEPTEMBER
SULAWESI BARAT,MAMASA,MAMASA,MAMBULILING,66,72,49,40,21,11,11,22,10,3,29,6,12,11,1,1,52,37,15,1,13,9,4,6,17,14,3,3,SEPTEMBER
SULAWESI BARAT,MAMASA,MAMASA,BOMBONG LAMBE,45,30,2,0,0,0,0,2,0,0,1,0,5,1,4,1,26,25,1,13,15,11,4,3,24,5,19,5,SEPTEMBER
SULAWESI BARAT,MAMASA,MAMASA,BUBUN BATU,42,57,17,9,2,0,0,11,2,1,6,1,1,0,1,0,24,15,9,13,21,12,9,8,15,2,13,0,SEPTEMBER
SULAWESI BARAT,MAMASA,MAMBI,MAMBI,90,75,36,9,2,2,2,20,8,4,7,27,7,6,1,6,75,61,14,51,39,23,16,7,38,0,38,2,SEPTEMBER
SULAWESI BARAT,MAMASA,MAMBI,TALIPUKKI,93,42,27,3,3,3,0,20,2,2,10,1,7,1,6,0,31,24,7,23,28,0,28,0,29,11,18,5,SEPTEMBER
SULAWESI BARAT,MAMASA,MAMBI,RANTEBULAHAN,50,42,18,10,8,1,0,1,5,8,4,7,0,0,0,0,19,18,1,10,15,8,7,0,3,1,2,0,SEPTEMBER
SULAWESI BARAT,MAMASA,MAMBI,SONDONGLAYU,60,62,30,9,2,2,2,27,0,1,28,1,0,0,0,0,48,41,7,37,14,9,5,2,18,15,3,14,SEPTEMBER
SULAWESI BARAT,MAMASA,MAMBI,SALUBANUA,30,71,59,18,18,5,4,21,10,9,3,14,0,0,0,0,32,19,13,17,21,10,11,6,19,0,19,16,SEPTEMBER
SULAWESI BARAT,MAMASA,MAMBI,TAPALINA,48,10,5,0,0,0,0,1,4,0,1,3,0,0,0,0,10,5,5,2,1,0,1,0,8,3,5,8,SEPTEMBER
SULAWESI BARAT,MAMASA,MAMBI,SENDANA,44,15,6,6,2,0,0,0,2,3,6,0,3,0,3,0,11,10,1,9,3,3,0,2,3,3,0,0,SEPTEMBER
SULAWESI BARAT,MAMASA,MAMBI,PAMOSEAN,59,60,60,39,21,6,0,50,2,1,2,56,6,5,1,0,47,5,42,3,4,0,4,0,23,12,11,5,SEPTEMBER
SULAWESI BARAT,MAMASA,MAMBI,SELUMAKA,59,74,49,43,13,12,1,9,23,0,23,5,5,0,5,0,46,42,4,23,11,8,3,8,55,26,29,3,SEPTEMBER
SULAWESI BARAT,MAMASA,MAMBI,BUJUNG MANURUNG,53,44,0,0,0,0,0,0,0,0,0,0,0,0,0,0,32,29,3,23,0,0,0,0,7,4,3,3,SEPTEMBER
SULAWESI BARAT,MAMASA,MAMBI,SALU ALO,100,45,35,23,4,2,1,2,13,17,4,11,18,12,6,5,23,16,7,13,15,6,9,1,15,1,14,1,SEPTEMBER
SULAWESI BARAT,MAMASA,MAMBI,INDOBANUA,87,62,17,0,0,0,0,1,15,0,8,9,4,4,0,3,49,40,9,33,43,41,2,0,32,11,21,9,SEPTEMBER
SULAWESI BARAT,MAMASA,MAMBI,SALUDURIAN,60,52,51,49,20,3,3,15,12,20,32,10,6,0,6,0,17,11,6,1,11,7,4,3,42,30,12,17,SEPTEMBER
SULAWESI BARAT,MAMASA,MEHALAAN,MEHALAAN,99,36,24,1,1,1,0,16,4,1,7,16,8,1,7,1,24,23,1,14,7,6,1,5,3,0,3,0,SEPTEMBER
SULAWESI BARAT,MAMASA,MEHALAAN,BOTTENG,35,59,39,5,3,3,2,19,4,14,11,16,0,0,0,0,44,41,3,4,43,30,13,1,26,20,6,24,SEPTEMBER
SULAWESI BARAT,MAMASA,MEHALAAN,SALUKONTA,47,63,45,15,13,6,5,10,12,0,23,7,3,0,3,0,21,11,10,7,9,0,9,0,9,0,9,1,SEPTEMBER
SULAWESI BARAT,MAMASA,MEHALAAN,MESAKADA,93,11,11,8,5,3,1,10,0,0,3,0,7,6,1,0,10,7,3,7,2,2,0,0,6,3,3,4,SEPTEMBER
SULAWESI BARAT,MAMASA,MEHALAAN,MEHALAAN BARAT,38,61,19,11,2,2,1,6,0,9,10,6,1,0,1,0,30,30,0,4,10,5,5,0,0,0,0,0,SEPTEMBER
SULAWESI BARAT,MAMASA,MEHALAAN,SALUAHOK,63,35,12,2,2,1,0,10,2,0,6,3,8,5,3,4,29,16,13,16,25,11,14,5,10,7,3,10,SEPTEMBER
SULAWESI BARAT,MAMASA,MEHALAAN,SALUBALO,80,25,13,13,0,0,0,10,0,1,13,0,14,0,14,0,17,12,5,2,5,5,0,5,11,10,1,6,SEPTEMBER
SULAWESI BARAT,MAMASA,MEHALAAN,PASSEMBUK,40,18,1,0,0,0,0,0,0,1,0,0,6,0,6,0,16,12,4,10,0,0,0,0,11,3,8,4,SEPTEMBER
SULAWESI BARAT,MAMASA,MEHALAAN,KONDO,69,41,35,17,1,0,0,0,5,11,1,32,11,0,11,0,31,22,9,5,28,8,20,6,44,17,27,17,SEPTEMBER
SULAWESI BARAT,MAMASA,MEHALAAN,LEKO SUKAMAJU,70,41,2,1,0,0,0,0,2,0,1,0,14,4,10,0,20,17,3,6,5,3,2,3,20,19,1,15,SEPTEMBER
SULAWESI BARAT,MAMASA,MEHALAAN,ULUMEA,90,26,23,19,8,2,1,19,2,1,16,1,14,6,8,2,21,12,9,10,16,13,3,13,21,3,18,2,SEPTEMBER
SULAWESI BARAT,MAMASA,MESSAWA,MESSAWA,98,35,26,4,3,1,0,15,10,1,4,14,5,0,5,0,33,23,10,14,18,14,4,14,23,14,9,22,SEPTEMBER
SULAWESI BARAT,MAMASA,MESSAWA,RIPPUNG,89,31,24,9,3,3,1,1,17,4,17,7,11,7,4,7,14,12,2,12,7,2,5,1,26,20,6,18,SEPTEMBER
SULAWESI BARAT,MAMASA,MESSAWA,MAKUANG,80,52,3,0,0,0,0,3,0,0,3,0,15,4,11,1,49,41,8,13,11,10,1,0,33,1,32,24,SEPTEMBER
SULAWESI BARAT,MAMASA,MESSAWA,SEPANG,40,28,10,5,4,2,2,1,0,2,1,3,1,1,0,1,26,10,16,0,17,3,14,3,7,4,3,5,SEPTEMBER
SULAWESI BARAT,MAMASA,MESSAWA,MALIMBONG,67,63,41,0,0,0,0,33,7,1,21,1,5,2,3,0,22,20,2,20,18,4,14,4,17,8,9,16,SEPTEMBER
SULAWESI BARAT,MAMASA,MESSAWA,MATANDE,83,50,16,13,8,5,3,11,2,0,11,5,3,3,0,0,17,7,10,3,0,0,0,0,2,0,2,1,SEPTEMBER
SULAWESI BARAT,MAMASA,MESSAWA,SIPAI,74,47,35,5,4,0,0,35,0,0,8,2,1,1,0,1,25,7,18,2,5,3,2,2,37,10,27,8,SEPTEMBER
SULAWESI BARAT,MAMASA,MESSAWA,PASMA MAMBU,74,41,20,14,12,12,4,12,0,1,9,2,9,8,1,5,16,11,5,6,13,9,4,2,34,21,13,31,SEPTEMBER
SULAWESI BARAT,MAMASA,MESSAWA,TANETE BATU,86,53,40,5,1,1,0,7,1,4,29,2,5,4,1,0,18,13,5,5,18,11,7,8,29,7,22,10,SEPTEMBER
SULAWESI BARAT,MAMASA,NOSU,NOSU,77,14,12,7,0,0,0,0,7,2,1,7,7,3,4,1,10,5,5,5,3,3,0,2,3,2,1,0,SEPTEMBER
SULAWESI BARAT,MAMASA,NOSU,MINANGA,43,29,26,17,17,14,12,7,1,1,22,4,6,2,4,0,11,9,2,3,1,0,1,0,13,0,13,1,SEPTEMBER
SULAWESI BARAT,MAMASA,NOSU,BATUPAPAN,43,18,15,11,10,8,7,0,3,5,7,5,7,6,1,6,11,11,0,5,3,3,0,1,1,0,1,0,SEPTEMBER
SULAWESI BARAT,MAMASA,NOSU,MASEWWE,68,24,24,3,2,2,1,15,1,6,16,6,12,10,2,4,10,5,5,3,9,1,8,0,12,5,7,6,SEPTEMBER
SULAWESI BARAT,MAMASA,NOSU,SIWI,49,77,56,13,12,4,4,52,0,0,13,30,5,4,1,2,14,6,8,1,2,2,0,0,9,4,5,7,SEPTEMBER
SULAWESI BARAT,MAMASA,NOSU,MINANGA TIMUR,60,23,6,5,3,1,1,4,1,0,6,0,4,2,2,2,19,12,7,12,19,19,0,18,35,26,9,32,SEPTEMBER
SULAWESI BARAT,MAMASA,NOSU,PARINDING,59,68,10,2,0,0,0,8,0,0,0,0,4,3,1,3,32,29,3,17,23,15,8,3,43,19,24,6,SEPTEMBER
SULAWESI BARAT,MAMASA,PANA,PANA,46,36,32,10,10,8,6,24,2,0,20,10,7,1,6,1,35,17,18,1,28,7,21,1,30,24,6,13,SEPTEMBER
SULAWESI BARAT,MAMASA,PANA,MANIPI,79,75,41,35,4,3,0,27,12,1,4,16,7,4,3,3,17,9,8,7,12,3,9,3,49,6,43,45,SEPTEMBER
SULAWESI BARAT,MAMASA,PANA,MAMULLU,59,14,6,5,3,3,2,3,1,0,5,1,3,1,2,0,12,12,0,12,3,2,1,1,5,3,2,2,SEPTEMBER
SULAWESI BARAT,MAMASA,PANA,SAPAN,93,70,37,6,2,1,1,9,25,0,29,1,8,2,6,1,69,29,40,14,17,0,17,0,31,21,10,0,SEPTEMBER
SULAWESI BARAT,MAMASA,PANA,DATUBARINGAN,77,68,19,10,7,5,2,6,6,4,14,0,14,12,2,10,24,17,7,2,0,0,0,0,12,6,6,11,SEPTEMBER
SULAWESI BARAT,MAMASA,PANA,PANURA,50,16,12,9,6,5,5,1,6,0,12,0,7,6,1,2,14,14,0,14,0,0,0,0,8,7,1,3,SEPTEMBER
SULAWESI BARAT,MAMASA,PANA,TALLANG BULAWAN,96,28,17,3,1,0,0,6,6,5,1,0,15,1,14,1,11,9,2,4,5,4,1,2,14,8,6,14,SEPTEMBER
SULAWESI BARAT,MAMASA,PANA,KARAKA,85,12,12,9,1,0,0,12,0,0,10,0,9,5,4,2,11,8,3,2,9,3,6,0,2,0,2,2,SEPTEMBER
SULAWESI BARAT,MAMASA,PANA,ULUSALU,61,53,27,9,8,8,4,9,7,7,27,0,9,3,6,2,25,15,10,9,22,13,9,11,23,16,7,2,SEPTEMBER
SULAWESI BARAT,MAMASA,PANA,WERI,55,49,6,3,3,2,0,6,0,0,2,0,10,2,8,2,31,12,19,9,7,2,5,0,38,6,32,11,SEPTEMBER
SULAWESI BARAT,MAMASA,PANA,SALUTAMBUN,75,44,30,10,4,2,2,22,0,2,23,4,1,1,0,0,32,24,8,11,32,20,12,0,18,9,9,13,SEPTEMBER
SULAWESI BARAT,MAMASA,PANA,SALOAN,32,71,68,58,2,0,0,4,6,49,28,4,2,1,1,1,51,28,23,15,26,11,15,4,40,34,6,22,SEPTEMBER
SULAWESI BARAT,MAMASA,PANA,ULUSALU INDAH,89,53,40,24,14,0,0,26,14,0,6,28,0,0,0,0,12,9,3,6,4,3,1,0,14,4,10,13,SEPTEMBER
SULAWESI BARAT,MAMASA,RANTEBULAHAN TIMUR,SALUMOKANAN,56,75,72,40,30,6,1,53,12,0,42,13,9,5,4,3,60,43,17,31,1,0,1,0,53,52,1,40,SEPTEMBER
SULAWESI BARAT,MAMASA,RANTEBULAHAN TIMUR,SALUMOKANAN BARAT,72,67,30,28,17,0,0,24,3,3,20,1,12,1,11,0,29,23,6,9,16,16,0,2,10,7,3,3,SEPTEMBER
SULAWESI BARAT,MAMASA,RANTEBULAHAN TIMUR,BUANGIN,65,20,5,4,1,0,0,0,5,0,2,2,9,1,8,0,11,7,4,5,9,8,1,7,8,6,2,7,SEPTEMBER
SULAWESI BARAT,MAMASA,RANTEBULAHAN TIMUR,BAMBANG BUDA,40,51,34,23,10,8,6,13,11,3,1,15,3,3,0,3,41,23,18,12,15,9,6,6,13,6,7,6,SEPTEMBER
SULAWESI BARAT,MAMASA,RANTEBULAHAN TIMUR,LEKO,30,53,3,1,1,1,0,1,0,0,3,0,3,1,2,0,43,34,9,26,30,9,21,3,1,0,1,0,SEPTEMBER
SULAWESI BARAT,MAMASA,RANTEBULAHAN TIMUR,KIRAK,86,27,3,2,1,0,0,3,0,0,3,0,9,3,6,1,10,5,5,1,4,1,3,0,7,6,1,1,SEPTEMBER
SULAWESI BARAT,MAMASA,RANTEBULAHAN TIMUR,SALUMOKANAN UTARA,68,45,18,10,0,0,0,18,0,0,3,9,4,4,0,4,33,22,11,3,0,0,0,0,30,8,22,5,SEPTEMBER
SULAWESI BARAT,MAMASA,RANTEBULAHAN TIMUR,SAMPALE,53,45,36,3,3,1,1,30,4,1,5,8,7,7,0,4,10,5,5,4,7,7,0,5,3,0,3,0,SEPTEMBER
SULAWESI BARAT,MAMASA,SESENAPADANG,OROBUA,55,44,35,9,7,1,0,2,6,26,16,4,10,3,7,3,18,16,2,5,8,4,4,4,29,21,8,24,SEPTEMBER
SULAWESI BARAT,MAMASA,SESENAPADANG,PALADAN,76,19,13,1,0,0,0,7,3,2,8,1,11,8,3,8,19,19,0,1,9,0,9,0,19,16,3,3,SEPTEMBER
SULAWESI BARAT,MAMASA,SESENAPADANG,OROBUA TIMUR,49,15,12,3,2,1,0,10,1,1,4,0,3,2,1,1,12,11,1,8,8,0,8,0,9,0,9,8,SEPTEMBER
SULAWESI BARAT,MAMASA,SESENAPADANG,RANTE PUANG,36,32,32,15,8,6,2,30,0,0,24,7,0,0,0,0,30,16,14,13,12,8,4,6,32,17,15,4,SEPTEMBER
SULAWESI BARAT,MAMASA,SESENAPADANG,SATENETEAN,60,44,32,3,3,0,0,15,7,7,27,2,11,5,6,1,13,7,6,5,3,1,2,0,12,3,9,11,SEPTEMBER
SULAWESI BARAT,MAMASA,SESENAPADANG,LISUAN ADA,86,63,3,2,2,2,1,1,0,0,0,2,12,2,10,0,33,20,13,18,18,13,5,11,41,12,29,5,SEPTEMBER
SULAWESI BARAT,MAMASA,SESENAPADANG,OROBUA SELATAN,37,23,21,20,17,3,0,15,1,0,13,7,4,1,3,1,10,10,0,7,5,4,1,1,14,5,9,4,SEPTEMBER
SULAWESI BARAT,MAMASA,SESENAPADANG,MALANGKENA PADANG,92,20,11,0,0,0,0,8,0,0,10,1,12,3,9,0,16,11,5,8,9,7,2,4,17,3,14,6,SEPTEMBER
SULAWESI BARAT,MAMASA,SESENAPADANG,MALIMBONG,74,52,26,5,5,1,0,12,5,0,0,0,8,6,2,6,52,10,42,2,6,3,3,3,18,4,14,2,SEPTEMBER
SULAWESI BARAT,MAMASA,SESENAPADANG,MARAMPAN OROBUA,45,37,32,22,19,6,1,14,7,0,23,0,8,3,5,3,22,22,0,2,12,9,3,8,11,8,3,5,SEPTEMBER
SULAWESI BARAT,MAMASA,SUMARORONG,SUMARORONG,35,27,6,6,0,0,0,1,4,1,0,0,3,3,0,0,13,6,7,3,5,0,5,0,4,2,2,3,SEPTEMBER
SULAWESI BARAT,MAMASA,SUMARORONG,TABONE,46,58,16,11,9,0,0,4,3,1,10,4,5,4,1,3,15,12,3,10,5,4,1,1,44,9,35,25,SEPTEMBER
SULAWESI BARAT,MAMASA,SUMARORONG,BATANG URU,76,30,21,21,5,3,1,20,0,0,4,8,9,5,4,2,16,11,5,0,1,1,0,0,22,7,15,11,SEPTEMBER
SULAWESI BARAT,MAMASA,SUMARORONG,SASAKAN,35,53,13,7,1,0,0,12,1,0,8,1,5,4,1,4,23,9,14,8,1,1,0,1,32,27,5,12,SEPTEMBER
SULAWESI BARAT,MAMASA,SUMARORONG,TADISI,48,71,5,1,1,0,0,2,2,1,2,1,6,2,4,0,11,8,3,5,1,0,1,0,40,38,2,2,SEPTEMBER
SULAWESI BARAT,MAMASA,SUMARORONG,SIBANAWA,34,40,38,18,13,1,0,26,7,5,23,2,4,1,3,1,19,15,4,3,13,12,1,8,26,20,6,10,SEPTEMBER
SULAWESI BARAT,MAMASA,SUMARORONG,BATANGNGURU TIMUR,83,14,14,6,5,4,3,6,0,5,1,6,12,9,3,8,13,12,1,9,6,3,3,2,9,5,4,6,SEPTEMBER
SULAWESI BARAT,MAMASA,SUMARORONG,SALUBALO,83,41,36,21,21,2,0,29,7,0,8,25,15,7,8,0,21,5,16,2,1,0,1,0,17,13,4,6,SEPTEMBER
SULAWESI BARAT,MAMASA,SUMARORONG,BANEA,100,12,8,1,0,0,0,4,2,0,0,4,6,3,3,0,10,5,5,1,10,6,4,6,2,0,2,2,SEPTEMBER
SULAWESI BARAT,MAMASA,SUMARORONG,RANTE KAMASE,79,66,58,39,0,0,0,37,15,2,6,32,8,7,1,2,59,36,23,13,57,12,45,0,12,7,5,2,SEPTEMBER
SULAWESI BARAT,MAMASA,TABANG,TABANG,62,41,28,1,0,0,0,23,2,1,1,19,12,7,5,7,15,5,10,2,14,8,6,0,11,10,1,9,SEPTEMBER
SULAWESI BARAT,MAMASA,TABANG,TADOKALUA,76,48,5,5,0,0,0,5,0,0,2,1,10,1,9,0,43,24,19,4,3,0,3,0,34,11,23,10,SEPTEMBER
SULAWESI BARAT,MAMASA,TABANG,TABANG BARAT,41,76,30,4,3,1,1,28,0,1,11,10,3,0,3,0,26,12,14,8,3,1,2,0,3,0,3,0,SEPTEMBER
SULAWESI BARAT,MAMASA,TABANG,MASUPU,74,27,16,7,7,4,3,6,3,1,8,8,5,3,2,0,24,23,1,10,20,8,12,6,0,0,0,0,SEPTEMBER
SULAWESI BARAT,MAMASA,TABANG,KALAMA,71,23,7,5,5,3,2,3,1,0,0,6,4,2,2,0,23,9,14,8,14,14,0,9,5,2,3,1,SEPTEMBER
SULAWESI BARAT,MAMASA,TABANG,BAKADISURA,35,71,64,11,7,4,1,7,48,4,45,16,2,0,2,0,45,32,13,9,15,3,12,0,10,2,8,1,SEPTEMBER
SULAWESI BARAT,MAMASA,TABANG,SALUKONA,50,42,24,2,0,0,0,5,13,6,3,2,10,10,0,6,34,14,20,10,25,17,8,7,19,10,9,8,SEPTEMBER
SULAWESI BARAT,MAMASA,TABULAHAN,LAKAHANG,87,73,53,24,7,3,2,37,0,3,18,24,17,11,6,3,72,29,43,8,60,40,20,38,104,72,32,54,SEPTEMBER
SULAWESI BARAT,MAMASA,TABULAHAN,PERIANGAN,52,31,19,9,1,0,0,1,7,4,17,0,0,0,0,0,25,14,11,8,15,9,6,2,29,26,3,10,SEPTEMBER
SULAWESI BARAT,MAMASA,TABULAHAN,MALATIRO,45,67,37,34,7,5,3,5,21,6,29,3,2,0,2,0,13,13,0,12,6,6,0,2,24,13,11,23,SEPTEMBER
SULAWESI BARAT,MAMASA,TABULAHAN,TABULAHAN,61,50,30,22,13,8,0,23,6,1,14,11,8,4,4,1,33,10,23,5,2,2,0,1,2,2,0,0,SEPTEMBER
SULAWESI BARAT,MAMASA,TABULAHAN,SALULEANG,82,37,17,16,1,0,0,14,1,1,5,0,9,3,6,1,12,10,2,0,5,4,1,1,30,0,30,24,SEPTEMBER
SULAWESI BARAT,MAMASA,TABULAHAN,TAMPAK KURRA,41,73,18,0,0,0,0,2,2,11,12,0,1,0,1,0,24,13,11,11,10,7,3,5,50,36,14,49,SEPTEMBER
SULAWESI BARAT,MAMASA,TABULAHAN,GANDANG DEWATA,89,27,13,9,8,4,0,2,6,4,3,1,1,0,1,0,14,13,1,4,5,0,5,0,14,7,7,9,SEPTEMBER
SULAWESI BARAT,MAMASA,TABULAHAN,BURANA,96,20,8,7,3,0,0,2,0,0,8,0,2,1,1,0,18,9,9,0,5,1,4,0,7,1,6,2,SEPTEMBER
SULAWESI BARAT,MAMASA,TABULAHAN,SALUBAKKA,66,26,9,9,3,0,0,6,1,0,9,0,1,0,1,0,19,6,13,5,15,2,13,0,22,12,10,8,SEPTEMBER
SULAWESI BARAT,MAMASA,TABULAHAN,PANGANDARAN,100,36,11,7,2,1,0,1,2,7,3,0,9,1,8,1,27,25,2,18,18,7,11,1,6,0,6,5,SEPTEMBER
SULAWESI BARAT,MAMASA,TABULAHAN,TALOPAK,35,44,24,18,18,5,3,4,13,1,20,1,6,3,3,3,41,38,3,19,34,12,22,5,22,11,11,8,SEPTEMBER
SULAWESI BARAT,MAMASA,TABULAHAN,PEU',53,44,5,2,2,1,1,2,2,0,0,3,10,9,1,7,22,13,9,7,9,7,2,4,31,22,9,8,SEPTEMBER
SULAWESI BARAT,MAMASA,TABULAHAN,TIMORO,33,54,45,18,8,3,3,7,1,34,18,1,3,2,1,1,16,10,6,0,16,4,12,0,28,11,17,20,SEPTEMBER
SULAWESI BARAT,MAMASA,TABULAHAN,LAKAHANG UTAMA,31,42,42,6,1,1,1,31,3,0,28,10,4,1,3,0,13,13,0,8,1,0,1,0,1,0,1,1,SEPTEMBER
SULAWESI BARAT,MAMASA,TANDUK KALUA,MINAKE,86,74,51,21,4,1,0,32,8,2,14,3,9,5,4,5,13,9,4,1,5,2,3,0,40,37,3,31,SEPTEMBER
SULAWESI BARAT,MAMASA,TANDUK KALUA,MALABO,32,54,16,3,1,1,1,1,6,7,13,3,0,0,0,0,48,13,35,9,26,14,12,8,59,6,53,11,SEPTEMBER
SULAWESI BARAT,MAMASA,TANDUK KALUA,SINDAGAMANIK,93,52,3,3,2,0,0,0,3,0,1,1,13,6,7,4,22,9,13,7,10,1,9,1,35,10,25,1,SEPTEMBER
SULAWESI BARAT,MAMASA,TANDUK KALUA,PARONDOBULAWAN,66,33,29,5,3,2,1,23,3,1,22,7,4,1,3,0,26,12,14,2,19,9,10,0,12,8,4,2,SEPTEMBER
SULAWESI BARAT,MAMASA,TANDUK KALUA,TAMALANTIK,88,75,56,20,12,3,1,17,27,4,26,18,5,5,0,1,45,8,37,7,40,0,40,0,5,4,1,2,SEPTEMBER
SULAWESI BARAT,MAMASA,TANDUK KALUA,MANNABABA,72,32,25,3,3,0,0,3,13,8,24,1,12,12,0,9,13,9,4,5,10,5,5,3,8,7,1,1,SEPTEMBER
SULAWESI BARAT,MAMASA,TANDUK KALUA,MESAKADA,30,19,12,10,3,3,0,10,0,1,6,1,6,5,1,1,12,6,6,6,9,8,1,5,6,5,1,1,SEPTEMBER
SULAWESI BARAT,MAMASA,TANDUK KALUA,BALLABATU,86,56,38,12,8,8,5,20,12,0,7,8,15,4,11,4,33,16,17,10,5,2,3,0,25,21,4,24,SEPTEMBER
SULAWESI BARAT,MAMASA,TANDUK KALUA,PAMBE,91,16,14,0,0,0,0,13,0,1,3,7,13,6,7,2,13,6,7,5,3,1,2,1,5,3,2,5,SEPTEMBER
SULAWESI BARAT,MAMASA,TANDUK KALUA,SALURANO,95,48,13,4,1,0,0,1,2,0,2,3,13,12,1,9,10,6,4,6,6,5,1,2,28,27,1,11,SEPTEMBER
SULAWESI BARAT,MAMASA,TANDUK KALUA,TALIMBUNG,97,36,24,3,0,0,0,12,8,2,17,2,19,12,7,1,28,7,21,7,8,5,3,4,30,30,0,24,SEPTEMBER
SULAWESI BARAT,MAMASA,TANDUK KALUA,KANAN,79,68,32,13,2,2,1,26,2,1,32,0,10,1,9,1,39,33,6,21,15,4,11,1,12,5,7,0,SEPTEMBER
SULAWESI BARAT,MAMASA,TAWALIAN,TAWALIAN,52,25,6,1,0,0,0,6,0,0,4,0,5,1,4,1,24,12,12,3,2,0,2,0,2,2,0,2,SEPTEMBER
SULAWESI BARAT,MAMASA,TAWALIAN,TAWALIAN TIMUR,38,24,24,4,4,3,0,18,2,4,3,2,5,2,3,1,11,8,3,0,3,0,3,0,1,1,0,0,SEPTEMBER
SULAWESI BARAT,MAMASA,TAWALIAN,KARIANGO,96,78,6,1,0,0,0,3,0,0,6,0,5,0,5,0,53,44,9,31,24,3,21,2,66,32,34,30,SEPTEMBER
SULAWESI BARAT,MAMASA,TAWALIAN,RANTETANGNGA,51,24,5,3,3,3,3,1,0,0,1,3,1,1,0,1,23,18,5,6,15,5,10,0,17,5,12,13,SEPTEMBER
SULAWESI BARAT,POLEWALI MANDAR,ALLU,PETOOSANG,63,79,3,2,0,0,0,0,2,0,1,2,1,1,0,0,58,15,43,0,42,35,7,13,10,4,6,2,SEPTEMBER
SULAWESI BARAT,POLEWALI MANDAR,ALLU,MOMBI,72,10,3,0,0,0,0,3,0,0,1,1,9,1,8,1,10,5,5,4,9,0,9,0,1,1,0,1,SEPTEMBER
SULAWESI BARAT,POLEWALI MANDAR,ALLU,KALUMAMMANG,63,36,2,2,0,0,0,2,0,0,2,0,6,5,1,0,14,5,9,3,5,2,3,1,20,5,15,3,SEPTEMBER
SULAWESI BARAT,POLEWALI MANDAR,ALLU,PAO-PAO,49,56,25,15,14,14,1,1,0,22,3,13,4,3,1,2,27,15,12,1,26,4,22,3,25,22,3,24,SEPTEMBER
SULAWESI BARAT,POLEWALI MANDAR,ALLU,PUPPU URING,31,57,12,9,9,2,0,3,7,1,10,0,1,1,0,1,18,10,8,10,9,0,9,0,14,12,2,10,SEPTEMBER
SULAWESI BARAT,POLEWALI MANDAR,ALLU,SARAGIAN,43,34,9,9,0,0,0,5,1,2,1,6,8,4,4,1,23,15,8,7,20,6,14,1,3,0,3,2,SEPTEMBER
SULAWESI BARAT,POLEWALI MANDAR,ALLU,SAYOANG,87,35,27,5,4,0,0,16,1,3,14,6,0,0,0,0,31,6,25,6,5,4,1,1,1,1,0,0,SEPTEMBER
SULAWESI BARAT,POLEWALI MANDAR,ALLU,ALU,45,36,26,23,19,17,10,15,0,0,25,1,7,0,7,0,21,16,5,6,2,2,0,1,22,19,3,22,SEPTEMBER
SULAWESI BARAT,POLEWALI MANDAR,ANREAPI,ANREAPI,67,18,10,0,0,0,0,10,0,0,10,0,10,6,4,2,16,11,5,7,3,2,1,1,3,3,0,2,SEPTEMBER
SULAWESI BARAT,POLEWALI MANDAR,ANREAPI,DUAMPANUA,99,50,48,18,7,5,4,12,7,1,40,1,5,5,0,0,17,12,5,10,10,1,9,1,4,1,3,1,SEPTEMBER
SULAWESI BARAT,POLEWALI MANDAR,ANREAPI,KELAPA DUA,94,68,24,16,5,3,0,7,8,2,5,10,12,10,2,8,52,25,27,15,36,23,13,17,15,1,14,5,SEPTEMBER
SULAWESI BARAT,POLEWALI MANDAR,ANREAPI,PAPPANDANGAN,43,11,9,3,3,3,2,3,4,0,1,8,6,4,2,1,11,10,1,9,4,1,3,1,9,0,9,6,SEPTEMBER
SULAWESI BARAT,POLEWALI MANDAR,ANREAPI,KUNYI,100,41,24,20,4,1,0,0,20,1,2,1,19,8,11,3,12,6,6,5,2,0,2,0,5,0,5,5,SEPTEMBER
SULAWESI BARAT,POLEWALI MANDAR,BALANIPA,BALANIPA,75,48,16,2,1,1,1,11,4,0,3,3,12,4,8,1,21,6,15,6,18,9,9,8,38,5,33,8,SEPTEMBER
SULAWESI BARAT,POLEWALI MANDAR,BALANIPA,TAMMAJARRA,78,67,51,3,1,0,0,21,9,20,51,0,13,4,9,3,32,6,26,4,9,9,0,4,43,34,9,11,SEPTEMBER
SULAWESI BARAT,POLEWALI MANDAR,BALANIPA,TAMANGGALLE,53,25,5,4,2,2,0,4,0,0,2,3,9,4,5,2,21,7,14,7,20,1,19,0,19,6,13,6,SEPTEMBER
SULAWESI BARAT,POLEWALI MANDAR,BALANIPA,MOSSO,62,22,17,3,0,0,0,8,3,2,12,1,0,0,0,0,22,13,9,7,7,6,1,3,22,6,16,3,SEPTEMBER
SULAWESI BARAT,POLEWALI MANDAR,BALANIPA,GALUNG TULUK,43,36,24,8,7,7,7,3,7,4,9,5,4,0,4,0,31,18,13,3,23,12,11,0,44,41,3,25,SEPTEMBER
SULAWESI BARAT,POLEWALI MANDAR,BALANIPA,SABANG SUBIK,68,19,17,1,0,0,0,13,2,2,16,0,4,2,2,0,13,8,5,5,7,5,2,1,7,5,2,6,SEPTEMBER
SULAWESI BARAT,POLEWALI MANDAR,BALANIPA,PAMBUSUANG,92,55,13,4,0,0,0,9,1,0,13,0,4,0,4,0,17,10,7,1,10,1,9,0,12,9,3,8,SEPTEMBER
SULAWESI BARAT,POLEWALI MANDAR,BALANIPA,BALA,36,76,26,18,2,1,0,15,8,1,19,5,3,0,3,0,43,16,27,2,30,19,11,14,5,5,0,1,SEPTEMBER
SULAWESI BARAT,POLEWALI MANDAR,BALANIPA,LAMBANAN,86,72,72,39,6,4,1,11,17,1,16,31,2,0,2,0,27,19,8,10,4,2,2,2,48,36,12,33,SEPTEMBER
SULAWESI BARAT,POLEWALI MANDAR,BALANIPA,LEGO,45,34,28,10,5,0,0,7,16,4,16,9,3,1,2,1,25,21,4,5,10,2,8,0,19,11,8,12,SEPTEMBER
SULAWESI BARAT,POLEWALI MANDAR,BALANIPA,PALLIS,90,18,2,2,1,0,0,0,2,0,2,0,13,1,12,0,17,14,3,10,2,2,0,0,3,3,0,2,SEPTEMBER
SULAWESI BARAT,POLEWALI MANDAR,BINUANG,AMASSANGAN,88,19,5,4,1,0,0,4,1,0,1,0,5,1,4,1,12,11,1,10,1,1,0,0,3,0,3,2,SEPTEMBER
SULAWESI BARAT,POLEWALI MANDAR,BINUANG,TONYAMAN,74,38,29,1,0,0,0,13,8,7,25,0,5,5,0,3,17,13,4,9,10,7,3,2,17,14,3,11,SEPTEMBER
SULAWESI BARAT,POLEWALI MANDAR,BINUANG,KUAJANG,41,50,46,41,8,6,1,17,1,14,10,8,0,0,0,0,10,6,4,3,3,2,1,0,28,16,12,12,SEPTEMBER
SULAWESI BARAT,POLEWALI MANDAR,BINUANG,PAKU,50,29,4,2,0,0,0,1,1,2,4,0,2,1,1,0,25,12,13,8,6,1,5,1,4,4,0,0,SEPTEMBER
SULAWESI BARAT,POLEWALI MANDAR,BINUANG,MIRRING,98,49,28,23,15,2,2,25,1,0,26,2,7,4,3,2,23,9,14,0,2,2,0,2,22,18,4,9,SEPTEMBER
SULAWESI BARAT,POLEWALI MANDAR,BINUANG,BATETANGNGA,58,32,13,1,0,0,0,4,8,1,2,7,2,0,2,0,15,8,7,1,3,1,2,0,13,11,2,5,SEPTEMBER
SULAWESI BARAT,POLEWALI MANDAR,BINUANG,MAMMI,90,45,11,11,9,1,1,9,1,0,7,0,9,4,5,0,13,9,4,4,2,1,1,0,28,26,2,11,SEPTEMBER
SULAWESI BARAT,POLEWALI MANDAR,BINUANG,KALEOK,48,19,17,10,8,8,4,6,1,3,4,8,5,0,5,0,10,6,4,1,9,0,9,0,22,9,13,10,SEPTEMBER
SULAWESI BARAT,POLEWALI MANDAR,BINUANG,AMOLA,64,26,11,5,1,1,0,7,0,4,8,1,8,6,2,3,14,9,5,8,11,10,1,7,10,5,5,5,SEPTEMBER
SULAWESI BARAT,POLEWALI MANDAR,BINUANG,REA,81,78,76,57,1,0,0,71,4,1,3,57,13,12,1,6,29,6,23,1,8,5,3,5,29,21,8,15,SEPTEMBER
SULAWESI BARAT,POLEWALI MANDAR,BULO,BULO,61,60,52,51,48,1,0,47,0,2,26,19,8,0,8,0,36,7,29,4,11,2,9,1,37,32,5,29,SEPTEMBER
SULAWESI BARAT,POLEWALI MANDAR,BULO,PULLIWA,43,58,58,48,28,0,0,23,8,17,29,25,1,0,1,0,37,7,30,4,4,4,0,4,13,8,5,12,SEPTEMBER
SULAWESI BARAT,POLEWALI MANDAR,BULO,PATAMBANUA,42,11,1,1,0,0,0,0,0,0,1,0,4,3,1,2,10,6,4,0,2,2,0,2,9,9,0,4,SEPTEMBER
SULAWESI BARAT,POLEWALI MANDAR,BULO,KAROMBANG,49,61,38,27,25,11,7,1,13,4,16,16,2,1,1,0,20,19,1,14,9,0,9,0,29,13,16,8,SEPTEMBER
SULAWESI BARAT,POLEWALI MANDAR,BULO,DAALA TIMUR,53,61,11,3,2,0,0,6,0,5,2,9,2,1,1,0,19,5,14,5,16,11,5,4,55,28,27,24,SEPTEMBER
SULAWESI BARAT,POLEWALI MANDAR,BULO,LENGGO,80,59,8,5,5,3,3,0,0,0,4,0,3,3,0,2,43,16,27,11,1,1,0,1,15,15,0,1,SEPTEMBER
SULAWESI BARAT,POLEWALI MANDAR,BULO,SABURA,61,28,6,0,0,0,0,1,2,1,6,0,9,7,2,0,25,13,12,4,24,10,14,1,32,12,20,7,SEPTEMBER
SULAWESI BARAT,POLEWALI MANDAR,BULO,SEPPORRAKI,78,67,25,25,0,0,0,14,4,6,12,1,8,4,4,1,49,18,31,17,9,4,5,4,33,15,18,6,SEPTEMBER
SULAWESI BARAT,POLEWALI MANDAR,BULO,IHING,50,35,27,3,2,0,0,20,5,1,20,0,8,2,6,1,34,22,12,17,10,8,2,6,30,25,5,20,SEPTEMBER
SULAWESI BARAT,POLEWALI MANDAR,CAMPALAGIAN,PAPPANG,100,20,13,6,6,4,4,9,0,0,10,3,18,10,8,3,12,11,1,8,1,0,1,0,14,0,14,10,SEPTEMBER
SULAWESI BARAT,POLEWALI MANDAR,CAMPALAGIAN,LALIKO,58,28,13,10,7,3,1,3,0,8,1,10,1,1,0,1,11,9,2,9,3,1,2,1,1,1,0,1,SEPTEMBER
SULAWESI BARAT,POLEWALI MANDAR,CAMPALAGIAN,BONDE,55,44,24,9,6,4,4,3,13,1,24,0,5,5,0,0,41,18,23,0,22,20,2,7,0,0,0,0,SEPTEMBER
SULAWESI BARAT,POLEWALI MANDAR,CAMPALAGIAN,KATUMBANGAN LEMO,94,41,26,19,8,4,1,7,18,0,8,9,5,0,5,0,14,11,3,0,6,2,4,0,16,1,15,15,SEPTEMBER
SULAWESI BARAT,POLEWALI MANDAR,CAMPALAGIAN,PANYAMPA,90,54,33,20,14,12,9,19,3,1,16,5,5,4,1,1,43,5,38,2,0,0,0,0,3,1,2,2,SEPTEMBER
SULAWESI BARAT,POLEWALI MANDAR,CAMPALAGIAN,SURUANG,87,25,8,0,0,0,0,3,4,1,6,1,2,2,0,1,24,18,6,11,15,0,15,0,22,1,21,20,SEPTEMBER
SULAWESI BARAT,POLEWALI MANDAR,CAMPALAGIAN,LAMPOKO,53,51,13,8,6,1,1,9,0,3,3,2,9,6,3,6,20,11,9,9,4,3,1,1,14,10,4,9,SEPTEMBER
SULAWESI BARAT,POLEWALI MANDAR,CAMPALAGIAN,KATUMBANGAN,35,45,33,3,3,1,1,25,3,1,30,1,2,2,0,0,12,11,1,6,7,5,2,3,35,20,15,19,SEPTEMBER
SULAWESI BARAT,POLEWALI MANDAR,CAMPALAGIAN,LAPEO,32,24,6,2,1,0,0,2,0,3,4,0,6,1,5,1,23,22,1,3,13,11,2,1,21,6,15,4,SEPTEMBER
SULAWESI BARAT,POLEWALI MANDAR,CAMPALAGIAN,PARAPPE,66,39,19,13,7,7,0,12,4,2,7,5,5,4,1,2,28,22,6,10,21,5,16,4,37,11,26,7,SEPTEMBER
SULAWESI BARAT,POLEWALI MANDAR,CAMPALAGIAN,ONGKO,46,76,49,25,10,6,2,8,29,8,21,21,0,0,0,0,47,26,21,3,43,2,41,1,26,1,25,19,SEPTEMBER
SULAWESI BARAT,POLEWALI MANDAR,CAMPALAGIAN,KENJE,58,71,58,7,3,3,2,12,24,1,28,10,1,1,0,0,41,25,16,1,2,2,0,2,2,1,1,0,SEPTEMBER
SULAWESI BARAT,POLEWALI MANDAR,CAMPALAGIAN,SUMARRANG,90,18,13,1,1,0,0,0,0,3,3,9,8,6,2,6,14,14,0,0,1,0,1,0,3,3,0,1,SEPTEMBER
SULAWESI BARAT,POLEWALI MANDAR,CAMPALAGIAN,BOTTO,56,31,2,0,0,0,0,2,0,0,2,0,4,2,2,0,26,11,15,6,3,3,0,0,14,11,3,6,SEPTEMBER
SULAWESI BARAT,POLEWALI MANDAR,CAMPALAGIAN,GATTUNGAN,42,33,23,22,3,3,2,4,12,4,9,3,7,3,4,1,10,8,2,2,7,4,3,3,17,0,17,10,SEPTEMBER
SULAWESI BARAT,POLEWALI MANDAR,CAMPALAGIAN,PADANG TIMUR,75,24,18,3,1,1,0,9,5,3,3,0,2,1,1,0,20,13,7,6,11,1,10,1,23,1,22,12,SEPTEMBER
SULAWESI BARAT,POLEWALI MANDAR,CAMPALAGIAN,PADANG,99,77,28,11,11,10,5,16,2,4,12,7,5,2,3,0,32,16,16,15,20,11,9,5,54,48,6,44,SEPTEMBER
SULAWESI BARAT,POLEWALI MANDAR,CAMPALAGIAN,LAGI-AGI,97,73,42,7,3,3,2,34,1,2,17,25,15,13,2,7,56,18,38,8,36,31,5,7,53,34,19,48,SEPTEMBER
SULAWESI BARAT,POLEWALI MANDAR,LIMBORO,LIMBORO,64,18,9,2,0,0,0,4,3,0,5,1,7,4,3,3,13,6,7,4,0,0,0,0,8,2,6,1,SEPTEMBER
SULAWESI BARAT,POLEWALI MANDAR,LIMBORO,LEMBANG LEMBANG,73,28,7,5,0,0,0,1,1,4,0,7,4,3,1,2,21,15,6,2,0,0,0,0,11,11,0,6,SEPTEMBER
SULAWESI BARAT,POLEWALI MANDAR,LIMBORO,TANDASURA,76,60,27,23,18,17,17,1,2,4,9,5,14,7,7,1,50,34,16,6,29,8,21,2,10,10,0,8,SEPTEMBER
SULAWESI BARAT,POLEWALI MANDAR,LIMBORO,SAMASUNDU,95,47,47,14,13,2,0,18,14,4,42,0,17,1,16,1,24,19,5,7,5,2,3,0,17,9,8,2,SEPTEMBER
SULAWESI BARAT,POLEWALI MANDAR,LIMBORO,NAPO,42,44,31,16,16,14,9,14,8,0,19,0,6,2,4,1,34,9,25,1,25,10,15,3,53,2,51,47,SEPTEMBER
SULAWESI BARAT,POLEWALI MANDAR,LIMBORO,TODANG TODANG,48,56,43,1,1,0,0,40,3,0,16,23,8,8,0,4,52,22,30,3,9,8,1,0,38,12,26,0,SEPTEMBER
SULAWESI BARAT,POLEWALI MANDAR,LIMBORO,PENDULANGAN,43,31,7,1,0,0,0,7,0,0,7,0,7,4,3,1,21,21,0,11,21,5,16,3,40,23,17,33,SEPTEMBER
SULAWESI BARAT,POLEWALI MANDAR,LIMBORO,RENGGEANG,95,21,0,0,0,0,0,0,0,0,0,0,2,1,1,0,14,9,5,0,13,9,4,3,22,3,19,4,SEPTEMBER
SULAWESI BARAT,POLEWALI MANDAR,LIMBORO,SALARRI,55,59,21,9,5,5,0,20,1,0,6,14,7,5,2,2,53,44,9,6,5,0,5,0,10,8,2,4,SEPTEMBER
SULAWESI BARAT,POLEWALI MANDAR,LIMBORO,TANGAN BARU,40,40,38,1,1,0,0,38,0,0,33,0,5,4,1,4,21,18,3,11,1,0,1,0,11,2,9,9,SEPTEMBER
SULAWESI BARAT,POLEWALI MANDAR,LIMBORO,PALECE,30,18,15,12,2,1,1,9,2,2,13,1,0,0,0,0,18,14,4,1,18,18,0,5,4,3,1,2,SEPTEMBER
SULAWESI BARAT,POLEWALI MANDAR,LUYO,BATUPANGA,45,71,58,52,27,12,12,43,3,0,17,31,4,0,4,0,36,36,0,5,23,1,22,0,67,48,19,22,SEPTEMBER
SULAWESI BARAT,POLEWALI MANDAR,LUYO,MAMBU,79,40,20,7,6,0,0,13,7,0,7,8,0,0,0,0,37,29,8,2,20,9,11,4,14,0,14,1,SEPTEMBER
SULAWESI BARAT,POLEWALI MANDAR,LUYO,TENGGELANG,97,67,1,0,0,0,0,0,1,0,1,0,16,15,1,1,15,14,1,2,6,1,5,1,46,22,24,11,SEPTEMBER
SULAWESI BARAT,POLEWALI MANDAR,LUYO,BARU,79,11,6,3,2,0,0,2,1,0,2,1,10,4,6,4,11,10,1,7,10,10,0,10,14,4,10,3,SEPTEMBER
SULAWESI BARAT,POLEWALI MANDAR,LUYO,PUSSUI,34,63,12,0,0,0,0,4,0,3,7,1,2,1,1,1,23,18,5,0,13,11,2,10,40,34,6,36,SEPTEMBER
SULAWESI BARAT,POLEWALI MANDAR,LUYO,MAPILI BARAT,71,77,74,38,14,3,0,12,24,25,32,22,13,8,5,4,27,12,15,10,16,4,12,3,19,13,6,13,SEPTEMBER
SULAWESI BARAT,POLEWALI MANDAR,LUYO,SAMBALI WALI,70,36,15,1,0,0,0,7,2,5,6,8,8,8,0,6,34,23,11,1,13,0,13,0,33,5,28,12,SEPTEMBER
SULAWESI BARAT,POLEWALI MANDAR,LUYO,BATUPANGA DAALA,79,32,16,9,3,3,2,14,0,0,2,1,4,2,2,0,14,10,4,8,5,5,0,4,21,7,14,17,SEPTEMBER
SULAWESI BARAT,POLEWALI MANDAR,LUYO,LUYO,42,41,35,17,16,5,5,28,2,0,0,28,5,1,4,1,15,6,9,3,1,1,0,1,5,4,1,2,SEPTEMBER
SULAWESI BARAT,POLEWALI MANDAR,LUYO,PUSSUI BARAT,30,43,19,19,7,5,4,10,0,0,4,13,5,1,4,1,31,18,13,11,15,6,9,1,22,8,14,0,SEPTEMBER
SULAWESI BARAT,POLEWALI MANDAR,LUYO,PUCCADI,35,27,3,3,2,0,0,2,1,0,0,2,0,0,0,0,25,11,14,6,10,9,1,9,8,0,8,0,SEPTEMBER
SULAWESI BARAT,POLEWALI MANDAR,MAPILLI,MAPILI,63,31,18,9,1,0,0,14,1,0,8,6,3,1,2,1,18,6,12,1,2,0,2,0,20,4,16,12,SEPTEMBER
SULAWESI BARAT,POLEWALI MANDAR,MAPILLI,UGIBARU,85,68,4,1,1,1,1,0,2,1,3,0,8,4,4,2,47,11,36,7,28,3,25,1,43,32,11,27,SEPTEMBER
SULAWESI BARAT,POLEWALI MANDAR,MAPILLI,RUMPA,52,23,11,7,3,3,1,4,4,1,0,3,1,1,0,0,18,18,0,5,18,6,12,5,19,19,0,11,SEPTEMBER
SULAWESI BARAT,POLEWALI MANDAR,MAPILLI,KURMA,46,53,28,20,8,6,0,19,6,1,2,23,8,1,7,1,50,31,19,30,49,16,33,4,60,57,3,29,SEPTEMBER
SULAWESI BARAT,POLEWALI MANDAR,MAPILLI,BUKU,97,47,40,20,15,3,0,22,9,8,24,1,0,0,0,0,17,13,4,7,15,4,11,1,0,0,0,0,SEPTEMBER
SULAWESI BARAT,POLEWALI MANDAR,MAPILLI,BONNE BONNE,86,22,20,12,6,1,0,10,3,2,15,2,4,0,4,0,14,6,8,1,2,0,2,0,9,1,8,3,SEPTEMBER
SULAWESI BARAT,POLEWALI MANDAR,MAPILLI,BEROANGIN,88,19,1,1,1,1,0,1,0,0,1,0,7,3,4,2,13,9,4,0,13,0,13,0,7,4,3,1,SEPTEMBER
SULAWESI BARAT,POLEWALI MANDAR,MAPILLI,SEGERANG,91,23,7,1,0,0,0,7,0,0,5,0,15,3,12,0,20,18,2,18,15,5,10,4,2,0,2,0,SEPTEMBER
SULAWESI BARAT,POLEWALI MANDAR,MAPILLI,BONRA,100,31,30,10,6,0,0,30,0,0,4,14,15,13,2,6,20,17,3,11,2,2,0,1,14,14,0,10,SEPTEMBER
SULAWESI BARAT,POLEWALI MANDAR,MAPILLI,SATTOKO,52,13,12,6,0,0,0,9,1,1,4,8,7,4,3,3,13,6,7,1,13,8,5,7,15,10,5,15,SEPTEMBER
SULAWESI BARAT,POLEWALI MANDAR,MAPILLI,RAPPANG BARAT,79,15,10,3,3,1,1,1,4,2,10,0,2,2,0,0,14,8,6,2,1,1,0,0,7,2,5,7,SEPTEMBER
SULAWESI BARAT,POLEWALI MANDAR,MAPILLI,LANDI KANUSUANG,63,43,8,5,2,0,0,7,0,0,1,1,12,8,4,1,29,21,8,9,1,1,0,0,21,9,12,10,SEPTEMBER
SULAWESI BARAT,POLEWALI MANDAR,MATAKALI,MATAKALI,40,69,37,37,1,1,1,4,15,3,19,17,1,1,0,1,43,27,16,1,38,37,1,1,6,4,2,0,SEPTEMBER
SULAWESI BARAT,POLEWALI MANDAR,MATAKALI,PETAMPANUA,91,10,6,1,1,1,0,0,0,4,6,0,0,0,0,0,10,6,4,0,0,0,0,0,5,1,4,0,SEPTEMBER
SULAWESI BARAT,POLEWALI MANDAR,MATAKALI,BARUMBUNG,35,60,52,2,0,0,0,27,19,4,7,35,1,1,0,1,19,16,3,1,4,0,4,0,10,2,8,2,SEPTEMBER
SULAWESI BARAT,POLEWALI MANDAR,MATAKALI,PASIANG,56,76,49,45,21,1,0,34,4,4,36,9,0,0,0,0,28,15,13,14,12,10,2,5,9,0,9,0,SEPTEMBER
SULAWESI BARAT,POLEWALI MANDAR,MATAKALI,TONROLIMA,55,77,13,1,1,0,0,6,7,0,11,1,4,0,4,0,36,9,27,9,13,7,6,6,36,6,30,13,SEPTEMBER
SULAWESI BARAT,POLEWALI MANDAR,MATAKALI,INDOMAKKOMBONG,46,80,43,29,21,10,10,15,13,4,29,1,8,1,7,0,57,5,52,5,34,34,0,15,25,14,11,4,SEPTEMBER
SULAWESI BARAT,POLEWALI MANDAR,MATAKALI,BUNGA-BUNGA,53,59,42,17,14,13,7,10,6,12,4,27,5,2,3,0,34,11,23,5,32,4,28,1,22,14,8,7,SEPTEMBER
SULAWESI BARAT,POLEWALI MANDAR,MATANGNGA,MATANGNGA,89,40,29,7,5,1,1,19,3,1,0,26,4,3,1,0,13,11,2,8,1,0,1,0,9,2,7,8,SEPTEMBER
SULAWESI BARAT,POLEWALI MANDAR,MATANGNGA,LILLI,34,56,4,4,2,1,1,1,0,2,4,0,2,1,1,0,56,34,22,33,46,4,42,3,85,30,55,58,SEPTEMBER
SULAWESI BARAT,POLEWALI MANDAR,MATANGNGA,RANGOAN,58,45,10,10,10,5,4,2,1,1,4,4,0,0,0,0,34,10,24,7,30,8,22,7,8,7,1,3,SEPTEMBER
SULAWESI BARAT,POLEWALI MANDAR,MATANGNGA,TAPUA,99,62,34,0,0,0,0,18,14,0,27,0,10,0,10,0,55,10,45,5,36,16,20,11,35,22,13,34,SEPTEMBER
SULAWESI BARAT,POLEWALI MANDAR,MATANGNGA,MAMBU TAPUA,37,10,7,4,1,1,0,3,0,0,4,2,6,5,1,3,10,8,2,7,0,0,0,0,2,1,1,0,SEPTEMBER
SULAWESI BARAT,POLEWALI MANDAR,MATANGNGA,BA'BA TAPUA,61,62,38,17,12,5,2,26,0,6,1,31,9,6,3,3,44,8,36,2,27,8,19,3,9,6,3,7,SEPTEMBER
SULAWESI BARAT,POLEWALI MANDAR,MATANGNGA,KATIMBANG,31,71,14,1,0,0,0,13,0,1,7,5,6,1,5,1,59,15,44,6,31,25,6,7,8,5,3,2,SEPTEMBER
SULAWESI BARAT,POLEWALI MANDAR,POLEWALI,POLEWALI,77,25,3,1,1,0,0,0,0,2,0,3,3,3,0,3,21,13,8,8,8,7,1,5,16,7,9,6,SEPTEMBER
SULAWESI BARAT,POLEWALI MANDAR,POLEWALI,WATTANG,70,32,5,1,1,0,0,3,1,0,0,1,14,5,9,2,18,7,11,5,6,5,1,0,14,6,8,2,SEPTEMBER
SULAWESI BARAT,POLEWALI MANDAR,POLEWALI,SULEWATANG,59,19,5,5,1,0,0,3,1,1,3,1,4,3,1,1,13,13,0,7,9,4,5,2,4,4,0,2,SEPTEMBER
SULAWESI BARAT,POLEWALI MANDAR,POLEWALI,LANTORA,59,50,16,5,1,1,1,6,8,0,3,8,2,2,0,0,36,7,29,4,22,13,9,1,56,53,3,54,SEPTEMBER
SULAWESI BARAT,POLEWALI MANDAR,POLEWALI,TAKATIDUNG,77,69,48,24,5,4,2,19,22,0,16,27,2,2,0,0,60,58,2,1,21,5,16,1,41,32,9,8,SEPTEMBER
SULAWESI BARAT,POLEWALI MANDAR,POLEWALI,PEKKABATA,39,62,21,5,4,4,0,12,0,0,12,3,5,4,1,0,27,13,14,0,14,5,9,0,44,1,43,17,SEPTEMBER
SULAWESI BARAT,POLEWALI MANDAR,POLEWALI,MADATE,82,55,0,0,0,0,0,0,0,0,0,0,14,9,5,7,45,15,30,3,14,7,7,3,50,7,43,12,SEPTEMBER
SULAWESI BARAT,POLEWALI MANDAR,POLEWALI,MANDING,91,40,2,1,0,0,0,1,1,0,0,2,18,6,12,0,32,11,21,0,12,8,4,1,12,6,6,2,SEPTEMBER
SULAWESI BARAT,POLEWALI MANDAR,POLEWALI,DARMA,50,58,43,38,36,5,0,4,27,4,40,1,10,1,9,0,44,5,39,3,32,21,11,3,24,20,4,22,SEPTEMBER
SULAWESI BARAT,POLEWALI MANDAR,TAPANGO,PELITAKAN,72,64,54,46,37,2,1,26,6,0,17,9,5,5,0,0,24,16,8,11,18,2,16,1,35,21,14,5,SEPTEMBER
SULAWESI BARAT,POLEWALI MANDAR,TAPANGO,TAPANGO,68,41,8,6,4,0,0,5,2,1,0,0,8,2,6,0,18,8,10,5,12,10,2,5,23,4,19,23,SEPTEMBER
SULAWESI BARAT,POLEWALI MANDAR,TAPANGO,RAPPANG,61,45,23,0,0,0,0,18,0,4,1,11,12,0,12,0,26,24,2,15,23,20,3,5,2,2,0,0,SEPTEMBER
SULAWESI BARAT,POLEWALI MANDAR,TAPANGO,DAKKA,59,75,35,18,18,4,0,3,1,7,0,9,7,4,3,3,58,56,2,51,36,33,3,7,18,17,1,7,SEPTEMBER
SULAWESI BARAT,POLEWALI MANDAR,TAPANGO,BATU,76,31,25,5,4,1,0,13,5,2,4,8,7,6,1,4,27,27,0,17,16,4,12,2,32,19,13,25,SEPTEMBER
SULAWESI BARAT,POLEWALI MANDAR,TAPANGO,RISO,36,80,30,10,0,0,0,18,0,12,5,11,2,2,0,0,37,26,11,17,35,30,5,5,78,35,43,74,SEPTEMBER
SULAWESI BARAT,POLEWALI MANDAR,TAPANGO,PALATTA,83,65,62,53,33,17,13,32,10,6,38,16,10,6,4,2,22,20,2,11,1,0,1,0,45,31,14,31,SEPTEMBER
SULAWESI BARAT,POLEWALI MANDAR,TAPANGO,TAPANGO BARAT,53,19,16,13,11,0,0,14,0,0,7,3,5,0,5,0,19,17,2,2,3,2,1,0,7,4,3,7,SEPTEMBER
SULAWESI BARAT,POLEWALI MANDAR,TAPANGO,KURRAK,78,50,11,3,0,0,0,3,5,0,9,2,15,4,11,1,10,8,2,5,1,1,0,1,31,30,1,4,SEPTEMBER
SULAWESI BARAT,POLEWALI MANDAR,TAPANGO,BUSSU,44,38,21,4,0,0,0,13,7,1,7,14,3,2,1,1,38,23,15,5,4,2,2,2,22,17,5,1,SEPTEMBER
SULAWESI BARAT,POLEWALI MANDAR,TAPANGO,TUTTULA,97,49,44,22,8,5,3,27,10,2,43,0,14,0,14,0,41,34,7,18,41,9,32,0,8,8,0,2,SEPTEMBER
SULAWESI BARAT,POLEWALI MANDAR,TAPANGO,JAMBU MALEA,31,68,31,30,25,3,2,23,6,0,14,0,3,0,3,0,11,6,5,5,4,2,2,2,48,6,42,32,SEPTEMBER
SULAWESI BARAT,POLEWALI MANDAR,TAPANGO,KALIMBUA,39,26,15,4,0,0,0,10,0,2,5,6,0,0,0,0,23,13,10,2,4,4,0,1,8,4,4,4,SEPTEMBER
SULAWESI BARAT,POLEWALI MANDAR,TAPANGO,BANATO REJO,46,25,17,6,6,4,3,14,0,0,6,3,1,0,1,0,23,19,4,16,8,1,7,1,5,4,1,5,SEPTEMBER
SULAWESI BARAT,POLEWALI MANDAR,TINAMBUNG,TINAMBUNG,74,65,36,13,4,0,0,9,1,3,14,22,3,1,2,1,14,8,6,3,12,11,1,10,47,35,12,9,SEPTEMBER
SULAWESI BARAT,POLEWALI MANDAR,TINAMBUNG,KARAMA,81,21,12,2,0,0,0,12,0,0,0,5,5,3,2,2,19,15,4,8,8,6,2,2,9,7,2,5,SEPTEMBER
SULAWESI BARAT,POLEWALI MANDAR,TINAMBUNG,TANGNGA TANGNGA,62,44,21,20,17,4,1,20,0,0,21,0,10,4,6,2,22,14,8,11,3,3,0,1,28,18,10,17,SEPTEMBER
SULAWESI BARAT,POLEWALI MANDAR,TINAMBUNG,LEKOPADIS,99,65,4,3,1,1,1,1,0,2,0,0,14,6,8,4,27,10,17,7,18,1,17,1,43,25,18,38,SEPTEMBER
SULAWESI BARAT,POLEWALI MANDAR,TINAMBUNG,GALUNG LOMBOK,74,79,44,13,0,0,0,42,0,1,22,12,5,1,4,0,42,38,4,10,33,0,33,0,48,25,23,9,SEPTEMBER
SULAWESI BARAT,POLEWALI MANDAR,TINAMBUNG,TANDUNG,80,71,64,58,24,24,8,42,0,6,44,12,14,6,8,0,31,26,5,11,31,1,30,0,57,34,23,32,SEPTEMBER
SULAWESI BARAT,POLEWALI MANDAR,TINAMBUNG,BATULAYA,67,76,24,16,15,13,12,11,0,0,21,0,11,10,1,5,47,7,40,0,46,5,41,0,48,5,43,27,SEPTEMBER
SULAWESI BARAT,POLEWALI MANDAR,TINAMBUNG,SEPABATU,99,69,69,41,13,11,11,42,16,0,5,20,5,5,0,4,32,15,17,7,28,27,1,27,67,53,14,55,SEPTEMBER
SULAWESI BARAT,POLEWALI MANDAR,TUTAR,TARAMANU,42,52,33,3,1,0,0,7,0,21,18,10,0,0,0,0,32,23,9,7,28,15,13,4,27,4,23,5,SEPTEMBER
SULAWESI BARAT,POLEWALI MANDAR,TUTAR,AMBOPADANG,93,54,34,1,1,1,1,30,0,1,22,5,3,0,3,0,48,39,9,30,18,18,0,5,13,0,13,10,SEPTEMBER
SULAWESI BARAT,POLEWALI MANDAR,TUTAR,TUBBI,69,71,45,32,15,8,0,44,1,0,16,19,8,7,1,0,30,9,21,7,17,5,12,2,63,13,50,63,SEPTEMBER
SULAWESI BARAT,POLEWALI MANDAR,TUTAR,RATTE,100,47,19,19,10,4,0,12,4,0,10,2,20,2,18,2,15,6,9,3,15,14,1,0,8,7,1,6,SEPTEMBER
SULAWESI BARAT,POLEWALI MANDAR,TUTAR,BESOANGIN,93,75,57,45,26,20,18,19,5,0,11,26,17,14,3,12,12,6,6,3,10,9,1,1,61,50,11,32,SEPTEMBER
SULAWESI BARAT,POLEWALI MANDAR,TUTAR,PIRIANG TAPIKO,30,75,70,23,9,0,0,50,6,11,36,34,0,0,0,0,64,58,6,41,6,3,3,2,37,11,26,2,SEPTEMBER
SULAWESI BARAT,POLEWALI MANDAR,TUTAR,PEBURRU,57,69,0,0,0,0,0,0,0,0,0,0,8,6,2,3,55,17,38,8,1,0,1,0,18,16,2,14,SEPTEMBER
SULAWESI BARAT,POLEWALI MANDAR,TUTAR,TALOBA,68,63,8,1,0,0,0,8,0,0,7,0,3,3,0,0,15,7,8,1,9,8,1,1,44,28,16,12,SEPTEMBER
SULAWESI BARAT,POLEWALI MANDAR,TUTAR,POLLEWANI,53,64,34,26,2,0,0,2,10,4,9,11,4,0,4,0,36,11,25,2,19,16,3,5,20,3,17,9,SEPTEMBER
SULAWESI BARAT,POLEWALI MANDAR,TUTAR,ARABUA,41,78,67,63,48,16,10,13,39,5,31,26,5,5,0,0,10,8,2,3,3,2,1,1,8,6,2,3,SEPTEMBER
SULAWESI BARAT,POLEWALI MANDAR,TUTAR,BESOANGIN UTARA,32,20,1,1,0,0,0,1,0,0,0,1,0,0,0,0,18,12,6,10,5,0,5,0,11,0,11,11,SEPTEMBER
SULAWESI BARAT,POLEWALI MANDAR,TUTAR,PODA,61,43,10,7,0,0,0,5,0,3,8,0,4,3,1,2,41,23,18,15,4,1,3,0,25,15,10,11,SEPTEMBER
SULAWESI BARAT,POLEWALI MANDAR,TUTAR,TARAMANU TUA,69,61,53,27,26,13,11,29,10,0,22,20,2,0,2,0,47,11,36,2,41,35,6,32,82,66,16,75,SEPTEMBER
SULAWESI BARAT,POLEWALI MANDAR,WONOMULYO,SIDODADI,39,71,46,17,3,2,2,27,2,2,19,27,6,4,2,1,62,46,16,29,56,27,29,7,30,12,18,4,SEPTEMBER
SULAWESI BARAT,POLEWALI MANDAR,WONOMULYO,SIDOREJO,68,24,1,1,0,0,0,1,0,0,0,1,7,0,7,0,14,5,9,2,5,4,1,1,19,3,16,10,SEPTEMBER
SULAWESI BARAT,POLEWALI MANDAR,WONOMULYO,SUMBEREJO,32,15,5,4,2,2,1,4,0,0,0,2,1,0,1,0,15,7,8,2,5,5,0,4,10,3,7,9,SEPTEMBER
SULAWESI BARAT,POLEWALI MANDAR,WONOMULYO,BUMIAYU,88,45,17,2,0,0,0,7,9,0,14,2,14,0,14,0,18,14,4,4,18,17,1,3,31,25,6,10,SEPTEMBER
SULAWESI BARAT,POLEWALI MANDAR,WONOMULYO,KEBUNSARI,95,57,27,18,14,8,1,17,0,6,18,8,11,2,9,2,28,16,12,3,10,10,0,9,49,32,17,36,SEPTEMBER
SULAWESI BARAT,POLEWALI MANDAR,WONOMULYO,BANUA BARU,85,73,57,53,6,1,0,21,31,1,38,5,17,11,6,8,38,34,4,4,20,9,11,5,63,55,8,54,SEPTEMBER
SULAWESI BARAT,POLEWALI MANDAR,WONOMULYO,NEPO,70,36,27,2,2,2,1,23,0,1,25,2,9,4,5,3,24,10,14,6,4,2,2,2,29,9,20,9,SEPTEMBER
SULAWESI BARAT,POLEWALI MANDAR,WONOMULYO,SUGIHWARAS,34,65,49,36,32,18,13,32,4,0,24,15,3,0,3,0,26,6,20,3,8,4,4,3,11,1,10,4,SEPTEMBER
SULAWESI BARAT,POLEWALI MANDAR,WONOMULYO,CAMPURJO,100,51,46,20,10,2,2,3,15,22,35,7,19,2,17,2,13,9,4,7,7,1,6,1,30,28,2,11,SEPTEMBER
SULAWESI BARAT,POLEWALI MANDAR,WONOMULYO,BUMIMULYO,96,50,1,1,0,0,0,0,1,0,1,0,2,2,0,0,29,7,22,5,17,16,1,5,42,19,23,32,SEPTEMBER
SULAWESI BARAT,POLEWALI MANDAR,WONOMULYO,TUMPILING,63,77,23,18,1,1,1,5,11,4,11,4,1,1,0,0,29,29,0,6,11,11,0,9,22,19,3,18,SEPTEMBER
SULAWESI BARAT,POLEWALI MANDAR,WONOMULYO,BAKKA-BAKKA,43,22,13,2,0,0,0,0,11,1,11,0,6,5,1,0,16,10,6,5,14,10,4,7,9,6,3,9,SEPTEMBER
SULAWESI BARAT,POLEWALI MANDAR,WONOMULYO,ARJO SARI,58,37,34,15,14,12,0,23,2,2,17,17,6,0,6,0,24,21,3,10,15,6,9,0,12,3,9,9,SEPTEMBER
SULAWESI BARAT,POLEWALI MANDAR,WONOMULYO,GALESON,82,14,8,1,1,1,1,2,5,0,6,2,6,1,5,1,11,7,4,2,10,8,2,6,19,15,4,13,SEPTEMBER
SULAWESI BARAT,MAMUJU,MAMUJU,BINANGA,95,38,38,26,10,3,1,2,6,27,10,27,3,2,1,1,15,12,3,7,6,1,5,0,15,12,3,8,SEPTEMBER
SULAWESI BARAT,MAMUJU,MAMUJU,MAMUNYU,100,51,4,1,1,0,0,4,0,0,4,0,7,3,4,3,27,15,12,3,2,2,0,0,17,17,0,0,SEPTEMBER
SULAWESI BARAT,MAMUJU,MAMUJU,KAREMA,82,77,21,2,2,1,1,19,0,1,7,3,10,7,3,7,51,47,4,12,31,2,29,2,84,32,52,84,SEPTEMBER
SULAWESI BARAT,MAMUJU,MAMUJU,RIMUKU,77,40,15,3,1,0,0,13,2,0,6,8,5,5,0,3,26,7,19,2,0,0,0,0,18,16,2,10,SEPTEMBER
SULAWESI BARAT,MAMUJU,MAMUJU,BAMBU,81,12,10,3,1,1,0,9,1,0,10,0,15,8,7,6,12,5,7,0,1,1,0,1,5,4,1,3,SEPTEMBER
SULAWESI BARAT,MAMUJU,MAMUJU,KARAMPUANG,39,42,25,22,1,0,0,23,2,0,25,0,6,0,6,0,34,26,8,11,8,5,3,3,37,35,2,37,SEPTEMBER
SULAWESI BARAT,MAMUJU,MAMUJU,TADUI,64,21,13,9,3,1,1,2,2,6,7,3,11,11,0,10,15,13,2,4,10,7,3,3,21,15,6,4,SEPTEMBER
SULAWESI BARAT,MAMUJU,MAMUJU,BATU PANNU,92,67,23,20,4,3,3,10,1,4,14,7,8,3,5,1,16,14,2,14,14,11,3,2,24,11,13,12,SEPTEMBER
SULAWESI BARAT,MAMUJU,TAPALANG,GALUNG,96,36,3,0,0,0,0,1,2,0,1,1,18,16,2,2,33,13,20,7,11,0,11,0,2,1,1,0,SEPTEMBER
SULAWESI BARAT,MAMUJU,TAPALANG,KASAMBANG,81,70,70,64,57,35,5,53,1,2,46,17,2,2,0,1,36,29,7,18,35,11,24,6,30,1,29,20,SEPTEMBER
SULAWESI BARAT,MAMUJU,TAPALANG,DAYANGINNA,72,38,32,25,23,9,2,6,14,5,3,13,0,0,0,0,27,12,15,10,27,4,23,0,40,11,29,25,SEPTEMBER
SULAWESI BARAT,MAMUJU,TAPALANG,OROBATU,55,69,4,4,3,0,0,4,0,0,3,0,7,7,0,6,11,5,6,3,1,0,1,0,5,1,4,5,SEPTEMBER
SULAWESI BARAT,MAMUJU,TAPALANG,TAKANDEANG,100,52,35,20,18,4,1,27,7,0,28,6,17,13,4,5,52,42,10,41,34,13,21,10,3,0,3,0,SEPTEMBER
SULAWESI BARAT,MAMUJU,TAPALANG,BELA,35,23,18,7,1,0,0,17,1,0,14,3,3,1,2,1,20,8,12,7,10,1,9,1,22,20,2,12,SEPTEMBER
SULAWESI BARAT,MAMUJU,TAPALANG,TAAN,37,52,29,25,13,11,7,5,9,3,1,21,4,1,3,1,26,23,3,8,10,7,3,2,39,7,32,30,SEPTEMBER
SULAWESI BARAT,MAMUJU,TAPALANG,TAMPALANG,65,62,46,29,14,1,1,1,12,17,20,12,2,1,1,0,10,6,4,6,0,0,0,0,28,27,1,16,SEPTEMBER
SULAWESI BARAT,MAMUJU,TAPALANG,RANTEDODA,58,32,32,6,2,1,0,27,5,0,31,1,6,6,0,2,15,11,4,9,4,2,2,0,14,2,12,0,SEPTEMBER
SULAWESI BARAT,MAMUJU,TAPALANG,KOPEANG,52,66,57,37,2,2,1,26,14,14,54,0,7,4,3,4,34,26,8,24,28,17,11,11,3,2,1,1,SEPTEMBER
SULAWESI BARAT,MAMUJU,KALUKKU,SINYONYOI,54,78,11,5,2,0,0,6,5,0,0,5,10,4,6,2,33,10,23,9,17,2,15,2,30,5,25,12,SEPTEMBER
SULAWESI BARAT,MAMUJU,KALUKKU,BEBANGA,59,54,3,3,3,3,0,3,0,0,1,1,4,4,0,4,42,16,26,7,10,7,3,4,28,7,21,18,SEPTEMBER
SULAWESI BARAT,MAMUJU,KALUKKU,KALUKKU,41,44,40,17,7,1,0,15,16,3,10,9,0,0,0,0,26,19,7,2,12,10,2,9,42,27,15,26,SEPTEMBER
SULAWESI BARAT,MAMUJU,KALUKKU,SINYONYOI SELATAN,60,21,8,7,1,1,1,7,0,0,4,2,7,3,4,2,19,16,3,12,11,6,5,2,12,4,8,3,SEPTEMBER
SULAWESI BARAT,MAMUJU,KALUKKU,SONDOANG,96,65,15,11,5,0,0,9,1,1,6,1,19,11,8,1,24,12,12,5,20,15,5,5,32,18,14,12,SEPTEMBER
SULAWESI BARAT,MAMUJU,KALUKKU,BERU-BERU,41,49,10,4,1,1,0,4,2,2,6,0,2,1,1,1,30,14,16,0,0,0,0,0,6,2,4,4,SEPTEMBER
SULAWESI BARAT,MAMUJU,KALUKKU,BELANG BELANG,41,25,2,0,0,0,0,0,2,0,1,0,3,1,2,1,17,16,1,4,14,5,9,3,30,4,26,8,SEPTEMBER
SULAWESI BARAT,MAMUJU,KALUKKU,KABULOANG,41,10,3,0,0,0,0,0,3,0,2,0,0,0,0,0,10,7,3,4,8,2,6,0,11,4,7,3,SEPTEMBER
SULAWESI BARAT,MAMUJU,KALUKKU,KEANG,74,77,2,2,2,2,2,0,0,0,2,0,5,5,0,0,18,12,6,10,10,7,3,4,27,0,27,13,SEPTEMBER
SULAWESI BARAT,MAMUJU,KALUKKU,POKKANG,78,65,25,23,2,1,1,12,7,2,13,4,9,4,5,4,26,7,19,4,2,2,0,0,3,3,0,0,SEPTEMBER
SULAWESI BARAT,MAMUJU,KALUKKU,GULILING,89,42,29,0,0,0,0,21,7,0,15,0,8,1,7,1,25,10,15,3,23,1,22,1,9,4,5,6,SEPTEMBER
SULAWESI BARAT,MAMUJU,KALUKKU,UHAIMATE,87,45,37,9,3,0,0,1,13,21,33,0,16,9,7,4,29,14,15,12,2,2,0,0,8,7,1,7,SEPTEMBER
SULAWESI BARAT,MAMUJU,KALUKKU,KALUKKU BARAT,60,51,28,23,13,13,13,5,7,2,5,9,4,3,1,2,21,21,0,9,3,0,3,0,8,7,1,0,SEPTEMBER
SULAWESI BARAT,MAMUJU,KALUKKU,PAMMULUKANG,53,54,12,4,1,0,0,8,3,0,12,0,8,7,1,1,10,6,4,1,4,3,1,1,2,0,2,0,SEPTEMBER
SULAWESI BARAT,MAMUJU,KALUMPANG,KALUMPANG,42,75,32,7,2,2,1,10,7,14,6,21,4,1,3,1,14,7,7,1,5,3,2,3,13,11,2,0,SEPTEMBER
SULAWESI BARAT,MAMUJU,KALUMPANG,KARATAUN,88,42,22,8,6,5,3,12,3,1,1,12,3,3,0,0,15,14,1,1,9,1,8,1,38,30,8,9,SEPTEMBER
SULAWESI BARAT,MAMUJU,KALUMPANG,KARAMA,34,56,4,2,0,0,0,4,0,0,2,2,2,1,1,1,15,12,3,9,7,1,6,1,27,9,18,18,SEPTEMBER
SULAWESI BARAT,MAMUJU,KALUMPANG,SIRAUN,86,12,8,2,2,2,2,6,0,0,5,1,9,5,4,5,10,9,1,7,9,4,5,2,13,2,11,8,SEPTEMBER
SULAWESI BARAT,MAMUJU,KALUMPANG,TUMOGA,96,36,34,1,1,1,0,17,1,6,30,1,6,6,0,0,18,5,13,2,16,2,14,1,19,0,19,10,SEPTEMBER
SULAWESI BARAT,MAMUJU,KALUMPANG,SALUMAKKI,46,79,65,25,21,18,15,12,21,14,3,50,0,0,0,0,59,41,18,16,47,31,16,30,59,4,55,24,SEPTEMBER
SULAWESI BARAT,MAMUJU,KALUMPANG,POLIO,87,41,39,19,17,0,0,13,5,18,36,2,10,7,3,2,25,8,17,7,9,0,9,0,1,1,0,1,SEPTEMBER
SULAWESI BARAT,MAMUJU,KALUMPANG,LIMBONG,77,53,39,26,18,10,1,18,4,12,13,3,4,0,4,0,51,20,31,9,5,4,1,3,35,1,34,18,SEPTEMBER
SULAWESI BARAT,MAMUJU,KALUMPANG,SANDAPANG,84,69,52,3,2,0,0,34,16,2,40,11,12,4,8,0,13,6,7,6,12,3,9,2,45,30,15,33,SEPTEMBER
SULAWESI BARAT,MAMUJU,KALUMPANG,KONDO BULO,46,47,34,24,9,9,6,4,17,2,22,12,0,0,0,0,24,10,14,3,4,4,0,1,16,4,12,6,SEPTEMBER
SULAWESI BARAT,MAMUJU,KALUMPANG,MAKKALIKI,85,63,33,31,13,13,13,16,0,2,33,0,7,4,3,2,25,17,8,12,20,19,1,7,14,9,5,4,SEPTEMBER
SULAWESI BARAT,MAMUJU,KALUMPANG,BATU MAKKADA,30,53,40,9,7,1,0,25,15,0,7,18,5,0,5,0,10,6,4,0,4,4,0,1,40,30,10,0,SEPTEMBER
SULAWESI BARAT,MAMUJU,KALUMPANG,LASA',48,41,18,11,0,0,0,6,0,6,18,0,2,2,0,1,25,12,13,5,18,17,1,9,2,0,2,0,SEPTEMBER
SULAWESI BARAT,MAMUJU,PAPALANG,TOABO,38,68,46,46,34,30,19,17,9,1,38,1,6,3,3,2,26,18,8,8,26,3,23,1,48,37,11,41,SEPTEMBER
SULAWESI BARAT,MAMUJU,PAPALANG,PAPALANG,94,66,11,8,1,0,0,2,0,1,3,2,2,2,0,2,33,29,4,29,25,24,1,5,42,8,34,2,SEPTEMBER
SULAWESI BARAT,MAMUJU,PAPALANG,BONDA,52,47,28,24,2,2,2,1,9,8,4,9,6,3,3,1,18,5,13,1,7,0,7,0,35,31,4,29,SEPTEMBER
SULAWESI BARAT,MAMUJU,PAPALANG,TOPORE,88,45,44,7,7,6,4,16,6,11,4,3,17,13,4,6,19,12,7,12,19,10,9,5,39,39,0,30,SEPTEMBER
SULAWESI BARAT,MAMUJU,PAPALANG,SALUKAYU,39,24,2,1,0,0,0,2,0,0,1,1,5,0,5,0,16,13,3,11,5,2,3,2,0,0,0,0,SEPTEMBER
SULAWESI BARAT,MAMUJU,PAPALANG,SUKADAMAI,91,25,7,7,2,2,0,0,4,3,4,1,16,2,14,1,16,11,5,4,14,1,13,0,3,2,1,2,SEPTEMBER
SULAWESI BARAT,MAMUJU,PAPALANG,BODA-BODA,54,74,74,11,4,4,2,47,15,9,16,4,0,0,0,0,43,19,24,19,17,10,7,7,33,24,9,7,SEPTEMBER
SULAWESI BARAT,MAMUJU,PAPALANG,SISANGO,52,60,16,4,0,0,0,7,3,3,15,1,3,3,0,3,10,9,1,9,2,2,0,0,25,18,7,10,SEPTEMBER
SULAWESI BARAT,MAMUJU,PAPALANG,BATU AMPA,62,50,38,32,32,29,21,13,4,0,16,0,2,2,0,2,31,12,19,2,18,13,5,12,53,43,10,46,SEPTEMBER
SULAWESI BARAT,MAMUJU,SAMPAGA,BUNDE,64,71,19,17,12,0,0,16,0,3,18,0,5,4,1,3,59,49,10,48,4,4,0,2,6,3,3,3,SEPTEMBER
SULAWESI BARAT,MAMUJU,SAMPAGA,KALONDING,88,52,33,5,5,2,2,24,0,4,19,8,4,0,4,0,48,9,39,1,45,24,21,6,23,7,16,20,SEPTEMBER
SULAWESI BARAT,MAMUJU,SAMPAGA,TARAILU,31,38,28,1,1,0,0,25,2,1,4,5,5,0,5,0,34,14,20,13,6,3,3,1,11,6,5,2,SEPTEMBER
SULAWESI BARAT,MAMUJU,SAMPAGA,SAMPAGA,57,58,44,44,39,21,5,31,5,1,16,12,4,0,4,0,22,19,3,4,7,6,1,3,46,33,13,46,SEPTEMBER
SULAWESI BARAT,MAMUJU,SAMPAGA,TANAMBUAH,81,12,6,2,0,0,0,6,0,0,5,1,7,4,3,0,10,9,1,1,1,1,0,1,8,7,1,7,SEPTEMBER
SULAWESI BARAT,MAMUJU,SAMPAGA,SALUBARANA,64,39,23,6,1,0,0,13,10,0,8,13,9,6,3,4,28,25,3,8,0,0,0,0,23,2,21,5,SEPTEMBER
SULAWESI BARAT,MAMUJU,SAMPAGA,LOSSO,54,12,11,1,1,0,0,0,0,4,8,1,7,7,0,4,11,7,4,6,11,11,0,7,14,14,0,8,SEPTEMBER
SULAWESI BARAT,MAMUJU,TOMMO,TOMMO,79,24,20,18,13,6,2,17,1,0,4,8,11,4,7,3,22,10,12,5,1,1,0,0,15,12,3,5,SEPTEMBER
SULAWESI BARAT,MAMUJU,TOMMO,CAMPALOGA,50,28,0,0,0,0,0,0,0,0,0,0,4,0,4,0,28,13,15,5,24,8,16,5,10,9,1,5,SEPTEMBER
SULAWESI BARAT,MAMUJU,TOMMO,BUANA SAKTI,67,11,0,0,0,0,0,0,0,0,0,0,9,5,4,0,11,11,0,8,11,8,3,5,18,5,13,7,SEPTEMBER
SULAWESI BARAT,MAMUJU,TOMMO,TAMEMONGGA,65,63,63,22,7,7,3,43,3,14,40,22,1,1,0,0,59,21,38,20,12,0,12,0,41,41,0,4,SEPTEMBER
SULAWESI BARAT,MAMUJU,TOMMO,TAMEJARRA,65,25,9,3,3,0,0,0,2,2,7,2,0,0,0,0,17,13,4,2,12,4,8,0,0,0,0,0,SEPTEMBER
SULAWESI BARAT,MAMUJU,TOMMO,RANTEMARIO,75,73,67,54,42,11,9,39,6,11,20,4,11,9,2,7,29,16,13,9,4,3,1,3,25,6,19,1,SEPTEMBER
SULAWESI BARAT,MAMUJU,TOMMO,MALINO,73,15,10,9,5,0,0,5,2,1,6,4,12,11,1,10,10,9,1,0,9,5,4,2,10,0,10,3,SEPTEMBER
SULAWESI BARAT,MAMUJU,TOMMO,KAKULLASANG,52,44,19,11,10,10,3,7,7,2,6,7,3,1,2,1,11,7,4,0,5,2,3,0,24,12,12,4,SEPTEMBER
SULAWESI BARAT,MAMUJU,TOMMO,LELING,97,48,26,11,9,8,2,18,4,1,7,12,14,3,11,2,36,12,24,3,14,3,11,3,4,0,4,2,SEPTEMBER
SULAWESI BARAT,MAMUJU,TOMMO,KALEPU,88,66,22,5,4,3,0,4,6,3,14,6,16,3,13,1,56,50,6,32,25,0,25,0,22,9,13,5,SEPTEMBER
SULAWESI BARAT,MAMUJU,TOMMO,SANDANA,51,28,15,7,7,6,2,10,3,0,0,3,8,2,6,1,12,7,5,3,4,4,0,1,1,0,1,1,SEPTEMBER
SULAWESI BARAT,MAMUJU,TOMMO,LELING BARAT,76,57,7,1,0,0,0,2,5,0,0,6,7,3,4,2,26,15,11,7,24,24,0,15,43,24,19,8,SEPTEMBER
SULAWESI BARAT,MAMUJU,TOMMO,LELING UTARA,80,70,46,46,5,2,2,33,7,3,44,0,14,1,13,1,67,36,31,32,67,60,7,40,115,72,43,14,SEPTEMBER
SULAWESI BARAT,MAMUJU,TOMMO,SALUDENGEN,84,63,27,9,3,1,0,21,1,5,1,21,3,2,1,1,48,15,33,9,47,20,27,14,62,52,10,59,SEPTEMBER
SULAWESI BARAT,MAMUJU,SIMBORO DAN KEPULAUAN,SIMBORO,35,16,0,0,0,0,0,0,0,0,0,0,3,3,0,3,14,8,6,0,11,10,1,9,6,0,6,5,SEPTEMBER
SULAWESI BARAT,MAMUJU,SIMBORO DAN KEPULAUAN,RANGAS,56,11,5,4,4,1,0,3,1,1,2,3,2,0,2,0,10,5,5,1,7,6,1,2,10,1,9,7,SEPTEMBER
SULAWESI BARAT,MAMUJU,SIMBORO DAN KEPULAUAN,BOTTENG,88,56,30,17,6,4,4,1,3,17,30,0,17,6,11,0,13,10,3,1,2,0,2,0,37,36,1,16,SEPTEMBER
SULAWESI BARAT,MAMUJU,SIMBORO DAN KEPULAUAN,SALETTO,85,43,10,3,0,0,0,1,6,0,0,8,10,3,7,3,34,34,0,31,23,21,2,10,44,1,43,30,SEPTEMBER
SULAWESI BARAT,MAMUJU,SIMBORO DAN KEPULAUAN,SUMARE,57,56,47,43,18,16,10,37,0,0,22,18,6,4,2,3,41,17,24,8,13,8,5,6,18,5,13,4,SEPTEMBER
SULAWESI BARAT,MAMUJU,SIMBORO DAN KEPULAUAN,BOTTENG UTARA,83,38,24,6,5,5,3,21,0,0,10,8,2,1,1,0,33,26,7,12,7,0,7,0,0,0,0,0,SEPTEMBER
SULAWESI BARAT,MAMUJU,SIMBORO DAN KEPULAUAN,TAPANDULLU,43,27,27,27,19,11,1,7,8,3,27,0,7,3,4,2,25,16,9,15,2,0,2,0,9,5,4,9,SEPTEMBER
SULAWESI BARAT,MAMUJU,SIMBORO DAN KEPULAUAN,PATI'DI,53,78,39,10,2,0,0,30,2,1,24,13,6,6,0,3,10,5,5,5,2,0,2,0,26,2,24,7,SEPTEMBER
SULAWESI BARAT,MAMUJU,TAPALANG BARAT,DUNGKAIT,86,62,16,10,4,3,3,3,5,0,6,2,17,15,2,2,53,45,8,38,48,8,40,8,86,58,28,34,SEPTEMBER
SULAWESI BARAT,MAMUJU,TAPALANG BARAT,LEBANI,100,57,34,24,2,0,0,17,15,1,20,3,7,4,3,4,11,10,1,2,7,3,4,1,17,9,8,3,SEPTEMBER
SULAWESI BARAT,MAMUJU,TAPALANG BARAT,LABUANG RANO,90,61,25,17,9,6,1,1,11,12,17,3,8,4,4,2,24,17,7,9,9,0,9,0,19,8,11,12,SEPTEMBER
SULAWESI BARAT,MAMUJU,TAPALANG BARAT,PASABU,69,31,8,6,6,3,0,8,0,0,3,3,5,0,5,0,17,13,4,7,6,1,5,1,24,20,4,1,SEPTEMBER
SULAWESI BARAT,MAMUJU,TAPALANG BARAT,TANETE PAO,62,40,36,10,0,0,0,28,4,1,30,5,8,7,1,2,10,9,1,1,9,9,0,0,30,2,28,0,SEPTEMBER
SULAWESI BARAT,MAMUJU,TAPALANG BARAT,PANGASAAN,75,33,18,6,2,0,0,12,0,6,15,2,3,1,2,1,20,7,13,1,0,0,0,0,3,3,0,3,SEPTEMBER
SULAWESI BARAT,MAMUJU,TAPALANG BARAT,AHU,60,10,3,3,0,0,0,3,0,0,2,0,12,4,8,0,10,9,1,4,1,0,1,0,6,2,4,4,SEPTEMBER
SULAWESI BARAT,MAMUJU,BONEHAU,BONEHAU,100,27,1,0,0,0,0,1,0,0,1,0,6,4,2,2,17,7,10,0,12,3,9,1,7,4,3,6,SEPTEMBER
SULAWESI BARAT,MAMUJU,BONEHAU,SALUTIWO,72,60,15,2,1,1,0,2,2,0,15,0,6,3,3,1,57,53,4,32,36,22,14,18,74,44,30,6,SEPTEMBER
SULAWESI BARAT,MAMUJU,BONEHAU,BUTTUADA,85,56,12,10,4,4,0,4,2,3,6,5,6,3,3,1,29,18,11,7,15,6,9,5,48,22,26,30,SEPTEMBER
SULAWESI BARAT,MAMUJU,BONEHAU,TAMALEA,44,56,14,9,2,1,0,9,5,0,8,4,6,3,3,2,17,14,3,9,1,0,1,0,31,7,24,29,SEPTEMBER
SULAWESI BARAT,MAMUJU,BONEHAU,LUMIKA,42,62,47,38,32,24,11,15,6,13,41,0,8,8,0,8,61,9,52,0,29,3,26,1,70,61,9,64,SEPTEMBER
SULAWESI BARAT,MAMUJU,BONEHAU,MAPPU,99,27,24,22,14,10,10,2,9,1,13,1,19,16,3,1,12,10,2,0,8,4,4,3,1,0,1,1,SEPTEMBER
SULAWESI BARAT,MAMUJU,BONEHAU,BANUADA,84,71,18,16,7,2,2,15,1,0,8,6,7,2,5,1,61,42,19,35,4,1,3,0,3,1,2,3,SEPTEMBER
SULAWESI BARAT,MAMUJU,BONEHAU,HINUA,81,10,7,3,3,1,1,0,5,1,1,1,1,1,0,0,10,7,3,5,4,3,1,0,3,3,0,1,SEPTEMBER
SULAWESI BARAT,MAMUJU,BONEHAU,KINATANG,64,68,34,5,0,0,0,15,9,0,3,25,9,3,6,3,24,23,1,20,18,0,18,0,60,29,31,10,SEPTEMBER
SULAWESI BARAT,MAMUJU,KEP. BALA BALAKANG,BALA BALAKANG,94,16,10,0,0,0,0,3,3,2,4,5,1,0,1,0,16,10,6,3,5,3,2,3,16,16,0,1,SEPTEMBER
SULAWESI BARAT,MAMUJU,KEP. BALA BALAKANG,BALA-BALAKANG TIMUR,81,23,2,0,0,0,0,0,1,1,1,1,11,4,7,2,13,7,6,7,12,5,7,0,21,15,6,21,SEPTEMBER
SULAWESI BARAT,MAMUJU TENGAH,TOBADAK,MAHAHE,45,29,13,12,7,4,3,3,2,3,5,5,5,5,0,5,22,20,2,15,1,1,0,0,13,3,10,11,OKTOBER
SULAWESI BARAT,MAMUJU TENGAH,TOBADAK,SALOBAJA,93,76,72,20,9,5,0,45,17,10,8,59,7,7,0,2,66,11,55,2,49,25,24,17,27,23,4,27,OKTOBER
SULAWESI BARAT,MAMUJU TENGAH,TOBADAK,TOBADAK,93,48,4,3,1,0,0,2,2,0,0,0,7,3,4,0,41,6,35,3,33,4,29,4,46,7,39,12,OKTOBER
SULAWESI BARAT,MAMUJU TENGAH,TOBADAK,PALONGAAN,74,75,66,19,8,2,0,3,54,7,32,14,8,5,3,5,47,31,16,23,27,20,7,4,44,11,33,2,OKTOBER
SULAWESI BARAT,MAMUJU TENGAH,TOBADAK,BATU PARIGI,49,50,20,12,8,0,0,4,10,4,3,7,6,2,4,0,12,8,4,8,8,2,6,2,8,0,8,8,OKTOBER
SULAWESI BARAT,MAMUJU TENGAH,TOBADAK,BAMBADARU,73,61,6,3,0,0,0,4,1,1,2,1,10,9,1,3,44,16,28,16,36,4,32,2,47,2,45,44,OKTOBER
SULAWESI BARAT,MAMUJU TENGAH,TOBADAK,SEJATI,60,63,59,45,2,1,0,16,42,0,36,12,3,2,1,0,56,45,11,33,40,31,9,31,34,11,23,11,OKTOBER
SULAWESI BARAT,MAMUJU TENGAH,TOBADAK,SALOADAK,50,33,13,4,2,0,0,12,1,0,5,7,0,0,0,0,30,27,3,5,9,1,8,0,21,12,9,8,OKTOBER
SULAWESI BARAT,MAMUJU TENGAH,PANGALE,POLO PANGALE,57,27,15,13,4,2,2,6,5,0,11,4,1,0,1,0,15,10,5,2,1,1,0,0,18,12,6,14,OKTOBER
SULAWESI BARAT,MAMUJU TENGAH,PANGALE,PANGALE,99,46,30,13,3,2,1,24,2,3,1,2,5,1,4,1,27,25,2,23,10,1,9,0,10,9,1,0,OKTOBER
SULAWESI BARAT,MAMUJU TENGAH,PANGALE,SARTANAMAJU,45,18,15,10,8,8,3,12,0,0,15,0,1,0,1,0,14,11,3,8,2,0,2,0,8,8,0,8,OKTOBER
SULAWESI BARAT,MAMUJU TENGAH,PANGALE,POLO LERENG,43,27,13,7,5,4,1,11,0,1,13,0,3,3,0,3,26,13,13,4,8,3,5,2,18,4,14,0,OKTOBER
SULAWESI BARAT,MAMUJU TENGAH,PANGALE,KUO,35,54,2,1,0,0,0,2,0,0,1,0,6,2,4,2,29,12,17,10,6,5,1,3,27,24,3,23,OKTOBER
SULAWESI BARAT,MAMUJU TENGAH,PANGALE,POLO CAMBA,79,31,30,6,4,4,3,15,7,2,16,7,10,6,4,6,20,7,13,7,11,1,10,1,3,3,0,3,OKTOBER
SULAWESI BARAT,MAMUJU TENGAH,PANGALE,LAMBA-LAMBA,64,67,14,6,5,5,1,6,1,6,6,0,12,11,1,4,27,17,10,4,4,0,4,0,21,16,5,16,OKTOBER
SULAWESI BARAT,MAMUJU TENGAH,PANGALE,KOMBILING,49,71,14,4,1,0,0,4,9,0,12,2,3,2,1,0,41,36,5,16,4,4,0,2,9,2,7,4,OKTOBER
SULAWESI BARAT,MAMUJU TENGAH,PANGALE,LEMO-LEMO,52,79,36,29,3,3,0,6,23,4,8,12,4,3,1,3,77,47,30,39,75,1,74,0,1,0,1,0,OKTOBER
SULAWESI BARAT,MAMUJU TENGAH,BUDONG-BUDONG,BABANA,66,13,13,10,9,1,0,0,8,4,13,0,7,2,5,2,13,6,7,5,10,6,4,3,2,1,1,0,OKTOBER
SULAWESI BARAT,MAMUJU TENGAH,BUDONG-BUDONG,LUMU,66,34,29,14,1,0,0,19,5,4,15,4,8,2,6,1,23,21,2,5,5,1,4,0,20,8,12,6,OKTOBER
SULAWESI BARAT,MAMUJU TENGAH,BUDONG-BUDONG,PONTANAKAYANG,70,43,41,39,16,9,3,12,0,22,35,2,9,0,9,0,30,18,12,5,6,2,4,1,21,3,18,21,OKTOBER
SULAWESI BARAT,MAMUJU TENGAH,BUDONG-BUDONG,SALOGATTA,47,41,4,3,2,0,0,4,0,0,0,3,7,1,6,0,22,15,7,10,8,6,2,3,26,15,11,24,OKTOBER
SULAWESI BARAT,MAMUJU TENGAH,BUDONG-BUDONG,KIRE,34,24,22,3,1,0,0,12,0,5,19,0,3,0,3,0,24,9,15,7,23,2,21,1,14,12,2,1,OKTOBER
SULAWESI BARAT,MAMUJU TENGAH,BUDONG-BUDONG,TINALI,39,10,0,0,0,0,0,0,0,0,0,0,7,5,2,1,10,9,1,4,10,0,10,0,10,9,1,10,OKTOBER
SULAWESI BARAT,MAMUJU TENGAH,BUDONG-BUDONG,SALUMANURUNG,59,40,9,8,3,3,2,2,0,4,1,3,5,1,4,1,10,10,0,6,1,1,0,0,15,2,13,6,OKTOBER
SULAWESI BARAT,MAMUJU TENGAH,BUDONG-BUDONG,PASAPA,34,74,13,0,0,0,0,8,2,2,13,0,4,4,0,2,57,5,52,5,25,15,10,7,55,3,52,12,OKTOBER
SULAWESI BARAT,MAMUJU TENGAH,BUDONG-BUDONG,BOJO,52,44,7,4,1,1,0,1,5,1,2,5,2,0,2,0,44,6,38,5,31,4,27,0,34,33,1,4,OKTOBER
SULAWESI BARAT,MAMUJU TENGAH,BUDONG-BUDONG,BARAKKANG,52,10,4,2,2,0,0,3,0,1,3,0,0,0,0,0,10,7,3,4,7,7,0,7,8,4,4,5,OKTOBER
SULAWESI BARAT,MAMUJU TENGAH,BUDONG-BUDONG,LEMBAH HADA,49,31,28,28,17,5,2,1,13,6,10,17,1,0,1,0,24,11,13,8,20,19,1,16,34,25,9,8,OKTOBER
SULAWESI BARAT,MAMUJU TENGAH,TOPOYO,BUDONG-BUDONG,98,63,55,31,25,24,17,5,5,12,41,2,10,3,7,1,58,25,33,20,6,6,0,0,27,11,16,4,OKTOBER
SULAWESI BARAT,MAMUJU TENGAH,TOPOYO,TOPOYO,80,44,26,1,1,0,0,21,1,3,23,0,13,12,1,7,15,11,4,0,3,1,2,0,29,7,22,1,OKTOBER
SULAWESI BARAT,MAMUJU TENGAH,TOPOYO,TUMBU,40,42,22,22,14,8,8,2,4,7,15,5,1,0,1,0,39,23,16,6,37,9,28,3,25,11,14,5,OKTOBER
SULAWESI BARAT,MAMUJU TENGAH,TOPOYO,KABUBU,57,47,20,3,0,0,0,13,1,1,17,2,5,1,4,0,14,6,8,1,0,0,0,0,29,6,23,11,OKTOBER
SULAWESI BARAT,MAMUJU TENGAH,TOPOYO,WAEPUTEH,71,46,27,16,12,12,7,12,3,5,17,7,13,11,2,3,10,10,0,0,7,2,5,2,32,5,27,24,OKTOBER
SULAWESI BARAT,MAMUJU TENGAH,TOPOYO,TANGKOU,48,13,2,2,0,0,0,2,0,0,2,0,6,6,0,6,11,7,4,5,1,1,0,1,8,7,1,5,OKTOBER
SULAWESI BARAT,MAMUJU TENGAH,TOPOYO,TABOLANG,76,68,26,18,3,3,2,8,13,3,4,4,14,8,6,0,64,16,48,10,31,3,28,1,32,25,7,18,OKTOBER
SULAWESI BARAT,MAMUJU TENGAH,TOPOYO,PARAILI,68,73,41,16,7,6,6,32,3,0,20,0,2,0,2,0,54,51,3,34,23,22,1,21,65,64,1,32,OKTOBER
SULAWESI BARAT,MAMUJU TENGAH,TOPOYO,SALUPANGKANG,99,44,3,1,0,0,0,0,0,0,2,0,5,4,1,1,19,15,4,5,14,9,5,0,4,2,2,3,OKTOBER
SULAWESI BARAT,MAMUJU TENGAH,TOPOYO,SALUPANGKANG IV,72,47,33,4,0,0,0,1,9,8,29,1,8,5,3,4,13,6,7,6,1,1,0,0,16,16,0,14,OKTOBER
SULAWESI BARAT,MAMUJU TENGAH,TOPOYO,TAPPILINA,48,14,11,9,7,2,1,1,3,0,5,4,6,0,6,0,13,11,2,6,5,2,3,1,1,1,0,0,OKTOBER
SULAWESI BARAT,MAMUJU TENGAH,TOPOYO,BAMBAMANURUNG,53,73,40,4,3,2,2,17,19,1,3,30,0,0,0,0,64,38,26,12,49,17,32,0,51,5,46,3,OKTOBER
SULAWESI BARAT,MAMUJU TENGAH,TOPOYO,SALULEKBO,53,29,7,3,0,0,0,1,4,0,0,7,4,0,4,0,12,10,2,3,9,4,5,2,27,23,4,19,OKTOBER
SULAWESI BARAT,MAMUJU TENGAH,TOPOYO,PANGALLOANG,98,27,11,2,0,0,0,7,3,0,3,3,3,3,0,1,11,9,2,0,11,11,0,1,6,6,0,3,OKTOBER
SULAWESI BARAT,MAMUJU TENGAH,TOPOYO,SINABATTA,57,68,32,24,19,2,1,29,2,0,3,22,4,4,0,2,34,27,7,26,17,6,11,3,8,2,6,1,OKTOBER
SULAWESI BARAT,MAMUJU TENGAH,KAROSSA,KAROSSA,36,38,32,0,0,0,0,24,5,2,11,10,5,1,4,1,27,17,10,16,15,1,14,1,15,8,7,2,OKTOBER
SULAWESI BARAT,MAMUJU TENGAH,KAROSSA,TASOKKO,62,43,14,13,5,0,0,1,12,0,2,6,4,2,2,2,31,31,0,11,7,3,4,2,10,2,8,0,OKTOBER
SULAWESI BARAT,MAMUJU TENGAH,KAROSSA,LARA,79,60,18,5,0,0,0,7,4,0,2,9,9,7,2,5,55,31,24,16,32,8,24,0,30,9,21,28,OKTOBER
SULAWESI BARAT,MAMUJU TENGAH,KAROSSA,KADAILA,33,74,39,21,7,0,0,24,2,4,19,8,2,2,0,2,50,36,14,29,28,17,11,14,16,14,2,3,OKTOBER
SULAWESI BARAT,MAMUJU TENGAH,KAROSSA,KAYU CALLA,72,21,4,0,0,0,0,3,1,0,3,0,2,2,0,1,21,18,3,1,5,3,2,2,9,2,7,7,OKTOBER
SULAWESI BARAT,MAMUJU TENGAH,KAROSSA,LEMBAH HOPO,49,66,5,1,1,1,0,1,2,1,2,3,5,3,2,0,55,38,17,10,48,9,39,1,60,37,23,26,OKTOBER
SULAWESI BARAT,MAMUJU TENGAH,KAROSSA,BENGGAULU,71,74,68,14,5,4,2,65,1,0,63,1,6,4,2,2,23,11,12,6,11,9,2,6,43,9,34,5,OKTOBER
SULAWESI BARAT,MAMUJU TENGAH,KAROSSA,SUKA MAJU,41,40,26,25,7,6,5,7,7,5,3,22,6,1,5,0,11,8,3,6,7,5,2,5,31,8,23,20,OKTOBER
SULAWESI BARAT,MAMUJU TENGAH,KAROSSA,KAMBUNONG,36,27,0,0,0,0,0,0,0,0,0,0,3,0,3,0,12,8,4,1,4,0,4,0,0,0,0,0,OKTOBER
SULAWESI BARAT,MAMUJU TENGAH,KAROSSA,SALUBIRO,96,29,8,0,0,0,0,8,0,0,1,4,5,4,1,1,16,9,7,8,4,4,0,0,20,12,8,8,OKTOBER
SULAWESI BARAT,MAMUJU TENGAH,KAROSSA,SANJANGO,82,23,2,1,0,0,0,0,1,0,2,0,1,1,0,1,22,9,13,7,13,0,13,0,3,2,1,1,OKTOBER
SULAWESI BARAT,PASANGKAYU,BAMBAIRA,TAMPAURE,71,55,8,0,0,0,0,0,8,0,7,1,1,0,1,0,30,16,14,13,26,24,2,17,53,5,48,37,OKTOBER
SULAWESI BARAT,PASANGKAYU,BAMBAIRA,BAMBAIRA,51,14,11,5,5,2,0,8,2,0,3,3,4,0,4,0,14,13,1,9,3,1,2,1,9,6,3,9,OKTOBER
SULAWESI BARAT,PASANGKAYU,BAMBAIRA,KASOLOANG,74,58,15,13,2,0,0,8,4,3,5,6,13,11,2,6,45,34,11,13,13,9,4,8,9,2,7,4,OKTOBER
SULAWESI BARAT,PASANGKAYU,BAMBAIRA,KALUKU NANGKA,60,52,52,31,14,4,3,8,9,14,18,2,11,7,4,1,19,9,10,9,0,0,0,0,31,27,4,15,OKTOBER
SULAWESI BARAT,PASANGKAYU,BAMBALAMOTU,RANDOMAYANG,63,33,16,3,0,0,0,14,0,1,16,0,7,4,3,2,25,16,9,1,2,1,1,0,20,20,0,4,OKTOBER
SULAWESI BARAT,PASANGKAYU,BAMBALAMOTU,BAMBALAMOTU,92,45,32,4,3,1,1,8,1,10,17,12,1,0,1,0,27,18,9,3,18,18,0,2,26,1,25,20,OKTOBER
SULAWESI BARAT,PASANGKAYU,BAMBALAMOTU,POLEWALI,96,29,21,11,11,9,1,19,1,0,20,1,4,0,4,0,27,11,16,6,3,1,2,1,14,5,9,9,OKTOBER
SULAWESI BARAT,PASANGKAYU,BAMBALAMOTU,PANGIANG,40,14,12,8,0,0,0,5,3,2,4,1,5,4,1,3,14,5,9,4,11,10,1,8,14,4,10,1,OKTOBER
SULAWESI BARAT,PASANGKAYU,BAMBALAMOTU,KALOLA,40,46,25,22,19,3,1,14,0,2,21,3,8,4,4,0,24,9,15,9,10,4,6,2,24,15,9,12,OKTOBER
SULAWESI BARAT,PASANGKAYU,BAMBALAMOTU,WULAI,98,29,8,5,4,3,3,4,1,0,1,1,13,7,6,1,11,6,5,2,11,1,10,0,21,14,7,16,OKTOBER
SULAWESI BARAT,PASANGKAYU,BARAS,BARAS,43,76,33,9,0,0,0,29,1,0,29,3,5,1,4,1,13,13,0,6,4,2,2,2,13,8,5,6,OKTOBER
SULAWESI BARAT,PASANGKAYU,BARAS,BULU PARIGI,43,13,10,6,3,0,0,2,3,2,5,5,0,0,0,0,13,12,1,6,12,8,4,5,9,0,9,6,OKTOBER
SULAWESI BARAT,PASANGKAYU,BARAS,BALANTI,47,17,7,6,6,2,1,5,1,0,3,3,3,0,3,0,16,15,1,15,5,5,0,5,16,3,13,13,OKTOBER
SULAWESI BARAT,PASANGKAYU,BARAS,MOTU,44,35,33,17,13,7,0,11,6,1,15,2,4,2,2,1,33,9,24,0,17,3,14,2,37,33,4,14,OKTOBER
SULAWESI BARAT,PASANGKAYU,BARAS,TOWONI,55,24,20,4,1,0,0,15,4,0,0,8,10,9,1,4,17,6,11,3,5,5,0,1,11,4,7,3,OKTOBER
SULAWESI BARAT,PASANGKAYU,BARAS,KASANO,52,79,39,23,7,1,1,20,6,2,26,11,1,0,1,0,23,22,1,1,8,1,7,1,21,13,8,9,OKTOBER
SULAWESI BARAT,PASANGKAYU,BULU TABA,SUMBER SARI,36,62,38,20,7,5,1,1,12,0,10,22,5,2,3,1,18,17,1,6,8,2,6,2,35,16,19,32,OKTOBER
SULAWESI BARAT,PASANGKAYU,BULU TABA,LELEJAE,45,52,42,25,5,2,2,20,12,6,32,9,8,7,1,6,29,8,21,6,22,9,13,7,35,7,28,32,OKTOBER
SULAWESI BARAT,PASANGKAYU,BULU TABA,BUKIT HARAPAN,46,12,11,6,1,1,0,6,0,2,0,11,9,2,7,0,11,6,5,5,2,0,2,0,1,1,0,0,OKTOBER
SULAWESI BARAT,PASANGKAYU,BULU TABA,LILIMORI,95,30,3,0,0,0,0,3,0,0,2,1,8,6,2,4,10,10,0,5,2,0,2,0,21,21,0,7,OKTOBER
SULAWESI BARAT,PASANGKAYU,BULU TABA,KARAVE,35,13,8,5,5,5,5,3,0,0,6,0,0,0,0,0,10,8,2,6,2,2,0,2,8,5,3,4,OKTOBER
SULAWESI BARAT,PASANGKAYU,BULU TABA,KASTABUANA,73,13,2,1,0,0,0,1,1,0,1,1,3,1,2,1,12,10,2,6,5,5,0,1,13,13,0,3,OKTOBER
SULAWESI BARAT,PASANGKAYU,BULU TABA,OMPI,77,35,13,12,8,6,4,4,3,2,8,2,3,2,1,0,13,6,7,0,0,0,0,0,14,7,7,9,OKTOBER
SULAWESI BARAT,PASANGKAYU,DAPURANG,DAPURANG,59,57,34,19,1,0,0,25,2,0,9,2,4,0,4,0,29,20,9,0,13,2,11,2,21,2,19,10,OKTOBER
SULAWESI BARAT,PASANGKAYU,DAPURANG,BENGGAULU,55,22,1,1,1,0,0,1,0,0,0,1,8,2,6,0,22,14,8,12,10,4,6,3,1,0,1,0,OKTOBER
SULAWESI BARAT,PASANGKAYU,DAPURANG,TIRTABUANA,54,28,19,17,4,0,0,5,12,2,18,1,6,2,4,1,12,7,5,6,2,2,0,2,14,0,14,0,OKTOBER
SULAWESI BARAT,PASANGKAYU,DAPURANG,BULU BONGGU,63,60,17,15,10,8,3,3,6,2,5,3,2,0,2,0,45,17,28,8,2,2,0,2,43,39,4,24,OKTOBER
SULAWESI BARAT,PASANGKAYU,DAPURANG,SARASA,40,60,41,10,3,0,0,3,13,16,0,13,5,2,3,0,43,6,37,6,5,5,0,3,14,12,2,13,OKTOBER
SULAWESI BARAT,PASANGKAYU,DURIPOKU,TAMMARUNANG,37,60,29,29,4,3,2,11,2,1,22,6,1,0,1,0,31,24,7,21,0,0,0,0,30,0,30,5,OKTOBER
SULAWESI BARAT,PASANGKAYU,DURIPOKU,SAPTANAJAYA,74,19,3,0,0,0,0,2,0,0,0,1,10,8,2,2,13,9,4,7,10,3,7,3,17,16,1,6,OKTOBER
SULAWESI BARAT,PASANGKAYU,DURIPOKU,TARANGGI,70,60,40,36,13,4,2,8,13,8,0,19,13,6,7,3,54,38,16,35,5,5,0,0,8,3,5,2,OKTOBER
SULAWESI BARAT,PASANGKAYU,DURIPOKU,SIPAKAINGA,41,14,2,2,1,0,0,1,1,0,0,2,4,3,1,1,14,9,5,1,14,10,4,10,18,10,8,4,OKTOBER
SULAWESI BARAT,PASANGKAYU,LARIANG,KULU,74,48,0,0,0,0,0,0,0,0,0,0,7,5,2,5,41,21,20,19,13,8,5,0,10,4,6,1,OKTOBER
SULAWESI BARAT,PASANGKAYU,LARIANG,PARABU,58,20,5,5,2,0,0,5,0,0,4,0,5,1,4,0,16,13,3,5,9,4,5,3,11,1,10,2,OKTOBER
SULAWESI BARAT,PASANGKAYU,LARIANG,KENANGAN,66,36,4,4,4,4,1,3,0,0,3,1,13,2,11,2,35,6,29,3,27,10,17,1,47,38,9,16,OKTOBER
SULAWESI BARAT,PASANGKAYU,LARIANG,BAJAWALI,72,33,22,20,16,1,1,15,4,2,14,1,0,0,0,0,33,5,28,3,18,10,8,3,23,8,15,8,OKTOBER
SULAWESI BARAT,PASANGKAYU,LARIANG,SINGGANI,100,28,26,3,0,0,0,7,11,8,9,14,10,4,6,0,20,17,3,3,3,2,1,1,14,7,7,1,OKTOBER
SULAWESI BARAT,PASANGKAYU,LARIANG,BATU MATORU,71,36,8,5,4,3,1,6,1,0,4,3,8,0,8,0,31,25,6,6,17,10,7,10,4,1,3,4,OKTOBER
SULAWESI BARAT,PASANGKAYU,LARIANG,BAMBAKORO,77,64,6,6,4,4,2,0,3,0,5,0,0,0,0,0,29,16,13,7,16,14,2,11,7,5,2,5,OKTOBER
SULAWESI BARAT,PASANGKAYU,PASANGKAYU,KARYA BERSAMA,52,16,1,0,0,0,0,1,0,0,1,0,6,4,2,2,11,11,0,5,5,0,5,0,9,4,5,2,OKTOBER
SULAWESI BARAT,PASANGKAYU,PASANGKAYU,AKO,86,58,26,7,2,1,0,9,3,5,1,0,7,2,5,0,46,9,37,2,24,12,12,2,50,30,20,49,OKTOBER
SULAWESI BARAT,PASANGKAYU,PASANGKAYU,PASANGKAYU,100,44,31,5,0,0,0,27,2,2,12,9,1,1,0,1,29,25,4,4,26,23,3,22,28,7,21,19,OKTOBER
SULAWESI BARAT,PASANGKAYU,PASANGKAYU,MARTAJAYA,88,55,50,48,33,31,8,11,18,4,3,16,10,5,5,1,51,39,12,23,4,3,1,1,7,6,1,7,OKTOBER
SULAWESI BARAT,PASANGKAYU,PASANGKAYU,PAKAVA,79,71,11,11,1,0,0,0,6,5,9,1,13,5,8,1,15,7,8,1,14,11,3,5,1,0,1,0,OKTOBER
SULAWESI BARAT,PASANGKAYU,PASANGKAYU,GUNUNG SARI,77,36,13,8,5,1,0,12,1,0,2,0,10,2,8,1,17,15,2,2,12,3,9,2,12,0,12,1,OKTOBER
SULAWESI BARAT,PASANGKAYU,PEDONGGA,MALEI,52,46,8,6,2,2,0,5,1,0,5,3,9,0,9,0,30,14,16,10,15,14,1,1,47,20,27,15,OKTOBER
SULAWESI BARAT,PASANGKAYU,PEDONGGA,PEDANDA,44,10,2,1,1,1,0,0,0,2,0,0,8,3,5,0,10,6,4,5,4,2,2,1,0,0,0,0,OKTOBER
SULAWESI BARAT,PASANGKAYU,PEDONGGA,BATU OGE,36,26,10,8,7,2,1,5,4,0,0,2,6,2,4,1,14,7,7,5,11,11,0,8,21,15,6,9,OKTOBER
SULAWESI BARAT,PASANGKAYU,PEDONGGA,MARTASARI,56,58,37,4,3,2,0,1,22,14,14,6,7,3,4,2,35,17,18,9,1,1,0,1,26,26,0,15,OKTOBER
SULAWESI BARAT,PASANGKAYU,SARJO,SARJO,96,32,15,0,0,0,0,9,0,1,7,8,4,0,4,0,12,12,0,11,0,0,0,0,5,2,3,4,OKTOBER
SULAWESI BARAT,PASANGKAYU,SARJO,MAPONU,97,26,21,20,6,2,2,12,4,3,6,7,1,1,0,1,25,14,11,7,16,9,7,7,29,0,29,19,OKTOBER
SULAWESI BARAT,PASANGKAYU,SARJO,LETAWA,72,33,20,14,1,1,0,8,9,0,6,9,8,0,8,0,13,13,0,1,1,0,1,0,16,10,6,15,OKTOBER
SULAWESI BARAT,PASANGKAYU,SARJO,SARUDE,75,40,34,32,8,5,1,28,0,2,17,12,14,8,6,7,34,12,22,10,4,0,4,0,20,14,6,8,OKTOBER
SULAWESI BARAT,PASANGKAYU,SARUDU,DODA,44,58,31,9,5,5,3,13,10,3,2,10,4,2,2,0,32,31,1,14,4,4,0,2,20,0,20,2,OKTOBER
SULAWESI BARAT,PASANGKAYU,SARUDU,SARUDU,30,16,7,4,4,0,0,6,0,1,7,0,0,0,0,0,12,5,7,5,6,0,6,0,15,9,6,7,OKTOBER
SULAWESI BARAT,PASANGKAYU,SARUDU,BULU MARIO,45,27,16,5,4,0,0,0,12,3,12,3,4,4,0,4,18,11,7,2,4,2,2,2,10,10,0,8,OKTOBER
SULAWESI BARAT,PASANGKAYU,SARUDU,KUMASARI,38,61,54,46,27,12,10,38,0,2,28,13,2,0,2,0,55,27,28,1,11,3,8,2,14,10,4,13,OKTOBER
SULAWESI BARAT,PASANGKAYU,SARUDU,PATIKA,55,55,35,15,3,2,1,1,28,2,30,1,10,0,10,0,27,16,11,12,19,18,1,15,52,12,40,11,OKTOBER
SULAWESI BARAT,PASANGKAYU,TIKKE RAYA,MAKMUR JAYA,88,38,9,1,0,0,0,4,1,1,0,3,2,2,0,2,23,17,6,5,15,4,11,3,23,4,19,10,OKTOBER
SULAWESI BARAT,PASANGKAYU,TIKKE RAYA,LARIANG,54,42,39,32,24,15,3,8,5,21,3,7,9,6,3,2,12,6,6,4,3,3,0,1,9,0,9,0,OKTOBER
SULAWESI BARAT,PASANGKAYU,TIKKE RAYA,TIKKE,40,36,24,24,22,14,7,3,12,0,14,7,2,2,0,2,10,5,5,5,7,0,7,0,8,3,5,3,OKTOBER
SULAWESI BARAT,PASANGKAYU,TIKKE RAYA,PAJALELE,42,31,13,11,2,1,1,8,4,0,12,1,3,0,3,0,29,16,13,6,12,5,7,2,17,10,7,14,OKTOBER
SULAWESI BARAT,PASANGKAYU,TIKKE RAYA,JENGENG RAYA,39,34,9,5,5,1,0,1,0,5,5,2,3,0,3,0,13,6,7,3,10,2,8,1,7,2,5,3,OKTOBER
SULAWESI BARAT,MAJENE,BANGGAE,BANGGAE,89,12,8,4,0,0,0,4,0,3,3,1,7,1,6,1,12,8,4,6,11,10,1,9,9,1,8,7,OKTOBER
SULAWESI BARAT,MAJENE,BANGGAE,BARU,81,71,43,8,7,0,0,23,2,0,12,22,1,0,1,0,37,26,11,19,21,3,18,1,29,14,15,1,OKTOBER
SULAWESI BARAT,MAJENE,BANGGAE,PANGALI ALI,45,20,2,0,0,0,0,2,0,0,2,0,6,1,5,0,17,12,5,8,12,9,3,7,11,3,8,5,OKTOBER
SULAWESI BARAT,MAJENE,BANGGAE,TOTOLI,43,49,43,35,1,0,0,8,23,6,27,7,3,3,0,3,41,36,5,3,8,4,4,1,14,0,14,10,OKTOBER
SULAWESI BARAT,MAJENE,BANGGAE,RANGAS,78,17,8,5,2,2,2,5,1,0,6,1,3,1,2,0,14,14,0,1,0,0,0,0,5,3,2,0,OKTOBER
SULAWESI BARAT,MAJENE,BANGGAE,GALUNG,59,20,7,1,1,0,0,3,1,1,2,4,1,0,1,0,18,11,7,1,8,5,3,3,19,4,15,12,OKTOBER
SULAWESI BARAT,MAJENE,BANGGAE,PALIPI SOREANG,71,40,8,6,4,3,1,2,1,4,6,2,5,4,1,2,36,26,10,21,7,5,2,1,14,11,3,3,OKTOBER
SULAWESI BARAT,MAJENE,BANGGAE,PAMBOBORANG,94,15,10,7,4,1,0,8,2,0,7,0,3,0,3,0,11,7,4,4,5,2,3,0,0,0,0,0,OKTOBER
SULAWESI BARAT,MAJENE,BANGGAE TIMUR,BAURUNG,46,28,27,13,11,8,3,9,11,4,21,6,7,2,5,0,15,7,8,1,0,0,0,0,7,5,2,6,OKTOBER
SULAWESI BARAT,MAJENE,BANGGAE TIMUR,BARUGA,70,44,1,0,0,0,0,1,0,0,0,0,13,12,1,8,39,13,26,5,6,0,6,0,18,2,16,12,OKTOBER
SULAWESI BARAT,MAJENE,BANGGAE TIMUR,BARUGA DHUA,30,79,9,2,0,0,0,2,0,6,7,1,1,0,1,0,21,21,0,16,6,1,5,1,41,14,27,4,OKTOBER
SULAWESI BARAT,MAJENE,BANGGAE TIMUR,LABUANG,67,64,19,9,7,7,3,10,0,3,6,5,3,1,2,1,11,5,6,1,7,4,3,2,25,7,18,23,OKTOBER
SULAWESI BARAT,MAJENE,BANGGAE TIMUR,TANDE,65,27,0,0,0,0,0,0,0,0,0,0,8,2,6,2,22,8,14,0,9,0,9,0,21,20,1,5,OKTOBER
SULAWESI BARAT,MAJENE,BANGGAE TIMUR,LEMBANG,86,76,11,0,0,0,0,4,6,1,1,7,14,2,12,0,18,14,4,13,10,1,9,1,34,33,1,13,OKTOBER
SULAWESI BARAT,MAJENE,BANGGAE TIMUR,LABUANG UTARA,39,45,40,3,2,0,0,36,0,2,16,8,0,0,0,0,10,9,1,6,0,0,0,0,19,16,3,0,OKTOBER
SULAWESI BARAT,MAJENE,BANGGAE TIMUR,TANDE TIMUR,54,59,9,5,0,0,0,0,1,0,8,1,4,4,0,2,50,27,23,7,7,6,1,0,44,0,44,43,OKTOBER
SULAWESI BARAT,MAJENE,BANGGAE TIMUR,BUTTU BARUGA,39,22,11,2,1,0,0,2,7,1,11,0,2,0,2,0,11,10,1,5,7,0,7,0,6,5,1,1,OKTOBER
SULAWESI BARAT,MAJENE,MALUNDA,MALUNDA,97,68,35,11,10,7,2,5,27,0,31,0,12,3,9,3,23,5,18,4,12,3,9,2,12,9,3,7,OKTOBER
SULAWESI BARAT,MAJENE,MALUNDA,LAMUNGANG BATU,42,64,4,0,0,0,0,4,0,0,2,1,3,3,0,3,48,23,25,8,42,14,28,10,5,4,1,5,OKTOBER
SULAWESI BARAT,MAJENE,MALUNDA,BAMBANGAN,98,34,7,2,0,0,0,4,0,2,5,2,8,4,4,3,34,30,4,12,6,6,0,4,0,0,0,0,OKTOBER
SULAWESI BARAT,MAJENE,MALUNDA,LOMBANG,81,38,24,19,2,0,0,20,2,1,18,1,6,0,6,0,10,7,3,0,3,0,3,0,14,10,4,0,OKTOBER
SULAWESI BARAT,MAJENE,MALUNDA,LOMBONG,67,37,11,6,6,2,2,6,1,2,6,2,1,0,1,0,26,6,20,2,19,6,13,3,25,9,16,2,OKTOBER
SULAWESI BARAT,MAJENE,MALUNDA,MEKKATTA,58,29,5,0,0,0,0,0,2,1,0,3,5,3,2,1,18,15,3,6,10,3,7,1,21,18,3,1,OKTOBER
SULAWESI BARAT,MAJENE,MALUNDA,MALIAYA,36,73,16,15,12,1,1,15,0,0,4,11,7,7,0,1,48,35,13,20,9,7,2,6,25,3,22,25,OKTOBER
SULAWESI BARAT,MAJENE,MALUNDA,LOMBANG TIMUR,31,11,10,5,5,2,1,1,3,2,5,3,3,3,0,0,10,7,3,3,0,0,0,0,7,1,6,6,OKTOBER
SULAWESI BARAT,MAJENE,MALUNDA,SALUTAHONGAN,99,70,2,0,0,0,0,0,1,1,1,0,8,7,1,3,57,11,46,4,13,4,9,1,15,13,2,2,OKTOBER
SULAWESI BARAT,MAJENE,MALUNDA,LOMBONG TIMUR,76,80,66,49,31,19,18,29,10,5,1,14,3,2,1,1,41,5,36,1,25,21,4,0,43,1,42,21,OKTOBER
SULAWESI BARAT,MAJENE,MALUNDA,MEKKATTA SELATAN,39,54,35,26,25,20,7,5,22,1,15,10,1,1,0,1,33,32,1,11,19,4,15,3,21,12,9,8,OKTOBER
SULAWESI BARAT,MAJENE,MALUNDA,KAYUANGIN,65,63,10,4,0,0,0,6,3,0,0,5,8,7,1,0,31,11,20,8,31,7,24,1,28,3,25,17,OKTOBER
SULAWESI BARAT,MAJENE,PAMBOANG,LALAMPANUA,60,48,23,11,9,3,2,5,5,6,8,12,0,0,0,0,29,22,7,11,13,9,4,6,27,13,14,26,OKTOBER
SULAWESI BARAT,MAJENE,PAMBOANG,SIRINDU,59,62,58,52,8,6,1,49,5,3,6,2,0,0,0,0,46,8,38,7,40,15,25,7,33,21,12,33,OKTOBER
SULAWESI BARAT,MAJENE,PAMBOANG,ADOLANG,61,20,15,15,1,1,1,3,5,6,6,2,4,4,0,4,15,12,3,12,7,5,2,5,21,19,2,6,OKTOBER
SULAWESI BARAT,MAJENE,PAMBOANG,BABABULO,85,60,48,46,35,28,9,12,10,11,43,0,11,3,8,1,37,5,32,3,21,18,3,17,42,18,24,7,OKTOBER
SULAWESI BARAT,MAJENE,PAMBOANG,BONDE,54,46,18,14,2,0,0,15,2,1,12,3,0,0,0,0,34,9,25,8,28,0,28,0,16,3,13,1,OKTOBER
SULAWESI BARAT,MAJENE,PAMBOANG,BETTENG,65,49,23,7,5,2,0,17,6,0,11,2,10,3,7,1,47,40,7,6,16,4,12,1,16,4,12,15,OKTOBER
SULAWESI BARAT,MAJENE,PAMBOANG,SIMBANG,100,64,63,57,55,27,2,25,18,5,37,6,8,6,2,0,58,55,3,13,17,3,14,0,8,0,8,2,OKTOBER
SULAWESI BARAT,MAJENE,PAMBOANG,BONDE UTARA,79,71,15,6,6,5,2,12,1,0,3,8,9,2,7,0,29,9,20,1,26,22,4,17,55,36,19,7,OKTOBER
SULAWESI BARAT,MAJENE,PAMBOANG,BABABULO UTARA,87,38,12,12,3,3,0,6,6,0,8,2,11,8,3,7,11,11,0,9,11,0,11,0,36,17,19,16,OKTOBER
SULAWESI BARAT,MAJENE,PAMBOANG,BUTTU PAMBOANG,65,39,32,12,5,4,0,27,2,1,4,0,7,7,0,4,35,18,17,3,8,3,5,1,22,10,12,3,OKTOBER
SULAWESI BARAT,MAJENE,PAMBOANG,BANUA ADOLANG,99,35,15,3,1,0,0,12,3,0,8,4,17,1,16,0,33,18,15,17,10,2,8,2,31,23,8,8,OKTOBER
SULAWESI BARAT,MAJENE,PAMBOANG,ADOLANG DHUA,73,63,11,0,0,0,0,7,4,0,8,0,3,1,2,0,16,7,9,0,1,0,1,0,10,7,3,7,OKTOBER
SULAWESI BARAT,MAJENE,PAMBOANG,TINAMBUNG,68,12,2,1,1,0,0,2,0,0,1,1,11,4,7,0,10,10,0,0,9,9,0,1,5,2,3,2,OKTOBER
SULAWESI BARAT,MAJENE,PAMBOANG,PESULOANG,60,66,60,36,0,0,0,44,12,4,20,21,7,1,6,1,28,15,13,11,2,1,1,1,11,11,0,10,OKTOBER
SULAWESI BARAT,MAJENE,PAMBOANG,BALOMBONG,95,71,37,5,1,1,0,12,15,8,17,11,8,3,5,2,63,32,31,8,2,0,2,0,49,29,20,32,OKTOBER
SULAWESI BARAT,MAJENE,SENDANA,MOSSO,44,15,7,6,2,1,1,2,3,1,0,6,0,0,0,0,11,11,0,5,11,1,10,0,14,12,2,5,OKTOBER
SULAWESI BARAT,MAJENE,SENDANA,MOSSO DHUA,43,14,5,3,0,0,0,2,0,1,3,0,7,1,6,1,13,7,6,4,8,0,8,0,5,4,1,3,OKTOBER
SULAWESI BARAT,MAJENE,SENDANA,TOTOLISI SENDANA,38,11,2,1,0,0,0,1,0,1,1,0,1,1,0,1,10,10,0,8,4,0,4,0,11,2,9,6,OKTOBER
SULAWESI BARAT,MAJENE,SENDANA,TALLUBANUA,36,49,31,28,12,3,3,20,0,5,2,10,2,1,1,1,32,28,4,2,27,13,14,3,41,19,22,12,OKTOBER
SULAWESI BARAT,MAJENE,SENDANA,LALATEDZONG,98,52,31,3,2,0,0,9,6,8,1,29,2,1,1,1,20,19,1,0,14,4,10,4,39,33,6,7,OKTOBER
SULAWESI BARAT,MAJENE,SENDANA,BINANGA,41,67,54,23,1,0,0,35,14,4,27,11,4,1,3,1,59,38,21,37,39,23,16,23,16,12,4,2,OKTOBER
SULAWESI BARAT,MAJENE,SENDANA,PUTTADA,81,49,11,6,5,1,1,4,0,1,10,0,11,0,11,0,35,13,22,13,33,15,18,7,53,7,46,32,OKTOBER
SULAWESI BARAT,MAJENE,SENDANA,PAMINGGALAN,79,25,13,12,6,0,0,9,1,2,9,2,0,0,0,0,10,10,0,6,1,1,0,0,2,2,0,1,OKTOBER
SULAWESI BARAT,MAJENE,SENDANA,LEPPANGANG,72,12,8,2,2,2,1,7,0,0,1,5,10,9,1,8,11,11,0,11,8,6,2,1,3,1,2,0,OKTOBER
SULAWESI BARAT,MAJENE,SENDANA,PUNDAU,100,75,71,29,10,0,0,27,9,22,3,38,8,8,0,8,29,19,10,3,22,12,10,12,15,3,12,14,OKTOBER
SULAWESI BARAT,MAJENE,SENDANA,SENDANA,86,51,49,34,13,0,0,10,3,26,23,11,9,7,2,0,44,24,20,15,22,19,3,4,48,32,16,14,OKTOBER
SULAWESI BARAT,MAJENE,SENDANA,BANUA SENDANA,40,58,13,1,1,0,0,0,8,4,9,0,6,1,5,1,43,36,7,2,28,21,7,11,65,17,48,13,OKTOBER
SULAWESI BARAT,MAJENE,SENDANA,TALLUBANUA UTARA,96,11,4,2,1,0,0,1,2,0,2,2,5,3,2,1,11,6,5,2,1,0,1,0,2,1,1,1,OKTOBER
SULAWESI BARAT,MAJENE,SENDANA,LIMBORO RAMBU-RAMBU,70,15,3,3,0,0,0,0,1,0,3,0,3,0,3,0,10,7,3,3,6,3,3,0,3,3,0,0,OKTOBER
SULAWESI BARAT,MAJENE,SENDANA,LIMBUA,37,13,11,2,0,0,0,5,4,1,1,1,6,4,2,4,13,8,5,2,5,5,0,5,6,2,4,6,OKTOBER
SULAWESI BARAT,MAJENE,SENDANA,BUKIT SAMANG,46,20,2,0,0,0,0,0,2,0,0,0,0,0,0,0,19,7,12,5,6,0,6,0,12,5,7,8,OKTOBER
SULAWESI BARAT,MAJENE,TAMMERODO SENDANA,SEPPONG,94,57,37,24,20,10,3,14,16,4,26,0,0,0,0,0,21,12,9,10,8,4,4,0,27,21,6,2,OKTOBER
SULAWESI BARAT,MAJENE,TAMMERODO SENDANA,TAMMERODO,98,47,32,2,1,1,0,27,0,5,30,1,0,0,0,0,30,5,25,0,22,12,10,5,9,7,2,4,OKTOBER
SULAWESI BARAT,MAJENE,TAMMERODO SENDANA,ULIDANG,33,50,37,32,13,13,10,11,12,4,30,4,4,3,1,0,26,17,9,14,22,12,10,3,0,0,0,0,OKTOBER
SULAWESI BARAT,MAJENE,TAMMERODO SENDANA,TALLAMBALAO,42,13,11,6,1,1,0,6,1,2,7,1,2,2,0,2,13,7,6,2,5,0,5,0,3,3,0,0,OKTOBER
SULAWESI BARAT,MAJENE,TAMMERODO SENDANA,TAMMERODO UTARA,62,76,31,23,13,6,0,2,0,20,16,4,5,3,2,3,38,32,6,0,2,2,0,2,40,16,24,36,OKTOBER
SULAWESI BARAT,MAJENE,TAMMERODO SENDANA,MANYAMBA,90,37,15,13,4,4,2,9,0,4,6,5,12,8,4,8,32,10,22,9,21,6,15,4,10,3,7,9,OKTOBER
SULAWESI BARAT,MAJENE,TAMMERODO SENDANA,AWO,44,41,35,7,1,0,0,5,13,12,21,13,5,1,4,0,33,26,7,4,24,13,11,10,27,16,11,1,OKTOBER
SULAWESI BARAT,MAJENE,TUBO SENDANA,ONANG,31,59,3,0,0,0,0,0,3,0,3,0,4,2,2,2,51,29,22,17,9,3,6,0,36,14,22,8,OKTOBER
SULAWESI BARAT,MAJENE,TUBO SENDANA,TUBO,93,64,43,21,16,10,6,3,31,3,17,24,17,17,0,4,26,17,9,9,10,9,1,8,8,6,2,4,OKTOBER
SULAWESI BARAT,MAJENE,TUBO SENDANA,ONANG UTARA,33,77,15,7,1,0,0,10,3,1,1,8,0,0,0,0,42,12,30,0,7,1,6,0,29,12,17,28,OKTOBER
SULAWESI BARAT,MAJENE,TUBO SENDANA,TUBO SELATAN,97,32,14,11,9,6,0,5,3,5,6,4,3,0,3,0,22,20,2,2,1,1,0,1,2,0,2,1,OKTOBER
SULAWESI BARAT,MAJENE,TUBO SENDANA,BONDE BONDE,71,22,1,1,1,0,0,0,0,0,1,0,4,4,0,0,20,7,13,2,6,1,5,1,2,2,0,1,OKTOBER
SULAWESI BARAT,MAJENE,TUBO SENDANA,TUBO TENGAH,46,78,54,11,5,4,1,3,40,9,34,1,7,4,3,2,57,40,17,29,5,0,5,0,27,6,21,20,OKTOBER
SULAWESI BARAT,MAJENE,TUBO SENDANA,TUBO POANG,98,52,26,22,6,1,0,11,8,4,22,1,12,8,4,8,35,25,10,8,11,7,4,6,40,32,8,35,OKTOBER
SULAWESI BARAT,MAJENE,ULUMANDA,KABIRAAN,84,54,46,28,21,19,14,8,18,4,27,3,10,6,4,5,11,7,4,0,9,5,4,3,35,24,11,31,OKTOBER
SULAWESI BARAT,MAJENE,ULUMANDA,SAMBABO,89,44,4,3,2,1,1,3,0,0,1,1,3,1,2,1,10,5,5,5,4,0,4,0,23,18,5,20,OKTOBER
SULAWESI BARAT,MAJENE,ULUMANDA,TANDEALLO,89,76,29,13,4,4,4,20,3,2,8,20,10,6,4,4,12,11,1,6,8,4,4,0,36,5,31,30,OKTOBER
SULAWESI BARAT,MAJENE,ULUMANDA,ULUMANDA,42,60,3,2,2,0,0,1,0,0,1,0,6,1,5,1,53,10,43,6,7,5,2,3,7,4,3,7,OKTOBER
SULAWESI BARAT,MAJENE,ULUMANDA,SALUTAMBUNG,89,21,7,4,3,2,1,6,0,0,5,0,17,8,9,1,16,6,10,2,11,4,7,1,1,1,0,1,OKTOBER
SULAWESI BARAT,MAJENE,ULUMANDA,POPENGA,88,56,8,6,2,0,0,0,2,4,3,4,4,0,4,0,16,14,2,3,11,4,7,2,2,0,2,2,OKTOBER
SULAWESI BARAT,MAJENE,ULUMANDA,SULAI,35,56,55,55,37,11,9,45,1,0,2,18,2,1,1,1,16,6,10,4,15,5,10,2,41,17,24,24,OKTOBER
SULAWESI BARAT,MAJENE,ULUMANDA,PANGGALO,56,80,49,22,1,1,1,16,21,7,13,5,3,1,2,0,59,39,20,4,33,22,11,12,74,17,57,55,OKTOBER
SULAWESI BARAT,MAMASA,ARALLE,ARALLE,100,45,11,0,0,0,0,7,1,2,0,8,17,9,8,2,34,20,14,7,11,7,4,3,26,7,19,13,OKTOBER
SULAWESI BARAT,MAMASA,ARALLE,RALLE ANAK,100,15,9,0,0,0,0,2,3,1,3,0,12,7,5,0,13,7,6,7,11,2,9,0,12,12,0,9,OKTOBER
SULAWESI BARAT,MAMASA,ARALLE,PANETEAN,87,49,8,1,1,0,0,1,1,3,1,1,17,16,1,14,34,18,16,12,29,10,19,6,0,0,0,0,OKTOBER
SULAWESI BARAT,MAMASA,ARALLE,UHAILANU,95,67,47,2,1,1,1,46,0,0,10,13,12,8,4,4,39,32,7,13,1,1,0,1,0,0,0,0,OKTOBER
SULAWESI BARAT,MAMASA,ARALLE,ARALLE UTARA,50,75,16,3,1,1,0,14,0,2,6,2,6,2,4,1,25,20,5,2,3,1,2,0,53,1,52,53,OKTOBER
SULAWESI BARAT,MAMASA,ARALLE,UHAIDAHO,54,54,17,15,11,3,2,8,5,1,5,7,5,4,1,0,30,15,15,2,18,18,0,17,5,1,4,5,OKTOBER
SULAWESI BARAT,MAMASA,ARALLE,BARURU,49,79,70,59,36,20,13,2,4,10,47,12,8,7,1,7,25,25,0,21,15,0,15,0,22,9,13,19,OKTOBER
SULAWESI BARAT,MAMASA,ARALLE,RALLEANAK UTARA,84,40,31,17,1,0,0,13,18,0,24,4,12,2,10,0,24,24,0,18,3,3,0,0,20,0,20,20,OKTOBER
SULAWESI BARAT,MAMASA,ARALLE,PAMOSEANG PANGGA,51,56,4,4,2,1,1,3,0,0,4,0,0,0,0,0,16,14,2,1,2,1,1,1,20,15,5,10,OKTOBER
SULAWESI BARAT,MAMASA,ARALLE,KALABE,47,76,67,18,6,4,4,19,23,2,23,10,8,2,6,0,52,17,35,15,47,43,4,28,72,56,16,43,OKTOBER
SULAWESI BARAT,MAMASA,ARALLE,ARALLE SELATAN,98,78,21,8,0,0,0,10,7,3,12,9,12,10,2,7,33,33,0,4,21,0,21,0,67,1,66,65,OKTOBER
SULAWESI BARAT,MAMASA,ARALLE,HAHANGAN,44,25,2,0,0,0,0,1,0,0,2,0,3,2,1,1,21,6,15,0,11,7,4,0,11,5,6,3,OKTOBER
SULAWESI BARAT,MAMASA,BALLA,BALLA,53,41,37,9,5,2,1,0,9,11,37,0,6,0,6,0,41,31,10,31,28,10,18,8,17,16,1,16,OKTOBER
SULAWESI BARAT,MAMASA,BALLA,BALLA BARAT,40,70,33,30,16,16,4,12,7,8,9,6,7,4,3,0,52,22,30,9,11,2,9,2,12,4,8,10,OKTOBER
SULAWESI BARAT,MAMASA,BALLA,BALLA SATANETEAN,35,69,37,7,4,2,2,10,15,2,13,15,3,2,1,1,25,9,16,6,6,4,2,2,15,11,4,4,OKTOBER
SULAWESI BARAT,MAMASA,BALLA,BALLA TUMUKA,70,12,7,6,4,1,0,1,1,5,4,2,13,10,3,4,11,7,4,5,1,0,1,0,8,7,1,0,OKTOBER
SULAWESI BARAT,MAMASA,BALLA,SEPAKUAN,76,40,15,8,5,5,4,2,6,3,3,1,5,5,0,3,34,9,25,3,1,1,0,1,24,4,20,21,OKTOBER
SULAWESI BARAT,MAMASA,BALLA,PIDARA,54,67,59,48,22,2,1,17,23,6,30,19,2,2,0,2,59,17,42,2,42,10,32,5,14,6,8,12,OKTOBER
SULAWESI BARAT,MAMASA,BALLA,BAMBAPUANG,46,26,11,1,0,0,0,1,4,6,10,1,8,1,7,1,11,8,3,4,8,8,0,7,7,1,6,4,OKTOBER
SULAWESI BARAT,MAMASA,BALLA,BALLA TIMUR,52,77,73,22,3,1,0,37,33,2,22,7,0,0,0,0,14,13,1,2,9,0,9,0,17,4,13,0,OKTOBER
SULAWESI BARAT,MAMASA,BAMBANG,MOKALLANG,64,61,29,14,0,0,0,1,24,3,10,1,7,2,5,0,50,14,36,11,39,10,29,10,5,3,2,4,OKTOBER
SULAWESI BARAT,MAMASA,BAMBANG,MASOSO,90,47,28,6,0,0,0,3,8,16,23,5,14,3,11,3,35,28,7,16,19,3,16,1,1,0,1,1,OKTOBER
SULAWESI BARAT,MAMASA,BAMBANG,SALUASSING,64,37,28,8,6,1,0,17,7,1,22,6,12,1,11,0,30,29,1,10,11,3,8,0,9,9,0,7,OKTOBER
SULAWESI BARAT,MAMASA,BAMBANG,SALUBULO,46,50,23,14,13,0,0,2,0,7,8,11,7,3,4,2,26,26,0,10,21,12,9,0,20,1,19,18,OKTOBER
SULAWESI BARAT,MAMASA,BAMBANG,SALUKADI,48,48,48,5,2,0,0,43,5,0,40,0,1,0,1,0,10,10,0,10,3,2,1,1,20,17,3,15,OKTOBER
SULAWESI BARAT,MAMASA,BAMBANG,SALUKEPOPOK,58,74,42,31,26,3,0,23,15,1,35,3,7,6,1,2,72,67,5,36,22,1,21,0,57,31,26,11,OKTOBER
SULAWESI BARAT,MAMASA,BAMBANG,ULUMAMBI BARAT,66,73,1,1,1,0,0,1,0,0,0,1,10,9,1,9,11,10,1,9,10,9,1,7,0,0,0,0,OKTOBER
SULAWESI BARAT,MAMASA,BAMBANG,LIMBADEBATA,37,51,14,6,1,0,0,14,0,0,7,7,6,4,2,3,29,18,11,10,17,14,3,0,32,20,12,1,OKTOBER
SULAWESI BARAT,MAMASA,BAMBANG,TANETE TOMBA,43,53,14,6,2,1,0,14,0,0,2,2,1,0,1,0,17,12,5,6,0,0,0,0,37,3,34,13,OKTOBER
SULAWESI BARAT,MAMASA,BAMBANG,BAMBANG,94,30,6,3,0,0,0,0,6,0,6,0,16,0,16,0,18,18,0,18,3,1,2,0,24,20,4,6,OKTOBER
SULAWESI BARAT,MAMASA,BAMBANG,RANTELEMO,85,46,25,5,3,0,0,19,4,0,8,15,14,13,1,11,41,12,29,9,7,1,6,0,36,25,11,4,OKTOBER
SULAWESI BARAT,MAMASA,BAMBANG,SALUDENGEN,77,50,28,23,1,0,0,16,10,1,2,7,2,2,0,1,19,19,0,9,8,1,7,1,39,11,28,18,OKTOBER
SULAWESI BARAT,MAMASA,BAMBANG,ULUMAMBI,93,13,8,0,0,0,0,4,0,4,6,1,8,0,8,0,10,5,5,0,8,1,7,1,8,8,0,4,OKTOBER
SULAWESI BARAT,MAMASA,BAMBANG,BAMBANG TIMUR,97,47,19,9,4,2,1,1,8,8,18,0,8,1,7,0,38,25,13,1,7,3,4,1,37,3,34,10,OKTOBER
SULAWESI BARAT,MAMASA,BAMBANG,MINANGA,55,60,9,8,7,0,0,9,0,0,0,7,1,1,0,1,23,12,11,11,18,11,7,3,39,35,4,5,OKTOBER
SULAWESI BARAT,MAMASA,BAMBANG,SIKAMASE,98,72,11,9,7,2,1,1,3,3,8,0,2,0,2,0,43,27,16,14,32,13,19,9,16,1,15,11,OKTOBER
SULAWESI BARAT,MAMASA,BAMBANG,RANTETARIMA,72,12,8,3,3,1,1,0,5,2,4,3,14,5,9,0,12,11,1,4,8,3,5,0,9,8,1,2,OKTOBER
SULAWESI BARAT,MAMASA,BAMBANG,SALURURU,72,78,36,35,0,0,0,30,6,0,1,2,0,0,0,0,30,14,16,2,15,5,10,3,24,22,2,13,OKTOBER
SULAWESI BARAT,MAMASA,BAMBANG,SALUTABANG,81,70,52,1,0,0,0,9,24,10,17,21,13,11,2,11,37,19,18,1,30,18,12,3,54,34,20,21,OKTOBER
SULAWESI BARAT,MAMASA,BAMBANG,BALATANA,45,76,2,0,0,0,0,1,0,0,0,2,0,0,0,0,58,44,14,6,35,13,22,2,52,16,36,45,OKTOBER
SULAWESI BARAT,MAMASA,BUNTUMALANGKA,BUNTUMALANGKA,82,18,9,7,1,1,1,0,4,4,1,0,14,10,4,1,17,10,7,1,9,3,6,3,4,2,2,2,OKTOBER
SULAWESI BARAT,MAMASA,BUNTUMALANGKA,RANTEBERAN,52,57,50,35,27,15,7,17,3,1,50,0,10,8,2,8,40,16,24,13,1,1,0,0,29,11,18,24,OKTOBER
SULAWESI BARAT,MAMASA,BUNTUMALANGKA,KEBANGA,68,44,42,1,0,0,0,10,11,2,5,30,11,3,8,3,12,6,6,5,0,0,0,0,19,3,16,9,OKTOBER
SULAWESI BARAT,MAMASA,BUNTUMALANGKA,SALURINDU,32,62,34,31,7,7,2,0,18,4,3,14,5,2,3,2,35,22,13,2,34,0,34,0,41,23,18,2,OKTOBER
SULAWESI BARAT,MAMASA,BUNTUMALANGKA,TAORA,94,34,30,19,18,8,1,1,21,5,3,17,3,1,2,1,17,17,0,15,14,4,10,1,14,6,8,5,OKTOBER
SULAWESI BARAT,MAMASA,BUNTUMALANGKA,KABAE,87,32,20,16,2,1,0,1,2,10,6,9,17,7,10,5,20,7,13,0,18,16,2,0,37,21,16,30,OKTOBER
SULAWESI BARAT,MAMASA,BUNTUMALANGKA,SALUTAMBUN BARAT,37,18,18,16,9,9,4,12,0,0,8,3,1,1,0,1,14,13,1,10,9,6,3,4,5,0,5,5,OKTOBER
SULAWESI BARAT,MAMASA,BUNTUMALANGKA,PENATANGAN,34,42,12,11,5,4,2,1,5,3,7,3,4,4,0,2,34,9,25,0,15,2,13,1,23,4,19,18,OKTOBER
SULAWESI BARAT,MAMASA,BUNTUMALANGKA,SALUTAMBUN TIMUR,39,65,63,30,19,9,4,21,9,10,53,0,4,2,2,1,36,9,27,4,25,24,1,15,31,18,13,22,OKTOBER
SULAWESI BARAT,MAMASA,BUNTUMALANGKA,SALUTAMBUN,55,12,7,3,1,0,0,2,4,1,3,2,11,7,4,7,10,5,5,0,10,10,0,3,7,0,7,5,OKTOBER
SULAWESI BARAT,MAMASA,BUNTUMALANGKA,ARALLE TIMUR,33,15,15,7,3,2,0,2,12,0,6,7,3,2,1,2,14,11,3,3,9,5,4,3,18,2,16,10,OKTOBER
SULAWESI BARAT,MAMASA,MAMASA,MAMASA,87,68,31,23,5,3,1,8,10,10,31,0,11,3,8,3,27,7,20,6,15,15,0,3,22,8,14,10,OKTOBER
SULAWESI BARAT,MAMASA,MAMASA,RAMBUSARATU,80,34,19,15,13,6,6,5,5,3,19,0,1,1,0,0,17,10,7,2,11,0,11,0,2,1,1,0,OKTOBER
SULAWESI BARAT,MAMASA,MAMASA,OSANGO,77,39,5,1,0,0,0,0,5,0,3,1,1,0,1,0,19,15,4,12,2,2,0,0,18,2,16,6,OKTOBER
SULAWESI BARAT,MAMASA,MAMASA,LAMBANAN,42,55,29,2,2,2,1,26,2,0,19,0,1,0,1,0,24,10,14,2,18,18,0,6,53,35,18,36,OKTOBER
SULAWESI BARAT,MAMASA,MAMASA,LEMBANA SALULO,99,48,35,28,24,22,2,13,14,0,11,23,19,8,11,6,30,28,2,27,5,1,4,1,4,0,4,1,OKTOBER
SULAWESI BARAT,MAMASA,MAMASA,TAUPE,67,77,58,31,8,6,1,28,10,16,37,14,7,3,4,2,23,23,0,14,3,3,0,2,52,42,10,25,OKTOBER
SULAWESI BARAT,MAMASA,MAMASA,BUNTU BUDA,42,38,36,22,1,0,0,31,4,0,27,6,8,4,4,3,30,19,11,7,15,0,15,0,13,8,5,13,OKTOBER
SULAWESI BARAT,MAMASA,MAMASA,TONDOK BAKARU,63,42,42,25,25,19,8,5,1,5,32,5,5,4,1,3,23,20,3,9,1,0,1,0,22,17,5,0,OKTOBER
SULAWESI BARAT,MAMASA,MAMASA,PEBASSIAN,95,43,18,12,6,3,2,7,4,2,18,0,2,1,1,0,30,12,18,10,17,10,7,3,36,12,24,20,OKTOBER
SULAWESI BARAT,MAMASA,MAMASA,MAMBULILING,90,75,63,49,0,0,0,46,2,8,6,7,18,15,3,14,47,39,8,17,31,18,13,15,34,0,34,19,OKTOBER
SULAWESI BARAT,MAMASA,MAMASA,BOMBONG LAMBE,86,63,60,41,5,4,0,4,20,21,30,8,7,6,1,3,62,24,38,15,33,11,22,1,2,2,0,1,OKTOBER
SULAWESI BARAT,MAMASA,MAMASA,BUBUN BATU,55,34,2,0,0,0,0,0,2,0,0,1,3,1,2,1,18,9,9,3,16,12,4,7,23,5,18,4,OKTOBER
SULAWESI BARAT,MAMASA,MAMBI,MAMBI,88,16,15,12,5,5,3,3,7,1,10,4,9,4,5,2,16,16,0,3,16,13,3,12,7,6,1,5,OKTOBER
SULAWESI BARAT,MAMASA,MAMBI,TALIPUKKI,95,19,0,0,0,0,0,0,0,0,0,0,1,1,0,1,13,10,3,2,2,1,1,1,11,4,7,6,OKTOBER
SULAWESI BARAT,MAMASA,MAMBI,RANTEBULAHAN,99,18,17,14,8,5,5,8,4,0,0,13,17,9,8,6,14,12,2,1,5,4,1,1,16,6,10,16,OKTOBER
SULAWESI BARAT,MAMASA,MAMBI,SONDONGLAYU,93,49,36,12,10,3,3,20,1,12,24,4,14,1,13,1,19,15,4,10,8,0,8,0,10,7,3,2,OKTOBER
SULAWESI BARAT,MAMASA,MAMBI,SALUBANUA,90,56,23,5,5,5,4,9,7,2,17,4,9,9,0,9,53,29,24,27,25,6,19,5,15,15,0,6,OKTOBER
SULAWESI BARAT,MAMASA,MAMBI,TAPALINA,30,31,31,18,3,1,1,21,7,1,13,13,5,4,1,1,24,11,13,5,6,5,1,3,15,9,6,5,OKTOBER
SULAWESI BARAT,MAMASA,MAMBI,SENDANA,61,16,13,9,8,5,4,0,5,3,11,2,8,0,8,0,15,9,6,7,7,7,0,4,5,5,0,3,OKTOBER
SULAWESI BARAT,MAMASA,MAMBI,PAMOSEAN,84,51,14,6,1,0,0,2,7,4,5,3,14,5,9,1,25,8,17,0,20,1,19,0,40,18,22,0,OKTOBER
SULAWESI BARAT,MAMASA,MAMBI,SELUMAKA,41,36,27,21,7,2,1,22,2,0,7,11,7,3,4,2,17,16,1,9,6,0,6,0,19,5,14,7,OKTOBER
SULAWESI BARAT,MAMASA,MAMBI,BUJUNG MANURUNG,46,62,6,4,3,2,1,4,0,0,1,1,6,1,5,1,39,12,27,4,4,1,3,0,43,22,21,29,OKTOBER
SULAWESI BARAT,MAMASA,MAMBI,SALU ALO,52,43,31,26,2,2,1,8,15,7,27,0,4,4,0,3,25,12,13,2,17,8,9,0,34,34,0,2,OKTOBER
SULAWESI BARAT,MAMASA,MAMBI,INDOBANUA,69,67,67,66,2,0,0,25,29,11,1,17,4,2,2,0,63,42,21,41,24,9,15,3,60,18,42,58,OKTOBER
SULAWESI BARAT,MAMASA,MAMBI,SALUDURIAN,95,36,35,2,0,0,0,35,0,0,28,0,6,5,1,2,30,17,13,15,26,13,13,9,45,20,25,15,OKTOBER
SULAWESI BARAT,MAMASA,MEHALAAN,MEHALAAN,92,49,2,1,1,1,0,2,0,0,1,0,3,1,2,1,40,7,33,1,22,16,6,16,38,35,3,6,OKTOBER
SULAWESI BARAT,MAMASA,MEHALAAN,BOTTENG,97,46,36,15,14,9,6,19,5,2,4,5,4,0,4,0,28,22,6,19,23,20,3,19,24,4,20,16,OKTOBER
SULAWESI BARAT,MAMASA,MEHALAAN,SALUKONTA,98,59,23,18,14,3,3,3,5,10,12,4,0,0,0,0,38,30,8,18,1,0,1,0,31,26,5,21,OKTOBER
SULAWESI BARAT,MAMASA,MEHALAAN,MESAKADA,88,21,1,1,1,0,0,0,1,0,1,0,0,0,0,0,14,8,6,7,11,10,1,10,17,11,6,11,OKTOBER
SULAWESI BARAT,MAMASA,MEHALAAN,MEHALAAN BARAT,61,70,53,36,2,0,0,51,1,1,44,6,11,0,11,0,48,28,20,2,5,4,1,0,24,10,14,13,OKTOBER
SULAWESI BARAT,MAMASA,MEHALAAN,SALUAHOK,65,72,19,12,0,0,0,6,6,3,11,2,9,0,9,0,50,14,36,4,46,39,7,24,31,26,5,18,OKTOBER
SULAWESI BARAT,MAMASA,MEHALAAN,SALUBALO,97,12,1,0,0,0,0,0,0,1,1,0,10,5,5,3,10,9,1,4,10,6,4,3,17,0,17,9,OKTOBER
SULAWESI BARAT,MAMASA,MEHALAAN,PASSEMBUK,82,41,0,0,0,0,0,0,0,0,0,0,9,8,1,0,39,6,33,5,37,6,31,0,47,29,18,10,OKTOBER
SULAWESI BARAT,MAMASA,MEHALAAN,KONDO,70,68,63,4,2,1,1,17,11,18,5,52,10,7,3,0,30,9,21,1,13,10,3,3,13,1,12,13,OKTOBER
SULAWESI BARAT,MAMASA,MEHALAAN,LEKO SUKAMAJU,48,39,20,19,6,1,0,15,5,0,0,12,2,2,0,0,11,6,5,6,6,5,1,5,5,2,3,1,OKTOBER
SULAWESI BARAT,MAMASA,MEHALAAN,ULUMEA,78,79,60,46,16,15,8,30,8,14,4,43,10,9,1,0,56,22,34,19,38,15,23,8,32,16,16,17,OKTOBER
SULAWESI BARAT,MAMASA,MESSAWA,MESSAWA,64,60,5,3,3,1,1,2,1,1,2,1,5,5,0,2,43,5,38,2,6,1,5,0,18,0,18,10,OKTOBER
SULAWESI BARAT,MAMASA,MESSAWA,RIPPUNG,80,66,11,7,5,4,1,4,5,1,2,1,16,0,16,0,62,45,17,31,55,21,34,0,90,46,44,55,OKTOBER
SULAWESI BARAT,MAMASA,MESSAWA,MAKUANG,77,37,23,5,1,1,0,5,2,10,17,3,10,3,7,3,20,12,8,0,4,0,4,0,13,8,5,7,OKTOBER
SULAWESI BARAT,MAMASA,MESSAWA,SEPANG,50,79,28,14,6,6,2,3,18,5,1,16,7,6,1,2,43,33,10,21,22,22,0,14,71,23,48,62,OKTOBER
SULAWESI BARAT,MAMASA,MESSAWA,MALIMBONG,99,60,3,3,0,0,0,0,2,1,1,0,10,4,6,0,21,7,14,3,8,2,6,0,47,17,30,0,OKTOBER
SULAWESI BARAT,MAMASA,MESSAWA,MATANDE,93,20,15,4,1,1,0,5,8,0,9,5,15,13,2,3,14,10,4,0,1,1,0,1,5,1,4,0,OKTOBER
SULAWESI BARAT,MAMASA,MESSAWA,SIPAI,58,35,4,4,1,0,0,1,1,0,1,3,11,0,11,0,34,22,12,11,18,1,17,0,34,19,15,7,OKTOBER
SULAWESI BARAT,MAMASA,MESSAWA,PASMA MAMBU,60,44,32,17,0,0,0,16,16,0,12,14,0,0,0,0,12,7,5,1,12,10,2,4,15,2,13,6,OKTOBER
SULAWESI BARAT,MAMASA,MESSAWA,TANETE BATU,63,18,2,1,1,0,0,1,0,0,1,0,10,8,2,0,10,9,1,0,5,3,2,1,6,3,3,2,OKTOBER
SULAWESI BARAT,MAMASA,NOSU,NOSU,66,21,5,1,0,0,0,0,4,1,1,4,0,0,0,0,10,6,4,4,4,4,0,2,2,2,0,2,OKTOBER
SULAWESI BARAT,MAMASA,NOSU,MINANGA,100,72,19,7,1,0,0,16,1,0,1,5,0,0,0,0,58,32,26,18,39,13,26,2,19,8,11,17,OKTOBER
SULAWESI BARAT,MAMASA,NOSU,BATUPAPAN,49,41,7,3,1,0,0,6,0,1,6,1,1,1,0,0,14,12,2,1,7,2,5,0,28,7,21,7,OKTOBER
SULAWESI BARAT,MAMASA,NOSU,MASEWWE,35,26,2,2,2,1,0,1,0,1,1,0,0,0,0,0,11,9,2,3,1,1,0,1,5,4,1,5,OKTOBER
SULAWESI BARAT,MAMASA,NOSU,SIWI,55,19,18,1,0,0,0,10,1,4,6,0,2,0,2,0,18,18,0,5,2,1,1,1,0,0,0,0,OKTOBER
SULAWESI BARAT,MAMASA,NOSU,MINANGA TIMUR,46,68,0,0,0,0,0,0,0,0,0,0,8,3,5,2,44,12,32,3,4,1,3,0,44,2,42,15,OKTOBER
SULAWESI BARAT,MAMASA,NOSU,PARINDING,61,18,18,6,2,1,0,9,7,0,5,8,9,9,0,1,16,14,2,0,2,1,1,0,6,4,2,4,OKTOBER
SULAWESI BARAT,MAMASA,PANA,PANA,55,29,23,8,3,2,0,4,1,10,14,0,1,0,1,0,24,19,5,11,22,8,14,4,16,7,9,7,OKTOBER
SULAWESI BARAT,MAMASA,PANA,MANIPI,67,61,53,52,25,3,1,21,25,2,47,6,13,7,6,4,38,16,22,5,4,1,3,0,32,24,8,27,OKTOBER
SULAWESI BARAT,MAMASA,PANA,MAMULLU,34,67,26,14,12,2,2,18,5,0,1,16,3,3,0,3,25,23,2,9,16,15,1,1,51,6,45,41,OKTOBER
SULAWESI BARAT,MAMASA,PANA,SAPAN,89,20,0,0,0,0,0,0,0,0,0,0,0,0,0,0,13,6,7,4,12,0,12,0,26,26,0,0,OKTOBER
SULAWESI BARAT,MAMASA,PANA,DATUBARINGAN,54,63,51,44,29,10,10,6,17,6,16,6,0,0,0,0,60,41,19,21,45,2,43,2,6,0,6,0,OKTOBER
SULAWESI BARAT,MAMASA,PANA,PANURA,33,74,50,3,3,0,0,43,7,0,45,4,4,3,1,3,21,16,5,12,19,1,18,1,19,19,0,11,OKTOBER
SULAWESI BARAT,MAMASA,PANA,TALLANG BULAWAN,85,47,28,25,9,4,2,13,0,7,25,2,2,0,2,0,32,16,16,3,10,4,6,0,42,5,37,4,OKTOBER
SULAWESI BARAT,MAMASA,PANA,KARAKA,40,44,9,7,4,1,0,6,2,1,2,5,3,0,3,0,32,30,2,15,25,25,0,6,31,13,18,20,OKTOBER
SULAWESI BARAT,MAMASA,PANA,ULUSALU,31,47,41,41,35,8,4,36,0,0,7,10,4,4,0,4,33,11,22,3,8,3,5,3,34,1,33,14,OKTOBER
SULAWESI BARAT,MAMASA,PANA,WERI,100,57,52,4,4,4,1,12,38,1,49,1,13,12,1,11,18,13,5,3,6,1,5,1,4,3,1,0,OKTOBER
SULAWESI BARAT,MAMASA,PANA,SALUTAMBUN,38,56,39,39,36,7,1,12,20,1,0,19,3,1,2,1,48,48,0,17,38,16,22,11,62,41,21,10,OKTOBER
SULAWESI BARAT,MAMASA,PANA,SALOAN,31,46,17,14,10,10,1,6,6,3,5,5,5,4,1,3,17,7,10,2,13,1,12,0,5,5,0,3,OKTOBER
SULAWESI BARAT,MAMASA,PANA,ULUSALU INDAH,70,53,53,38,16,9,0,50,0,1,13,18,7,7,0,6,28,13,15,3,23,17,6,11,37,30,7,29,OKTOBER
SULAWESI BARAT,MAMASA,RANTEBULAHAN TIMUR,SALUMOKANAN,35,66,5,1,0,0,0,0,1,0,3,1,5,1,4,1,27,19,8,10,15,0,15,0,3,2,1,3,OKTOBER
SULAWESI BARAT,MAMASA,RANTEBULAHAN TIMUR,SALUMOKANAN BARAT,99,61,3,0,0,0,0,2,0,1,1,1,11,6,5,0,18,5,13,4,10,8,2,5,10,8,2,10,OKTOBER
SULAWESI BARAT,MAMASA,RANTEBULAHAN TIMUR,BUANGIN,42,68,55,53,16,5,1,42,8,3,9,32,0,0,0,0,24,11,13,9,19,0,19,0,32,7,25,25,OKTOBER
SULAWESI BARAT,MAMASA,RANTEBULAHAN TIMUR,BAMBANG BUDA,52,50,41,39,4,1,1,37,2,1,31,3,7,3,4,2,17,14,3,0,7,7,0,6,16,6,10,5,OKTOBER
SULAWESI BARAT,MAMASA,RANTEBULAHAN TIMUR,LEKO,77,13,7,1,0,0,0,0,6,1,6,1,2,0,2,0,12,11,1,0,0,0,0,0,9,1,8,6,OKTOBER
SULAWESI BARAT,MAMASA,RANTEBULAHAN TIMUR,KIRAK,33,24,12,4,3,0,0,8,2,1,3,4,2,2,0,1,18,7,11,5,7,0,7,0,21,12,9,10,OKTOBER
SULAWESI BARAT,MAMASA,RANTEBULAHAN TIMUR,SALUMOKANAN UTARA,54,18,0,0,0,0,0,0,0,0,0,0,3,2,1,0,10,8,2,2,9,0,9,0,10,8,2,2,OKTOBER
SULAWESI BARAT,MAMASA,RANTEBULAHAN TIMUR,SAMPALE,35,13,13,6,3,1,0,11,0,0,3,2,2,2,0,2,12,10,2,2,4,3,1,0,10,2,8,0,OKTOBER
SULAWESI BARAT,MAMASA,SESENAPADANG,OROBUA,86,62,12,1,0,0,0,9,3,0,3,6,5,3,2,2,60,51,9,47,58,18,40,4,13,8,5,0,OKTOBER
SULAWESI BARAT,MAMASA,SESENAPADANG,PALADAN,84,54,23,23,6,5,1,1,1,1,10,12,7,2,5,1,28,24,4,23,10,3,7,1,45,35,10,35,OKTOBER
SULAWESI BARAT,MAMASA,SESENAPADANG,OROBUA TIMUR,74,75,71,0,0,0,0,7,5,55,28,16,10,2,8,1,63,47,16,30,60,52,8,5,15,6,9,13,OKTOBER
SULAWESI BARAT,MAMASA,SESENAPADANG,RANTE PUANG,71,25,9,7,0,0,0,5,2,1,9,0,11,8,3,7,13,11,2,3,1,0,1,0,6,4,2,4,OKTOBER
SULAWESI BARAT,MAMASA,SESENAPADANG,SATENETEAN,71,29,24,12,7,5,0,22,2,0,24,0,2,0,2,0,19,11,8,2,8,2,6,2,28,10,18,23,OKTOBER
SULAWESI BARAT,MAMASA,SESENAPADANG,LISUAN ADA,35,28,3,2,2,2,1,0,1,1,2,0,3,0,3,0,22,7,15,0,12,5,7,4,28,23,5,20,OKTOBER
SULAWESI BARAT,MAMASA,SESENAPADANG,OROBUA SELATAN,58,46,4,1,0,0,0,0,3,0,1,3,9,9,0,2,34,17,17,7,20,20,0,19,43,15,28,25,OKTOBER
SULAWESI BARAT,MAMASA,SESENAPADANG,MALANGKENA PADANG,81,33,26,22,1,0,0,25,1,0,3,23,11,2,9,2,11,5,6,0,8,1,7,1,0,0,0,0,OKTOBER
SULAWESI BARAT,MAMASA,SESENAPADANG,MALIMBONG,48,59,29,21,8,6,6,16,0,0,19,9,9,0,9,0,45,43,2,6,5,0,5,0,40,35,5,6,OKTOBER
SULAWESI BARAT,MAMASA,SESENAPADANG,MARAMPAN OROBUA,72,78,53,21,3,1,1,39,3,9,0,7,6,5,1,2,45,39,6,11,5,5,0,5,8,1,7,1,OKTOBER
SULAWESI BARAT,MAMASA,SUMARORONG,SUMARORONG,48,52,6,5,0,0,0,0,2,3,6,0,5,3,2,1,40,19,21,17,34,25,9,7,57,22,35,51,OKTOBER
SULAWESI BARAT,MAMASA,SUMARORONG,TABONE,58,27,7,4,2,1,0,7,0,0,2,3,3,2,1,2,15,9,6,8,1,1,0,0,6,2,4,3,OKTOBER
SULAWESI BARAT,MAMASA,SUMARORONG,BATANG URU,47,23,0,0,0,0,0,0,0,0,0,0,8,2,6,1,18,12,6,5,0,0,0,0,3,2,1,3,OKTOBER
SULAWESI BARAT,MAMASA,SUMARORONG,SASAKAN,70,62,46,30,21,15,11,7,7,0,39,3,13,3,10,1,23,10,13,0,16,3,13,0,0,0,0,0,OKTOBER
SULAWESI BARAT,MAMASA,SUMARORONG,TADISI,48,47,45,9,4,2,1,43,1,0,39,5,8,3,5,1,37,21,16,8,30,5,25,2,47,22,25,37,OKTOBER
SULAWESI BARAT,MAMASA,SUMARORONG,SIBANAWA,64,26,20,11,0,0,0,8,4,6,12,8,8,7,1,2,10,6,4,4,10,3,7,3,22,2,20,22,OKTOBER
SULAWESI BARAT,MAMASA,SUMARORONG,BATANGNGURU TIMUR,71,28,24,6,4,1,1,14,5,3,3,2,11,1,10,0,10,7,3,6,9,6,3,6,18,15,3,6,OKTOBER
SULAWESI BARAT,MAMASA,SUMARORONG,SALUBALO,39,27,17,6,4,1,1,2,12,0,0,0,2,2,0,0,19,16,3,14,2,2,0,0,8,8,0,7,OKTOBER
SULAWESI BARAT,MAMASA,SUMARORONG,BANEA,60,38,11,1,0,0,0,2,2,6,2,8,3,3,0,0,26,7,19,5,20,5,15,0,36,4,32,0,OKTOBER
SULAWESI BARAT,MAMASA,SUMARORONG,RANTE KAMASE,73,33,4,2,2,0,0,2,0,1,0,1,12,0,12,0,10,8,2,5,4,1,3,1,11,7,4,8,OKTOBER
SULAWESI BARAT,MAMASA,TABANG,TABANG,98,71,44,43,0,0,0,44,0,0,42,2,19,9,10,5,28,26,2,19,17,14,3,4,53,33,20,50,OKTOBER
SULAWESI BARAT,MAMASA,TABANG,TADOKALUA,77,10,3,3,0,0,0,0,1,1,0,0,2,1,1,0,10,7,3,3,10,1,9,0,3,2,1,1,OKTOBER
SULAWESI BARAT,MAMASA,TABANG,TABANG BARAT,43,42,0,0,0,0,0,0,0,0,0,0,0,0,0,0,39,23,16,13,14,13,1,2,27,16,11,0,OKTOBER
SULAWESI BARAT,MAMASA,TABANG,MASUPU,67,68,52,20,7,0,0,50,1,1,13,23,0,0,0,0,41,8,33,7,21,7,14,5,66,16,50,39,OKTOBER
SULAWESI BARAT,MAMASA,TABANG,KALAMA,37,20,16,5,0,0,0,13,0,0,2,4,4,0,4,0,14,5,9,0,9,1,8,0,10,1,9,2,OKTOBER
SULAWESI BARAT,MAMASA,TABANG,BAKADISURA,60,27,24,19,18,1,0,17,0,2,4,6,5,3,2,1,23,16,7,12,18,2,16,2,36,36,0,2,OKTOBER
SULAWESI BARAT,MAMASA,TABANG,SALUKONA,49,59,52,22,4,3,2,33,15,0,28,15,5,5,0,5,38,30,8,10,15,5,10,5,24,4,20,12,OKTOBER
SULAWESI BARAT,MAMASA,TABULAHAN,LAKAHANG,48,59,19,15,12,3,0,1,8,6,7,1,9,1,8,1,10,10,0,10,4,1,3,0,37,17,20,22,OKTOBER
SULAWESI BARAT,MAMASA,TABULAHAN,PERIANGAN,68,34,3,0,0,0,0,3,0,0,3,0,2,0,2,0,23,7,16,1,13,13,0,4,2,0,2,1,OKTOBER
SULAWESI BARAT,MAMASA,TABULAHAN,MALATIRO,38,65,12,10,7,0,0,9,3,0,9,0,3,2,1,2,64,27,37,16,23,18,5,9,40,9,31,38,OKTOBER
SULAWESI BARAT,MAMASA,TABULAHAN,TABULAHAN,70,54,22,0,0,0,0,2,12,2,1,13,9,0,9,0,34,27,7,11,16,10,6,8,33,32,1,12,OKTOBER
SULAWESI BARAT,MAMASA,TABULAHAN,SALULEANG,82,57,28,19,13,5,1,13,8,4,26,2,10,6,4,0,33,20,13,19,22,16,6,8,20,3,17,9,OKTOBER
SULAWESI BARAT,MAMASA,TABULAHAN,TAMPAK KURRA,70,55,33,6,5,0,0,31,2,0,32,0,7,7,0,7,31,7,24,3,21,10,11,4,47,14,33,7,OKTOBER
SULAWESI BARAT,MAMASA,TABULAHAN,GANDANG DEWATA,94,70,62,60,3,3,2,7,41,2,44,4,1,1,0,1,67,11,56,9,1,1,0,1,7,5,2,1,OKTOBER
SULAWESI BARAT,MAMASA,TABULAHAN,BURANA,64,75,31,11,2,1,0,20,8,0,20,6,3,2,1,0,60,19,41,13,34,14,20,4,23,2,21,8,OKTOBER
SULAWESI BARAT,MAMASA,TABULAHAN,SALUBAKKA,42,18,10,4,4,3,0,10,0,0,10,0,4,1,3,1,17,12,5,11,3,3,0,0,13,9,4,5,OKTOBER
SULAWESI BARAT,MAMASA,TABULAHAN,PANGANDARAN,60,74,33,12,2,2,1,7,19,3,3,10,3,3,0,0,56,37,19,32,10,8,2,5,36,17,19,16,OKTOBER
SULAWESI BARAT,MAMASA,TABULAHAN,TALOPAK,39,31,9,4,0,0,0,4,5,0,4,5,4,4,0,1,30,17,13,3,9,2,7,0,20,16,4,8,OKTOBER
SULAWESI BARAT,MAMASA,TABULAHAN,PEU',41,21,19,12,1,0,0,14,4,1,15,3,8,6,2,6,16,13,3,8,6,2,4,1,3,0,3,1,OKTOBER
SULAWESI BARAT,MAMASA,TABULAHAN,TIMORO,70,60,30,3,1,1,0,23,4,0,21,8,14,4,10,2,17,16,1,16,3,0,3,0,33,21,12,20,OKTOBER
SULAWESI BARAT,MAMASA,TABULAHAN,LAKAHANG UTAMA,75,66,42,16,15,7,3,11,19,3,16,25,3,2,1,2,65,13,52,7,16,5,11,4,11,3,8,11,OKTOBER
SULAWESI BARAT,MAMASA,TANDUK KALUA,MINAKE,40,20,5,0,0,0,0,5,0,0,0,3,8,0,8,0,12,9,3,1,7,4,3,0,2,1,1,0,OKTOBER
SULAWESI BARAT,MAMASA,TANDUK KALUA,MALABO,57,75,53,14,2,1,0,22,8,11,49,0,8,3,5,3,68,35,33,11,48,36,12,12,30,13,17,0,OKTOBER
SULAWESI BARAT,MAMASA,TANDUK KALUA,SINDAGAMANIK,50,40,24,19,17,4,3,13,7,1,23,0,2,0,2,0,39,16,23,11,11,4,7,1,31,8,23,27,OKTOBER
SULAWESI BARAT,MAMASA,TANDUK KALUA,PARONDOBULAWAN,30,50,24,3,3,0,0,11,0,9,2,16,1,1,0,1,46,22,24,7,37,18,19,15,6,1,5,2,OKTOBER
SULAWESI BARAT,MAMASA,TANDUK KALUA,TAMALANTIK,82,40,22,20,10,3,0,2,15,2,1,4,4,0,4,0,30,21,9,4,19,9,10,1,28,0,28,15,OKTOBER
SULAWESI BARAT,MAMASA,TANDUK KALUA,MANNABABA,34,26,5,2,2,1,1,2,2,0,0,4,1,1,0,0,26,15,11,12,18,2,16,2,17,15,2,11,OKTOBER
SULAWESI BARAT,MAMASA,TANDUK KALUA,MESAKADA,41,54,33,30,17,10,4,25,3,0,11,10,2,1,1,0,13,10,3,6,0,0,0,0,19,6,13,18,OKTOBER
SULAWESI BARAT,MAMASA,TANDUK KALUA,BALLABATU,82,24,24,9,8,8,0,17,5,0,2,14,15,6,9,5,12,12,0,8,2,0,2,0,7,0,7,6,OKTOBER
SULAWESI BARAT,MAMASA,TANDUK KALUA,PAMBE,30,46,27,8,8,4,2,10,10,2,27,0,3,3,0,2,36,10,26,10,11,8,3,3,36,15,21,28,OKTOBER
SULAWESI BARAT,MAMASA,TANDUK KALUA,SALURANO,54,67,36,7,3,3,3,15,17,1,1,15,5,3,2,1,54,5,49,2,22,4,18,2,30,28,2,28,OKTOBER
SULAWESI BARAT,MAMASA,TANDUK KALUA,TALIMBUNG,78,54,32,15,0,0,0,18,3,9,15,9,7,1,6,0,30,17,13,16,23,5,18,2,9,3,6,7,OKTOBER
SULAWESI BARAT,MAMASA,TANDUK KALUA,KANAN,85,69,27,18,6,2,2,15,8,1,25,1,0,0,0,0,38,13,25,10,10,8,2,3,4,3,1,0,OKTOBER
SULAWESI BARAT,MAMASA,TAWALIAN,TAWALIAN,34,60,37,8,0,0,0,8,1,24,7,19,0,0,0,0,45,45,0,11,34,17,17,12,41,38,3,23,OKTOBER
SULAWESI BARAT,MAMASA,TAWALIAN,TAWALIAN TIMUR,96,61,1,0,0,0,0,1,0,0,1,0,6,1,5,0,47,44,3,22,9,9,0,8,13,1,12,1,OKTOBER
SULAWESI BARAT,MAMASA,TAWALIAN,KARIANGO,50,26,0,0,0,0,0,0,0,0,0,0,8,0,8,0,24,21,3,13,16,0,16,0,1,0,1,0,OKTOBER
SULAWESI BARAT,MAMASA,TAWALIAN,RANTETANGNGA,71,56,6,6,3,0,0,4,0,1,4,1,13,13,0,5,25,23,2,16,9,1,8,0,32,25,7,16,OKTOBER
SULAWESI BARAT,POLEWALI MANDAR,ALLU,PETOOSANG,79,16,4,2,1,1,0,0,0,0,2,0,15,0,15,0,14,5,9,5,4,2,2,0,13,4,9,11,OKTOBER
SULAWESI BARAT,POLEWALI MANDAR,ALLU,MOMBI,90,33,16,9,2,1,1,7,0,8,3,9,0,0,0,0,31,8,23,6,10,9,1,1,15,13,2,9,OKTOBER
SULAWESI BARAT,POLEWALI MANDAR,ALLU,KALUMAMMANG,60,78,2,0,0,0,0,0,2,0,2,0,4,3,1,1,78,26,52,12,31,15,16,15,29,27,2,23,OKTOBER
SULAWESI BARAT,POLEWALI MANDAR,ALLU,PAO-PAO,68,10,3,1,0,0,0,1,0,1,1,1,2,1,1,0,10,10,0,8,8,2,6,0,7,1,6,4,OKTOBER
SULAWESI BARAT,POLEWALI MANDAR,ALLU,PUPPU URING,69,71,48,12,6,1,0,47,1,0,34,12,2,2,0,1,35,20,15,11,20,18,2,2,38,38,0,15,OKTOBER
SULAWESI BARAT,POLEWALI MANDAR,ALLU,SARAGIAN,60,39,13,5,2,0,0,5,0,7,0,4,11,1,10,1,23,12,11,8,11,0,11,0,21,10,11,4,OKTOBER
SULAWESI BARAT,POLEWALI MANDAR,ALLU,SAYOANG,88,41,35,33,11,0,0,2,32,1,5,10,4,4,0,2,15,14,1,1,6,5,1,5,32,32,0,27,OKTOBER
SULAWESI BARAT,POLEWALI MANDAR,ALLU,ALU,45,56,28,1,1,1,0,18,3,4,0,6,2,0,2,0,14,9,5,0,11,11,0,3,22,0,22,16,OKTOBER
SULAWESI BARAT,POLEWALI MANDAR,ANREAPI,ANREAPI,98,66,43,33,4,4,4,1,2,19,17,12,9,0,9,0,46,5,41,0,34,5,29,1,39,34,5,15,OKTOBER
SULAWESI BARAT,POLEWALI MANDAR,ANREAPI,DUAMPANUA,68,80,35,26,4,0,0,21,9,1,21,14,7,5,2,1,44,19,25,5,14,12,2,3,7,3,4,1,OKTOBER
SULAWESI BARAT,POLEWALI MANDAR,ANREAPI,KELAPA DUA,51,21,13,11,7,1,0,5,7,1,13,0,7,6,1,0,20,5,15,2,18,11,7,5,32,24,8,0,OKTOBER
SULAWESI BARAT,POLEWALI MANDAR,ANREAPI,PAPPANDANGAN,85,45,1,0,0,0,0,1,0,0,1,0,15,13,2,11,18,13,5,9,12,3,9,2,34,22,12,23,OKTOBER
SULAWESI BARAT,POLEWALI MANDAR,ANREAPI,KUNYI,32,12,8,8,2,2,2,5,1,0,3,4,4,1,3,0,10,6,4,3,3,2,1,1,10,6,4,6,OKTOBER
SULAWESI BARAT,POLEWALI MANDAR,BALANIPA,BALANIPA,90,80,35,3,3,0,0,32,3,0,22,7,1,0,1,0,39,38,1,18,22,15,7,11,8,7,1,6,OKTOBER
SULAWESI BARAT,POLEWALI MANDAR,BALANIPA,TAMMAJARRA,63,61,42,24,7,3,1,5,25,7,6,9,6,1,5,1,44,16,28,9,8,0,8,0,35,5,30,12,OKTOBER
SULAWESI BARAT,POLEWALI MANDAR,BALANIPA,TAMANGGALLE,65,14,14,13,4,1,0,7,6,0,0,11,0,0,0,0,11,11,0,0,8,0,8,0,3,3,0,2,OKTOBER
SULAWESI BARAT,POLEWALI MANDAR,BALANIPA,MOSSO,57,72,6,6,1,0,0,0,6,0,3,1,10,10,0,5,16,9,7,0,0,0,0,0,46,22,24,22,OKTOBER
SULAWESI BARAT,POLEWALI MANDAR,BALANIPA,GALUNG TULUK,38,46,22,17,14,3,1,7,5,0,7,0,7,5,2,0,30,20,10,13,22,0,22,0,33,15,18,10,OKTOBER
SULAWESI BARAT,POLEWALI MANDAR,BALANIPA,SABANG SUBIK,35,30,7,5,4,0,0,5,0,0,0,2,7,7,0,4,14,5,9,4,13,10,3,3,33,17,16,28,OKTOBER
SULAWESI BARAT,POLEWALI MANDAR,BALANIPA,PAMBUSUANG,89,19,10,4,4,4,3,6,0,0,4,3,9,3,6,1,16,15,1,6,3,3,0,3,3,0,3,1,OKTOBER
SULAWESI BARAT,POLEWALI MANDAR,BALANIPA,BALA,39,64,44,31,30,29,21,20,2,0,0,30,7,7,0,3,56,9,47,9,46,13,33,7,66,22,44,61,OKTOBER
SULAWESI BARAT,POLEWALI MANDAR,BALANIPA,LAMBANAN,64,35,7,6,1,0,0,1,3,3,3,3,2,1,1,1,25,14,11,4,22,6,16,3,17,14,3,3,OKTOBER
SULAWESI BARAT,POLEWALI MANDAR,BALANIPA,LEGO,96,13,4,0,0,0,0,2,0,0,4,0,15,14,1,3,10,5,5,5,5,2,3,1,13,1,12,2,OKTOBER
SULAWESI BARAT,POLEWALI MANDAR,BALANIPA,PALLIS,97,21,6,2,1,0,0,5,0,1,1,3,9,8,1,7,12,9,3,4,9,3,6,1,14,8,6,1,OKTOBER
SULAWESI BARAT,POLEWALI MANDAR,BINUANG,AMASSANGAN,48,47,26,5,3,2,0,6,20,0,4,21,8,1,7,0,27,18,9,7,11,9,2,8,29,8,21,17,OKTOBER
SULAWESI BARAT,POLEWALI MANDAR,BINUANG,TONYAMAN,31,79,59,36,34,10,10,22,7,14,29,20,0,0,0,0,39,15,24,5,2,2,0,1,47,25,22,36,OKTOBER
SULAWESI BARAT,POLEWALI MANDAR,BINUANG,KUAJANG,30,62,55,30,24,3,2,42,8,1,48,1,1,1,0,1,32,14,18,7,12,7,5,2,33,13,20,9,OKTOBER
SULAWESI BARAT,POLEWALI MANDAR,BINUANG,PAKU,87,18,9,2,0,0,0,8,0,0,3,1,7,1,6,0,14,9,5,1,13,1,12,0,23,18,5,1,OKTOBER
SULAWESI BARAT,POLEWALI MANDAR,BINUANG,MIRRING,59,59,24,15,11,4,3,8,1,2,11,8,0,0,0,0,45,9,36,3,1,1,0,0,4,4,0,1,OKTOBER
SULAWESI BARAT,POLEWALI MANDAR,BINUANG,BATETANGNGA,45,39,18,3,2,2,0,10,6,0,17,0,9,7,2,5,16,11,5,11,0,0,0,0,12,2,10,10,OKTOBER
SULAWESI BARAT,POLEWALI MANDAR,BINUANG,MAMMI,31,72,12,2,1,0,0,4,1,2,4,0,2,0,2,0,23,22,1,16,23,11,12,5,32,0,32,5,OKTOBER
SULAWESI BARAT,POLEWALI MANDAR,BINUANG,KALEOK,85,59,55,3,2,0,0,16,24,5,31,6,6,4,2,4,49,10,39,6,26,4,22,2,5,4,1,1,OKTOBER
SULAWESI BARAT,POLEWALI MANDAR,BINUANG,AMOLA,99,25,9,4,1,1,1,6,0,2,4,5,14,4,10,1,23,5,18,3,16,8,8,7,1,1,0,1,OKTOBER
SULAWESI BARAT,POLEWALI MANDAR,BINUANG,REA,33,12,3,0,0,0,0,1,1,1,3,0,0,0,0,0,12,7,5,1,2,0,2,0,5,1,4,1,OKTOBER
SULAWESI BARAT,POLEWALI MANDAR,BULO,BULO,75,74,37,9,0,0,0,23,8,0,6,29,5,1,4,1,56,50,6,25,10,5,5,1,28,11,17,9,OKTOBER
SULAWESI BARAT,POLEWALI MANDAR,BULO,PULLIWA,98,26,1,1,0,0,0,0,0,1,0,1,5,3,2,1,11,8,3,3,11,2,9,1,20,14,6,10,OKTOBER
SULAWESI BARAT,POLEWALI MANDAR,BULO,PATAMBANUA,54,31,3,0,0,0,0,0,1,1,1,2,9,9,0,9,24,10,14,4,19,17,2,0,8,2,6,6,OKTOBER
SULAWESI BARAT,POLEWALI MANDAR,BULO,KAROMBANG,41,69,12,2,2,2,0,11,0,1,10,0,8,0,8,0,21,17,4,14,13,4,9,2,42,13,29,2,OKTOBER
SULAWESI BARAT,POLEWALI MANDAR,BULO,DAALA TIMUR,50,48,8,7,2,1,1,5,0,1,3,0,0,0,0,0,24,22,2,15,1,0,1,0,18,11,7,13,OKTOBER
SULAWESI BARAT,POLEWALI MANDAR,BULO,LENGGO,61,13,11,0,0,0,0,11,0,0,3,0,3,0,3,0,13,8,5,7,12,10,2,2,1,0,1,1,OKTOBER
SULAWESI BARAT,POLEWALI MANDAR,BULO,SABURA,71,61,58,1,1,0,0,53,5,0,41,0,1,0,1,0,49,25,24,1,34,30,4,4,3,0,3,2,OKTOBER
SULAWESI BARAT,POLEWALI MANDAR,BULO,SEPPORRAKI,81,20,8,5,4,0,0,3,4,0,1,4,5,4,1,3,14,8,6,4,6,1,5,0,13,3,10,8,OKTOBER
SULAWESI BARAT,POLEWALI MANDAR,BULO,IHING,44,14,11,3,1,0,0,11,0,0,5,1,2,1,1,1,12,9,3,0,6,3,3,3,6,6,0,4,OKTOBER
SULAWESI BARAT,POLEWALI MANDAR,CAMPALAGIAN,PAPPANG,41,50,33,14,10,6,4,0,23,3,23,6,5,0,5,0,33,17,16,16,5,2,3,1,0,0,0,0,OKTOBER
SULAWESI BARAT,POLEWALI MANDAR,CAMPALAGIAN,LALIKO,89,17,6,1,1,1,0,6,0,0,1,1,17,1,16,0,16,10,6,6,10,6,4,2,5,2,3,0,OKTOBER
SULAWESI BARAT,POLEWALI MANDAR,CAMPALAGIAN,BONDE,73,69,9,6,5,1,1,3,4,1,9,0,0,0,0,0,23,20,3,1,7,5,2,4,48,41,7,43,OKTOBER
SULAWESI BARAT,POLEWALI MANDAR,CAMPALAGIAN,KATUMBANGAN LEMO,99,25,4,1,1,0,0,2,1,1,4,0,8,4,4,3,19,12,7,1,8,3,5,3,16,9,7,12,OKTOBER
SULAWESI BARAT,POLEWALI MANDAR,CAMPALAGIAN,PANYAMPA,88,39,29,18,6,0,0,23,1,2,3,0,3,1,2,0,18,5,13,4,1,1,0,1,5,4,1,2,OKTOBER
SULAWESI BARAT,POLEWALI MANDAR,CAMPALAGIAN,SURUANG,94,67,39,18,6,6,4,35,0,0,27,6,13,7,6,0,53,40,13,16,7,0,7,0,8,8,0,1,OKTOBER
SULAWESI BARAT,POLEWALI MANDAR,CAMPALAGIAN,LAMPOKO,73,28,9,5,4,3,0,4,1,1,4,0,10,3,7,2,28,27,1,27,26,4,22,4,36,10,26,19,OKTOBER
SULAWESI BARAT,POLEWALI MANDAR,CAMPALAGIAN,KATUMBANGAN,33,50,10,9,5,4,2,2,1,5,3,3,1,0,1,0,47,20,27,2,11,6,5,0,29,24,5,9,OKTOBER
SULAWESI BARAT,POLEWALI MANDAR,CAMPALAGIAN,LAPEO,92,71,47,1,0,0,0,37,3,1,34,3,17,9,8,3,61,13,48,1,17,7,10,3,47,47,0,39,OKTOBER
SULAWESI BARAT,POLEWALI MANDAR,CAMPALAGIAN,PARAPPE,37,38,23,4,3,3,3,12,6,2,3,20,6,2,4,0,21,17,4,14,21,18,3,5,6,2,4,1,OKTOBER
SULAWESI BARAT,POLEWALI MANDAR,CAMPALAGIAN,ONGKO,73,72,27,5,4,0,0,19,3,1,6,20,14,13,1,5,24,23,1,13,0,0,0,0,16,15,1,4,OKTOBER
SULAWESI BARAT,POLEWALI MANDAR,CAMPALAGIAN,KENJE,75,21,14,7,6,0,0,3,4,7,2,6,2,0,2,0,20,11,9,8,15,3,12,1,23,9,14,8,OKTOBER
SULAWESI BARAT,POLEWALI MANDAR,CAMPALAGIAN,SUMARRANG,39,43,35,32,22,0,0,30,2,3,25,1,1,0,1,0,36,36,0,7,21,3,18,2,1,0,1,1,OKTOBER
SULAWESI BARAT,POLEWALI MANDAR,CAMPALAGIAN,BOTTO,80,38,25,15,3,3,0,17,6,2,14,4,11,3,8,3,30,20,10,6,25,19,6,5,43,28,15,7,OKTOBER
SULAWESI BARAT,POLEWALI MANDAR,CAMPALAGIAN,GATTUNGAN,39,75,66,9,5,0,0,8,16,0,48,13,3,3,0,3,65,35,30,0,28,0,28,0,52,30,22,8,OKTOBER
SULAWESI BARAT,POLEWALI MANDAR,CAMPALAGIAN,PADANG TIMUR,95,59,42,6,4,1,1,10,24,6,14,22,7,0,7,0,28,15,13,10,9,0,9,0,49,12,37,16,OKTOBER
SULAWESI BARAT,POLEWALI MANDAR,CAMPALAGIAN,PADANG,57,12,9,7,7,5,0,4,3,2,6,0,0,0,0,0,11,8,3,3,9,1,8,1,4,2,2,4,OKTOBER
SULAWESI BARAT,POLEWALI MANDAR,CAMPALAGIAN,LAGI-AGI,93,32,28,20,12,9,6,6,7,4,21,2,12,10,2,6,28,23,5,8,10,9,1,8,26,7,19,14,OKTOBER
SULAWESI BARAT,POLEWALI MANDAR,LIMBORO,LIMBORO,72,59,3,0,0,0,0,0,1,1,1,2,4,1,3,1,40,11,29,7,13,10,3,4,2,2,0,2,OKTOBER
SULAWESI BARAT,POLEWALI MANDAR,LIMBORO,LEMBANG LEMBANG,75,22,1,1,0,0,0,0,0,1,1,0,5,0,5,0,16,6,10,1,10,4,6,0,6,4,2,0,OKTOBER
SULAWESI BARAT,POLEWALI MANDAR,LIMBORO,TANDASURA,30,34,16,12,1,0,0,2,1,12,9,3,6,3,3,3,23,20,3,13,4,2,2,1,17,16,1,0,OKTOBER
SULAWESI BARAT,POLEWALI MANDAR,LIMBORO,SAMASUNDU,58,38,2,1,0,0,0,2,0,0,2,0,7,1,6,1,29,14,15,1,29,18,11,13,39,23,16,34,OKTOBER
SULAWESI BARAT,POLEWALI MANDAR,LIMBORO,NAPO,81,36,28,10,10,1,1,11,11,2,17,0,0,0,0,0,19,15,4,5,12,12,0,0,28,2,26,24,OKTOBER
SULAWESI BARAT,POLEWALI MANDAR,LIMBORO,TODANG TODANG,37,36,29,8,0,0,0,9,12,7,17,7,1,0,1,0,33,30,3,29,29,10,19,5,32,29,3,9,OKTOBER
SULAWESI BARAT,POLEWALI MANDAR,LIMBORO,PENDULANGAN,60,48,5,4,4,3,0,4,0,0,5,0,6,6,0,1,14,6,8,3,0,0,0,0,29,12,17,12,OKTOBER
SULAWESI BARAT,POLEWALI MANDAR,LIMBORO,RENGGEANG,69,51,44,31,19,7,4,10,17,11,38,6,13,13,0,2,13,11,2,10,3,0,3,0,26,21,5,18,OKTOBER
SULAWESI BARAT,POLEWALI MANDAR,LIMBORO,SALARRI,44,23,4,1,0,0,0,2,0,2,4,0,3,2,1,1,17,5,12,3,8,8,0,4,20,8,12,19,OKTOBER
SULAWESI BARAT,POLEWALI MANDAR,LIMBORO,TANGAN BARU,45,24,8,1,1,1,1,4,0,2,2,3,0,0,0,0,21,17,4,3,14,7,7,3,28,15,13,15,OKTOBER
SULAWESI BARAT,POLEWALI MANDAR,LIMBORO,PALECE,68,41,15,13,1,1,0,0,1,2,2,5,4,0,4,0,33,23,10,0,1,0,1,0,18,10,8,0,OKTOBER
SULAWESI BARAT,POLEWALI MANDAR,LUYO,BATUPANGA,64,51,15,12,11,2,1,7,3,0,8,3,12,9,3,7,39,36,3,32,3,3,0,0,26,8,18,3,OKTOBER
SULAWESI BARAT,POLEWALI MANDAR,LUYO,MAMBU,32,24,16,13,3,3,2,2,2,8,16,0,4,4,0,4,23,12,11,9,5,1,4,1,11,3,8,5,OKTOBER
SULAWESI BARAT,POLEWALI MANDAR,LUYO,TENGGELANG,85,64,13,13,9,0,0,12,0,0,11,0,11,2,9,1,35,19,16,7,1,1,0,1,26,13,13,1,OKTOBER
SULAWESI BARAT,POLEWALI MANDAR,LUYO,BARU,63,78,10,7,1,1,0,4,3,3,4,1,6,0,6,0,62,33,29,18,47,43,4,20,42,3,39,25,OKTOBER
SULAWESI BARAT,POLEWALI MANDAR,LUYO,PUSSUI,57,59,3,1,0,0,0,0,1,1,3,0,4,1,3,1,28,15,13,4,3,2,1,0,16,2,14,16,OKTOBER
SULAWESI BARAT,POLEWALI MANDAR,LUYO,MAPILI BARAT,51,21,0,0,0,0,0,0,0,0,0,0,3,2,1,2,11,7,4,0,8,5,3,2,1,1,0,1,OKTOBER
SULAWESI BARAT,POLEWALI MANDAR,LUYO,SAMBALI WALI,42,51,28,10,9,4,4,10,4,0,20,7,3,2,1,1,28,23,5,9,16,1,15,1,30,19,11,20,OKTOBER
SULAWESI BARAT,POLEWALI MANDAR,LUYO,BATUPANGA DAALA,97,57,13,2,2,0,0,3,0,2,2,11,3,0,3,0,52,38,14,32,33,33,0,33,1,0,1,0,OKTOBER
SULAWESI BARAT,POLEWALI MANDAR,LUYO,LUYO,90,36,32,1,1,0,0,25,5,1,3,23,0,0,0,0,11,8,3,6,5,2,3,2,18,13,5,18,OKTOBER
SULAWESI BARAT,POLEWALI MANDAR,LUYO,PUSSUI BARAT,83,69,68,29,17,5,5,62,1,0,62,3,0,0,0,0,44,32,12,6,13,6,7,1,24,4,20,2,OKTOBER
SULAWESI BARAT,POLEWALI MANDAR,LUYO,PUCCADI,88,57,12,4,3,1,1,4,4,2,4,6,15,5,10,0,35,31,4,27,9,1,8,0,35,29,6,15,OKTOBER
SULAWESI BARAT,POLEWALI MANDAR,MAPILLI,MAPILI,41,45,45,38,12,7,5,2,17,1,45,0,0,0,0,0,25,15,10,10,10,1,9,1,25,19,6,23,OKTOBER
SULAWESI BARAT,POLEWALI MANDAR,MAPILLI,UGIBARU,41,77,74,13,10,0,0,52,16,0,71,1,4,1,3,0,26,18,8,11,25,7,18,2,20,5,15,19,OKTOBER
SULAWESI BARAT,POLEWALI MANDAR,MAPILLI,RUMPA,63,57,48,27,23,23,1,9,6,23,17,22,1,0,1,0,35,20,15,14,2,2,0,0,32,23,9,25,OKTOBER
SULAWESI BARAT,POLEWALI MANDAR,MAPILLI,KURMA,100,46,25,9,1,0,0,12,10,0,25,0,20,10,10,8,29,9,20,5,3,3,0,0,6,3,3,4,OKTOBER
SULAWESI BARAT,POLEWALI MANDAR,MAPILLI,BUKU,48,11,3,1,0,0,0,2,0,0,0,3,8,7,1,6,10,6,4,4,4,1,3,1,9,0,9,2,OKTOBER
SULAWESI BARAT,POLEWALI MANDAR,MAPILLI,BONNE BONNE,50,17,17,9,5,0,0,3,8,6,16,1,2,0,2,0,16,7,9,6,6,5,1,3,3,3,0,2,OKTOBER
SULAWESI BARAT,POLEWALI MANDAR,MAPILLI,BEROANGIN,44,47,21,17,11,3,2,7,0,8,0,1,3,1,2,1,26,14,12,0,15,0,15,0,37,0,37,4,OKTOBER
SULAWESI BARAT,POLEWALI MANDAR,MAPILLI,SEGERANG,54,62,7,5,2,1,1,3,1,2,6,0,3,3,0,0,43,37,6,4,34,29,5,6,0,0,0,0,OKTOBER
SULAWESI BARAT,POLEWALI MANDAR,MAPILLI,BONRA,97,49,26,17,12,0,0,20,1,5,7,15,2,1,1,1,29,26,3,8,11,11,0,8,35,33,2,10,OKTOBER
SULAWESI BARAT,POLEWALI MANDAR,MAPILLI,SATTOKO,94,72,24,12,12,11,5,10,6,1,11,7,17,4,13,3,17,10,7,8,3,0,3,0,5,3,2,5,OKTOBER
SULAWESI BARAT,POLEWALI MANDAR,MAPILLI,RAPPANG BARAT,78,60,2,1,1,0,0,1,0,1,0,1,9,2,7,2,41,25,16,7,8,1,7,0,35,7,28,29,OKTOBER
SULAWESI BARAT,POLEWALI MANDAR,MAPILLI,LANDI KANUSUANG,43,55,55,40,20,10,0,53,1,0,7,37,8,7,1,6,37,19,18,19,20,9,11,8,26,25,1,25,OKTOBER
SULAWESI BARAT,POLEWALI MANDAR,MATAKALI,MATAKALI,63,57,22,18,6,5,2,14,4,2,10,10,7,0,7,0,55,41,14,28,30,21,9,4,63,25,38,50,OKTOBER
SULAWESI BARAT,POLEWALI MANDAR,MATAKALI,PETAMPANUA,33,38,6,0,0,0,0,3,2,1,1,1,6,5,1,3,20,9,11,3,12,7,5,3,8,7,1,0,OKTOBER
SULAWESI BARAT,POLEWALI MANDAR,MATAKALI,BARUMBUNG,94,80,80,11,8,5,3,53,21,1,2,42,1,1,0,1,43,38,5,1,5,3,2,3,34,13,21,10,OKTOBER
SULAWESI BARAT,POLEWALI MANDAR,MATAKALI,PASIANG,54,36,1,0,0,0,0,1,0,0,1,0,2,0,2,0,22,11,11,2,6,5,1,0,14,2,12,12,OKTOBER
SULAWESI BARAT,POLEWALI MANDAR,MATAKALI,TONROLIMA,66,46,6,1,0,0,0,0,4,2,4,0,0,0,0,0,14,13,1,3,7,2,5,0,22,21,1,22,OKTOBER
SULAWESI BARAT,POLEWALI MANDAR,MATAKALI,INDOMAKKOMBONG,48,67,60,1,0,0,0,4,49,3,42,16,1,1,0,0,51,24,27,4,29,1,28,1,38,13,25,8,OKTOBER
SULAWESI BARAT,POLEWALI MANDAR,MATAKALI,BUNGA-BUNGA,31,49,16,6,5,2,0,14,0,1,5,6,2,0,2,0,39,21,18,6,5,4,1,2,33,17,16,9,OKTOBER
SULAWESI BARAT,POLEWALI MANDAR,MATANGNGA,MATANGNGA,43,63,27,12,1,0,0,11,11,2,7,3,0,0,0,0,36,29,7,2,33,23,10,10,76,68,8,46,OKTOBER
SULAWESI BARAT,POLEWALI MANDAR,MATANGNGA,LILLI,73,72,33,5,5,2,1,4,16,4,33,0,9,8,1,2,19,17,2,1,13,6,7,5,9,2,7,4,OKTOBER
SULAWESI BARAT,POLEWALI MANDAR,MATANGNGA,RANGOAN,63,54,0,0,0,0,0,0,0,0,0,0,10,10,0,1,30,19,11,12,9,1,8,1,7,2,5,1,OKTOBER
SULAWESI BARAT,POLEWALI MANDAR,MATANGNGA,TAPUA,58,55,31,21,18,16,12,3,15,1,25,0,6,3,3,3,13,5,8,3,2,2,0,2,8,5,3,0,OKTOBER
SULAWESI BARAT,POLEWALI MANDAR,MATANGNGA,MAMBU TAPUA,53,63,13,7,2,0,0,13,0,0,12,1,9,6,3,6,25,7,18,7,12,12,0,0,50,12,38,5,OKTOBER
SULAWESI BARAT,POLEWALI MANDAR,MATANGNGA,BA'BA TAPUA,88,36,17,15,13,5,5,11,0,1,13,0,9,6,3,0,11,6,5,4,2,1,1,0,7,1,6,5,OKTOBER
SULAWESI BARAT,POLEWALI MANDAR,MATANGNGA,KATIMBANG,100,58,36,32,19,19,14,7,6,8,32,1,5,0,5,0,48,15,33,14,43,36,7,11,76,8,68,55,OKTOBER
SULAWESI BARAT,POLEWALI MANDAR,POLEWALI,POLEWALI,64,53,13,9,8,7,5,3,5,0,7,2,0,0,0,0,21,11,10,11,17,5,12,1,38,14,24,33,OKTOBER
SULAWESI BARAT,POLEWALI MANDAR,POLEWALI,WATTANG,88,24,20,9,4,0,0,14,5,0,5,14,8,4,4,2,22,8,14,6,8,3,5,2,23,8,15,23,OKTOBER
SULAWESI BARAT,POLEWALI MANDAR,POLEWALI,SULEWATANG,96,46,9,5,2,1,0,6,0,2,0,7,4,4,0,3,15,5,10,0,0,0,0,0,19,19,0,19,OKTOBER
SULAWESI BARAT,POLEWALI MANDAR,POLEWALI,LANTORA,73,46,27,6,4,3,0,6,17,4,11,2,7,1,6,1,17,15,2,6,13,8,5,3,3,3,0,1,OKTOBER
SULAWESI BARAT,POLEWALI MANDAR,POLEWALI,TAKATIDUNG,59,20,15,2,0,0,0,14,1,0,9,3,10,2,8,2,17,12,5,8,2,1,1,1,2,2,0,0,OKTOBER
SULAWESI BARAT,POLEWALI MANDAR,POLEWALI,PEKKABATA,32,12,11,6,4,0,0,2,1,4,4,4,3,3,0,1,10,6,4,1,1,0,1,0,4,3,1,4,OKTOBER
SULAWESI BARAT,POLEWALI MANDAR,POLEWALI,MADATE,95,76,37,13,0,0,0,17,12,2,34,3,18,18,0,3,62,61,1,57,6,2,4,0,26,19,7,3,OKTOBER
SULAWESI BARAT,POLEWALI MANDAR,POLEWALI,MANDING,66,43,28,16,13,7,1,20,2,1,12,1,12,10,2,5,20,7,13,6,1,0,1,0,15,5,10,8,OKTOBER
SULAWESI BARAT,POLEWALI MANDAR,POLEWALI,DARMA,59,77,70,21,7,3,0,43,15,7,40,27,3,1,2,1,19,18,1,13,10,2,8,0,56,2,54,10,OKTOBER
SULAWESI BARAT,POLEWALI MANDAR,TAPANGO,PELITAKAN,68,30,3,1,1,0,0,0,1,0,3,0,7,4,3,1,21,20,1,19,8,6,2,5,0,0,0,0,OKTOBER
SULAWESI BARAT,POLEWALI MANDAR,TAPANGO,TAPANGO,41,74,45,13,12,2,1,43,1,0,34,3,2,2,0,2,48,40,8,36,42,36,6,2,24,3,21,8,OKTOBER
SULAWESI BARAT,POLEWALI MANDAR,TAPANGO,RAPPANG,72,47,24,11,11,10,0,18,4,0,0,16,11,5,6,5,10,5,5,0,1,1,0,1,8,6,2,4,OKTOBER
SULAWESI BARAT,POLEWALI MANDAR,TAPANGO,DAKKA,38,67,13,12,5,1,0,11,2,0,2,2,2,0,2,0,58,43,15,38,47,28,19,4,88,60,28,72,OKTOBER
SULAWESI BARAT,POLEWALI MANDAR,TAPANGO,BATU,43,19,1,0,0,0,0,0,1,0,1,0,8,1,7,0,11,10,1,0,7,0,7,0,11,4,7,0,OKTOBER
SULAWESI BARAT,POLEWALI MANDAR,TAPANGO,RISO,68,48,0,0,0,0,0,0,0,0,0,0,5,4,1,0,32,13,19,10,13,4,9,0,46,37,9,0,OKTOBER
SULAWESI BARAT,POLEWALI MANDAR,TAPANGO,PALATTA,64,40,29,21,14,14,8,10,3,1,4,6,6,0,6,0,24,8,16,0,12,5,7,0,7,3,4,7,OKTOBER
SULAWESI BARAT,POLEWALI MANDAR,TAPANGO,TAPANGO BARAT,89,70,12,8,2,1,1,11,0,0,3,9,0,0,0,0,29,20,9,4,7,1,6,0,14,0,14,12,OKTOBER
SULAWESI BARAT,POLEWALI MANDAR,TAPANGO,KURRAK,81,70,57,24,13,0,0,51,2,1,20,14,13,4,9,4,23,10,13,2,9,3,6,2,42,39,3,34,OKTOBER
SULAWESI BARAT,POLEWALI MANDAR,TAPANGO,BUSSU,52,29,24,13,3,1,1,20,2,1,9,14,3,3,0,0,18,12,6,5,6,6,0,2,8,6,2,4,OKTOBER
SULAWESI BARAT,POLEWALI MANDAR,TAPANGO,TUTTULA,53,36,32,19,9,6,2,7,14,6,27,2,10,10,0,1,11,7,4,3,3,0,3,0,18,4,14,10,OKTOBER
SULAWESI BARAT,POLEWALI MANDAR,TAPANGO,JAMBU MALEA,77,64,42,13,4,0,0,7,33,1,2,19,13,3,10,0,49,20,29,4,32,26,6,2,51,42,9,43,OKTOBER
SULAWESI BARAT,POLEWALI MANDAR,TAPANGO,KALIMBUA,46,29,14,9,8,4,1,10,3,0,0,8,1,0,1,0,20,19,1,13,0,0,0,0,13,10,3,13,OKTOBER
SULAWESI BARAT,POLEWALI MANDAR,TAPANGO,BANATO REJO,58,60,38,38,14,12,7,19,4,7,22,5,3,1,2,0,56,44,12,13,29,4,25,1,21,20,1,17,OKTOBER
SULAWESI BARAT,POLEWALI MANDAR,TINAMBUNG,TINAMBUNG,87,56,19,8,4,0,0,12,2,5,19,0,3,0,3,0,18,17,1,1,5,4,1,0,27,25,2,9,OKTOBER
SULAWESI BARAT,POLEWALI MANDAR,TINAMBUNG,KARAMA,100,65,58,41,9,9,1,16,6,25,35,7,2,1,1,0,26,16,10,14,0,0,0,0,17,10,7,6,OKTOBER
SULAWESI BARAT,POLEWALI MANDAR,TINAMBUNG,TANGNGA TANGNGA,84,75,1,1,0,0,0,1,0,0,1,0,11,9,2,3,42,42,0,7,5,4,1,0,7,7,0,6,OKTOBER
SULAWESI BARAT,POLEWALI MANDAR,TINAMBUNG,LEKOPADIS,98,27,0,0,0,0,0,0,0,0,0,0,3,2,1,1,15,13,2,11,7,7,0,3,12,11,1,2,OKTOBER
SULAWESI BARAT,POLEWALI MANDAR,TINAMBUNG,GALUNG LOMBOK,60,80,76,26,0,0,0,6,13,21,54,10,12,8,4,6,24,9,15,5,13,9,4,4,33,23,10,19,OKTOBER
SULAWESI BARAT,POLEWALI MANDAR,TINAMBUNG,TANDUNG,87,39,29,0,0,0,0,1,22,0,3,19,8,2,6,0,15,15,0,13,15,9,6,7,23,20,3,9,OKTOBER
SULAWESI BARAT,POLEWALI MANDAR,TINAMBUNG,BATULAYA,65,36,6,5,3,1,0,6,0,0,5,1,13,7,6,6,28,21,7,6,17,11,6,9,41,6,35,12,OKTOBER
SULAWESI BARAT,POLEWALI MANDAR,TINAMBUNG,SEPABATU,76,17,15,13,3,1,1,0,3,5,14,0,7,1,6,1,14,10,4,5,8,1,7,1,13,8,5,1,OKTOBER
SULAWESI BARAT,POLEWALI MANDAR,TUTAR,TARAMANU,71,14,0,0,0,0,0,0,0,0,0,0,6,0,6,0,10,9,1,5,2,1,1,0,7,0,7,2,OKTOBER
SULAWESI BARAT,POLEWALI MANDAR,TUTAR,AMBOPADANG,83,75,63,22,9,0,0,36,1,5,54,9,7,2,5,2,58,9,49,6,29,7,22,1,16,1,15,14,OKTOBER
SULAWESI BARAT,POLEWALI MANDAR,TUTAR,TUBBI,80,78,11,7,3,1,1,0,8,2,11,0,13,7,6,7,51,6,45,2,0,0,0,0,48,29,19,33,OKTOBER
SULAWESI BARAT,POLEWALI MANDAR,TUTAR,RATTE,61,59,44,2,1,0,0,14,29,0,31,1,9,6,3,5,13,12,1,0,5,5,0,4,29,16,13,15,OKTOBER
SULAWESI BARAT,POLEWALI MANDAR,TUTAR,BESOANGIN,81,67,58,41,22,10,6,21,17,8,23,2,13,4,9,2,54,53,1,24,37,8,29,7,50,11,39,20,OKTOBER
SULAWESI BARAT,POLEWALI MANDAR,TUTAR,PIRIANG TAPIKO,96,20,13,9,5,3,2,7,3,0,9,0,16,9,7,3,17,9,8,6,7,4,3,2,14,5,9,2,OKTOBER
SULAWESI BARAT,POLEWALI MANDAR,TUTAR,PEBURRU,100,11,2,0,0,0,0,1,1,0,1,1,7,3,4,1,11,9,2,5,8,7,1,4,3,3,0,0,OKTOBER
SULAWESI BARAT,POLEWALI MANDAR,TUTAR,TALOBA,92,59,45,9,6,4,1,13,0,17,42,2,4,1,3,0,15,12,3,10,9,7,2,6,17,2,15,7,OKTOBER
SULAWESI BARAT,POLEWALI MANDAR,TUTAR,POLLEWANI,30,17,17,5,4,1,1,13,1,2,2,12,0,0,0,0,16,12,4,9,12,9,3,6,19,5,14,0,OKTOBER
SULAWESI BARAT,POLEWALI MANDAR,TUTAR,ARABUA,78,13,7,5,2,0,0,2,1,2,3,3,9,4,5,0,10,8,2,8,6,5,1,5,1,0,1,1,OKTOBER
SULAWESI BARAT,POLEWALI MANDAR,TUTAR,BESOANGIN UTARA,87,21,0,0,0,0,0,0,0,0,0,0,16,6,10,0,11,9,2,4,5,2,3,2,2,1,1,2,OKTOBER
SULAWESI BARAT,POLEWALI MANDAR,TUTAR,PODA,70,39,20,4,4,4,1,10,6,0,9,9,1,0,1,0,14,7,7,1,4,2,2,1,10,3,7,10,OKTOBER
SULAWESI BARAT,POLEWALI MANDAR,TUTAR,TARAMANU TUA,78,73,51,22,2,0,0,24,27,0,15,9,14,3,11,3,14,10,4,9,11,6,5,4,8,6,2,5,OKTOBER
SULAWESI BARAT,POLEWALI MANDAR,WONOMULYO,SIDODADI,88,43,0,0,0,0,0,0,0,0,0,0,10,3,7,0,26,16,10,6,4,1,3,1,33,12,21,25,OKTOBER
SULAWESI BARAT,POLEWALI MANDAR,WONOMULYO,SIDOREJO,91,30,8,2,1,0,0,6,1,0,1,7,10,3,7,3,20,15,5,13,5,3,2,1,17,1,16,2,OKTOBER
SULAWESI BARAT,POLEWALI MANDAR,WONOMULYO,SUMBEREJO,70,10,7,7,2,0,0,7,0,0,1,5,7,3,4,2,10,7,3,3,9,6,3,1,9,6,3,0,OKTOBER
SULAWESI BARAT,POLEWALI MANDAR,WONOMULYO,BUMIAYU,30,66,63,56,52,5,4,6,28,24,58,4,4,2,2,2,11,5,6,1,4,3,1,2,15,13,2,1,OKTOBER
SULAWESI BARAT,POLEWALI MANDAR,WONOMULYO,KEBUNSARI,32,23,4,2,1,1,1,3,0,0,4,0,0,0,0,0,15,12,3,8,11,3,8,3,16,11,5,12,OKTOBER
SULAWESI BARAT,POLEWALI MANDAR,WONOMULYO,BANUA BARU,43,61,33,11,7,1,0,16,7,2,28,3,4,0,4,0,43,30,13,13,16,13,3,13,17,10,7,16,OKTOBER
SULAWESI BARAT,POLEWALI MANDAR,WONOMULYO,NEPO,40,20,16,1,1,0,0,15,1,0,9,4,4,0,4,0,18,5,13,2,5,4,1,0,9,8,1,6,OKTOBER
SULAWESI BARAT,POLEWALI MANDAR,WONOMULYO,SUGIHWARAS,64,54,21,12,3,0,0,0,12,7,17,1,4,4,0,2,32,14,18,1,24,6,18,0,31,1,30,31,OKTOBER
SULAWESI BARAT,POLEWALI MANDAR,WONOMULYO,CAMPURJO,46,24,0,0,0,0,0,0,0,0,0,0,0,0,0,0,17,5,12,4,16,7,9,0,16,11,5,3,OKTOBER
SULAWESI BARAT,POLEWALI MANDAR,WONOMULYO,BUMIMULYO,66,18,6,2,2,1,1,0,3,0,5,1,11,9,2,2,10,9,1,7,4,1,3,0,9,7,2,8,OKTOBER
SULAWESI BARAT,POLEWALI MANDAR,WONOMULYO,TUMPILING,31,72,23,12,1,1,1,6,10,2,1,7,6,5,1,5,46,40,6,12,35,26,9,7,6,3,3,1,OKTOBER
SULAWESI BARAT,POLEWALI MANDAR,WONOMULYO,BAKKA-BAKKA,48,64,16,1,1,1,0,2,14,0,16,0,3,0,3,0,58,19,39,8,4,3,1,1,20,13,7,13,OKTOBER
SULAWESI BARAT,POLEWALI MANDAR,WONOMULYO,ARJO SARI,79,66,58,5,0,0,0,4,0,18,29,15,9,2,7,2,31,14,17,5,23,15,8,7,69,38,31,20,OKTOBER
SULAWESI BARAT,POLEWALI MANDAR,WONOMULYO,GALESON,53,36,7,1,1,0,0,5,1,1,3,2,3,3,0,1,13,9,4,6,7,1,6,1,3,0,3,1,OKTOBER
SULAWESI BARAT,MAMUJU,MAMUJU,BINANGA,90,69,49,32,16,8,1,27,13,4,43,1,5,3,2,1,54,53,1,2,13,7,6,7,48,3,45,43,OKTOBER
SULAWESI BARAT,MAMUJU,MAMUJU,MAMUNYU,83,72,33,26,18,15,10,0,5,9,2,6,6,6,0,4,15,14,1,1,6,2,4,0,24,20,4,10,OKTOBER
SULAWESI BARAT,MAMUJU,MAMUJU,KAREMA,82,25,16,7,6,3,2,10,4,0,8,7,13,4,9,4,20,14,6,3,8,6,2,1,9,1,8,0,OKTOBER
SULAWESI BARAT,MAMUJU,MAMUJU,RIMUKU,62,57,2,2,1,0,0,2,0,0,1,0,0,0,0,0,51,40,11,7,38,21,17,0,33,13,20,9,OKTOBER
SULAWESI BARAT,MAMUJU,MAMUJU,BAMBU,32,18,14,7,0,0,0,4,5,4,8,6,1,0,1,0,10,7,3,3,2,1,1,0,6,1,5,2,OKTOBER
SULAWESI BARAT,MAMUJU,MAMUJU,KARAMPUANG,95,48,30,5,0,0,0,4,22,1,5,24,7,3,4,0,45,22,23,8,40,35,5,4,8,0,8,7,OKTOBER
SULAWESI BARAT,MAMUJU,MAMUJU,TADUI,47,79,45,42,0,0,0,15,30,0,9,19,0,0,0,0,71,50,21,6,11,0,11,0,59,8,51,44,OKTOBER
SULAWESI BARAT,MAMUJU,MAMUJU,BATU PANNU,49,21,0,0,0,0,0,0,0,0,0,0,6,0,6,0,12,12,0,3,9,6,3,0,17,3,14,5,OKTOBER
SULAWESI BARAT,MAMUJU,TAPALANG,GALUNG,73,39,10,1,1,0,0,2,2,2,0,3,5,1,4,1,14,8,6,4,5,1,4,0,29,8,21,19,OKTOBER
SULAWESI BARAT,MAMUJU,TAPALANG,KASAMBANG,38,62,42,22,9,0,0,23,17,2,35,3,0,0,0,0,45,31,14,26,9,0,9,0,40,16,24,12,OKTOBER
SULAWESI BARAT,MAMUJU,TAPALANG,DAYANGINNA,81,66,60,31,25,2,1,19,38,2,59,0,0,0,0,0,33,15,18,11,26,17,9,11,25,7,18,24,OKTOBER
SULAWESI BARAT,MAMUJU,TAPALANG,OROBATU,80,66,26,22,15,10,9,1,15,0,26,0,1,0,1,0,24,24,0,10,23,19,4,19,36,32,4,11,OKTOBER
SULAWESI BARAT,MAMUJU,TAPALANG,TAKANDEANG,96,74,1,1,1,1,1,0,0,0,1,0,11,6,5,3,15,12,3,4,4,0,4,0,7,3,4,7,OKTOBER
SULAWESI BARAT,MAMUJU,TAPALANG,BELA,38,20,0,0,0,0,0,0,0,0,0,0,3,3,0,2,18,6,12,1,14,9,5,0,13,7,6,9,OKTOBER
SULAWESI BARAT,MAMUJU,TAPALANG,TAAN,51,20,2,0,0,0,0,2,0,0,2,0,5,1,4,0,18,5,13,3,4,3,1,0,11,9,2,9,OKTOBER
SULAWESI BARAT,MAMUJU,TAPALANG,TAMPALANG,87,44,21,5,4,0,0,13,4,3,14,1,3,2,1,0,15,10,5,10,3,0,3,0,30,29,1,26,OKTOBER
SULAWESI BARAT,MAMUJU,TAPALANG,RANTEDODA,63,33,8,8,0,0,0,7,0,0,0,5,3,3,0,0,16,14,2,8,12,7,5,5,21,7,14,0,OKTOBER
SULAWESI BARAT,MAMUJU,TAPALANG,KOPEANG,100,35,30,8,7,4,3,12,5,9,14,15,6,6,0,3,14,5,9,2,8,1,7,1,25,12,13,16,OKTOBER
SULAWESI BARAT,MAMUJU,KALUKKU,SINYONYOI,61,64,9,5,2,1,1,8,0,0,2,4,3,2,1,1,47,33,14,25,38,19,19,8,78,57,21,15,OKTOBER
SULAWESI BARAT,MAMUJU,KALUKKU,BEBANGA,42,14,1,0,0,0,0,0,0,0,0,1,8,2,6,0,12,9,3,0,10,8,2,8,19,18,1,0,OKTOBER
SULAWESI BARAT,MAMUJU,KALUKKU,KALUKKU,79,74,3,0,0,0,0,1,0,2,2,1,2,2,0,2,34,12,22,7,20,2,18,1,55,28,27,41,OKTOBER
SULAWESI BARAT,MAMUJU,KALUKKU,SINYONYOI SELATAN,31,68,48,16,13,1,1,30,0,10,9,24,4,3,1,3,64,54,10,15,25,13,12,6,23,23,0,13,OKTOBER
SULAWESI BARAT,MAMUJU,KALUKKU,SONDOANG,32,27,7,5,1,0,0,6,1,0,6,0,5,5,0,0,23,19,4,4,4,2,2,2,13,7,6,12,OKTOBER
SULAWESI BARAT,MAMUJU,KALUKKU,BERU-BERU,81,80,80,2,0,0,0,67,1,1,66,5,8,5,3,1,29,26,3,0,13,2,11,2,10,6,4,10,OKTOBER
SULAWESI BARAT,MAMUJU,KALUKKU,BELANG BELANG,66,54,47,13,0,0,0,39,6,1,3,40,6,1,5,0,52,38,14,34,51,46,5,5,87,39,48,68,OKTOBER
SULAWESI BARAT,MAMUJU,KALUKKU,KABULOANG,63,43,35,18,6,6,2,19,12,2,22,4,5,3,2,0,26,25,1,15,10,3,7,0,37,29,8,12,OKTOBER
SULAWESI BARAT,MAMUJU,KALUKKU,KEANG,47,13,11,10,5,5,0,9,0,1,3,5,3,2,1,0,10,6,4,5,8,1,7,1,16,0,16,12,OKTOBER
SULAWESI BARAT,MAMUJU,KALUKKU,POKKANG,54,34,15,4,1,1,0,15,0,0,4,0,7,5,2,1,15,15,0,14,1,1,0,1,6,0,6,5,OKTOBER
SULAWESI BARAT,MAMUJU,KALUKKU,GULILING,47,44,29,0,0,0,0,20,0,9,7,10,7,0,7,0,39,9,30,3,21,21,0,9,12,5,7,11,OKTOBER
SULAWESI BARAT,MAMUJU,KALUKKU,UHAIMATE,39,35,27,8,1,1,0,23,1,0,20,7,0,0,0,0,11,7,4,5,1,1,0,0,8,5,3,1,OKTOBER
SULAWESI BARAT,MAMUJU,KALUKKU,KALUKKU BARAT,57,19,6,1,1,1,1,3,1,0,4,0,5,0,5,0,15,13,2,11,8,5,3,3,8,4,4,1,OKTOBER
SULAWESI BARAT,MAMUJU,KALUKKU,PAMMULUKANG,38,48,21,16,2,2,0,15,4,0,19,0,3,2,1,2,27,16,11,3,19,5,14,5,51,11,40,25,OKTOBER
SULAWESI BARAT,MAMUJU,KALUMPANG,KALUMPANG,55,26,12,3,3,0,0,0,6,1,1,5,10,0,10,0,10,7,3,0,9,9,0,8,21,12,9,0,OKTOBER
SULAWESI BARAT,MAMUJU,KALUMPANG,KARATAUN,31,55,36,13,8,6,0,30,6,0,5,30,4,2,2,2,44,40,4,13,42,30,12,8,36,20,16,26,OKTOBER
SULAWESI BARAT,MAMUJU,KALUMPANG,KARAMA,81,72,26,15,4,0,0,0,13,9,6,9,11,7,4,7,56,39,17,11,15,14,1,8,34,9,25,14,OKTOBER
SULAWESI BARAT,MAMUJU,KALUMPANG,SIRAUN,58,24,2,2,1,1,0,2,0,0,1,0,2,2,0,1,19,14,5,2,5,0,5,0,15,8,7,7,OKTOBER
SULAWESI BARAT,MAMUJU,KALUMPANG,TUMOGA,51,29,9,0,0,0,0,4,3,2,8,0,9,0,9,0,17,10,7,7,10,2,8,1,7,2,5,1,OKTOBER
SULAWESI BARAT,MAMUJU,KALUMPANG,SALUMAKKI,42,45,10,6,3,2,0,5,0,2,0,1,2,1,1,0,36,26,10,3,2,2,0,2,10,7,3,9,OKTOBER
SULAWESI BARAT,MAMUJU,KALUMPANG,POLIO,63,19,4,3,3,1,1,0,2,1,3,1,8,4,4,4,13,11,2,11,11,9,2,6,11,10,1,1,OKTOBER
SULAWESI BARAT,MAMUJU,KALUMPANG,LIMBONG,62,53,33,27,11,0,0,13,5,14,2,24,0,0,0,0,17,6,11,0,13,12,1,3,49,31,18,39,OKTOBER
SULAWESI BARAT,MAMUJU,KALUMPANG,SANDAPANG,56,80,63,3,1,0,0,40,15,2,37,11,5,5,0,1,64,30,34,26,34,17,17,6,32,21,11,19,OKTOBER
SULAWESI BARAT,MAMUJU,KALUMPANG,KONDO BULO,66,28,9,8,5,1,0,0,1,3,0,0,1,1,0,1,13,7,6,0,8,3,5,3,11,10,1,0,OKTOBER
SULAWESI BARAT,MAMUJU,KALUMPANG,MAKKALIKI,52,33,13,6,3,1,1,3,8,0,1,8,10,0,10,0,28,20,8,11,5,2,3,0,27,12,15,21,OKTOBER
SULAWESI BARAT,MAMUJU,KALUMPANG,BATU MAKKADA,47,62,43,37,24,16,6,19,1,5,26,11,5,2,3,0,33,18,15,16,13,4,9,1,21,18,3,17,OKTOBER
SULAWESI BARAT,MAMUJU,KALUMPANG,LASA',36,27,5,2,1,0,0,4,1,0,2,2,4,1,3,0,18,7,11,5,10,6,4,4,28,24,4,2,OKTOBER
SULAWESI BARAT,MAMUJU,PAPALANG,TOABO,57,24,14,13,13,5,4,1,8,1,1,3,3,3,0,3,10,7,3,2,7,2,5,1,2,0,2,1,OKTOBER
SULAWESI BARAT,MAMUJU,PAPALANG,PAPALANG,43,51,24,16,0,0,0,4,9,11,17,5,5,5,0,3,50,8,42,4,29,3,26,1,35,3,32,24,OKTOBER
SULAWESI BARAT,MAMUJU,PAPALANG,BONDA,72,63,16,7,6,3,1,9,4,0,5,10,8,8,0,1,27,10,17,5,21,2,19,1,42,28,14,36,OKTOBER
SULAWESI BARAT,MAMUJU,PAPALANG,TOPORE,73,34,30,4,1,1,1,17,2,5,14,16,13,11,2,11,33,15,18,0,7,4,3,3,3,1,2,0,OKTOBER
SULAWESI BARAT,MAMUJU,PAPALANG,SALUKAYU,77,73,15,11,8,8,8,6,0,0,5,4,8,5,3,3,49,5,44,1,25,0,25,0,27,1,26,18,OKTOBER
SULAWESI BARAT,MAMUJU,PAPALANG,SUKADAMAI,61,50,29,12,10,7,5,18,3,2,11,3,1,0,1,0,50,48,2,22,50,49,1,39,1,1,0,0,OKTOBER
SULAWESI BARAT,MAMUJU,PAPALANG,BODA-BODA,55,34,7,2,1,1,0,3,2,1,7,0,6,3,3,2,12,10,2,4,2,2,0,1,2,0,2,2,OKTOBER
SULAWESI BARAT,MAMUJU,PAPALANG,SISANGO,36,75,58,54,17,7,3,11,41,2,22,7,4,0,4,0,63,11,52,10,39,27,12,14,27,14,13,12,OKTOBER
SULAWESI BARAT,MAMUJU,PAPALANG,BATU AMPA,63,76,34,28,13,0,0,11,23,0,16,0,6,0,6,0,62,39,23,1,25,21,4,5,55,20,35,26,OKTOBER
SULAWESI BARAT,MAMUJU,SAMPAGA,BUNDE,90,75,71,57,55,46,29,4,12,8,61,5,4,1,3,0,59,30,29,18,3,0,3,0,17,7,10,0,OKTOBER
SULAWESI BARAT,MAMUJU,SAMPAGA,KALONDING,36,71,54,5,4,3,1,19,27,2,27,19,6,2,4,2,46,20,26,10,44,27,17,13,47,19,28,12,OKTOBER
SULAWESI BARAT,MAMUJU,SAMPAGA,TARAILU,89,63,13,4,3,3,0,4,7,2,6,7,13,6,7,6,52,26,26,26,49,2,47,1,41,4,37,17,OKTOBER
SULAWESI BARAT,MAMUJU,SAMPAGA,SAMPAGA,98,42,15,14,7,7,6,1,1,5,9,4,1,1,0,1,18,14,4,10,1,1,0,0,20,4,16,11,OKTOBER
SULAWESI BARAT,MAMUJU,SAMPAGA,TANAMBUAH,56,20,11,1,0,0,0,8,3,0,10,1,1,0,1,0,11,8,3,3,10,8,2,7,2,1,1,1,OKTOBER
SULAWESI BARAT,MAMUJU,SAMPAGA,SALUBARANA,48,51,34,19,15,15,5,21,6,2,7,3,7,2,5,0,18,15,3,6,10,10,0,8,8,4,4,4,OKTOBER
SULAWESI BARAT,MAMUJU,SAMPAGA,LOSSO,63,32,22,18,7,3,0,5,5,12,6,3,2,1,1,0,12,8,4,0,4,1,3,1,16,8,8,4,OKTOBER
SULAWESI BARAT,MAMUJU,TOMMO,TOMMO,57,13,5,1,0,0,0,5,0,0,5,0,7,1,6,0,11,10,1,3,6,2,4,0,5,2,3,4,OKTOBER
SULAWESI BARAT,MAMUJU,TOMMO,CAMPALOGA,81,64,56,33,4,2,2,25,6,18,8,14,0,0,0,0,18,18,0,2,13,9,4,8,3,3,0,2,OKTOBER
SULAWESI BARAT,MAMUJU,TOMMO,BUANA SAKTI,68,51,49,16,9,5,2,42,1,4,39,2,7,1,6,0,25,15,10,1,14,11,3,6,19,16,3,6,OKTOBER
SULAWESI BARAT,MAMUJU,TOMMO,TAMEMONGGA,71,42,8,5,2,2,2,3,2,1,2,6,8,5,3,2,30,24,6,24,27,18,9,13,46,21,25,45,OKTOBER
SULAWESI BARAT,MAMUJU,TOMMO,TAMEJARRA,88,36,29,25,8,0,0,8,17,2,16,1,10,3,7,1,22,14,8,12,0,0,0,0,18,14,4,12,OKTOBER
SULAWESI BARAT,MAMUJU,TOMMO,RANTEMARIO,52,17,13,10,7,5,2,1,2,0,10,3,0,0,0,0,11,8,3,7,2,1,1,0,0,0,0,0,OKTOBER
SULAWESI BARAT,MAMUJU,TOMMO,MALINO,44,35,30,6,1,0,0,17,2,2,8,9,4,1,3,0,27,9,18,1,20,6,14,0,12,3,9,4,OKTOBER
SULAWESI BARAT,MAMUJU,TOMMO,KAKULLASANG,88,72,66,27,22,14,13,10,34,8,36,1,16,16,0,2,16,15,1,6,6,3,3,3,4,2,2,4,OKTOBER
SULAWESI BARAT,MAMUJU,TOMMO,LELING,77,16,16,5,2,1,0,2,0,10,13,1,14,14,0,8,11,6,5,0,11,8,3,6,15,10,5,9,OKTOBER
SULAWESI BARAT,MAMUJU,TOMMO,KALEPU,56,74,10,4,3,0,0,2,3,4,3,0,10,1,9,0,16,7,9,0,9,3,6,2,3,0,3,1,OKTOBER
SULAWESI BARAT,MAMUJU,TOMMO,SANDANA,88,78,17,6,4,4,3,7,4,0,3,13,16,9,7,4,45,35,10,31,6,1,5,1,14,9,5,14,OKTOBER
SULAWESI BARAT,MAMUJU,TOMMO,LELING BARAT,97,70,36,8,6,1,1,24,10,0,17,9,9,3,6,0,44,6,38,5,4,0,4,0,47,36,11,23,OKTOBER
SULAWESI BARAT,MAMUJU,TOMMO,LELING UTARA,41,53,20,15,5,5,4,2,3,5,18,2,6,5,1,1,38,26,12,15,4,3,1,3,20,18,2,11,OKTOBER
SULAWESI BARAT,MAMUJU,TOMMO,SALUDENGEN,64,63,39,17,3,1,1,2,1,3,30,6,5,4,1,2,42,17,25,15,24,11,13,9,54,29,25,54,OKTOBER
SULAWESI BARAT,MAMUJU,SIMBORO DAN KEPULAUAN,SIMBORO,42,69,56,33,24,20,19,24,1,4,27,5,2,0,2,0,45,8,37,0,8,5,3,3,19,1,18,16,OKTOBER
SULAWESI BARAT,MAMUJU,SIMBORO DAN KEPULAUAN,RANGAS,70,36,16,8,1,1,0,12,2,2,6,3,0,0,0,0,13,10,3,10,13,1,12,0,36,3,33,25,OKTOBER
SULAWESI BARAT,MAMUJU,SIMBORO DAN KEPULAUAN,BOTTENG,99,57,42,27,15,11,8,28,2,3,21,7,12,0,12,0,51,26,25,1,50,2,48,0,11,2,9,9,OKTOBER
SULAWESI BARAT,MAMUJU,SIMBORO DAN KEPULAUAN,SALETTO,62,22,1,1,1,0,0,1,0,0,0,1,3,1,2,0,17,14,3,9,9,5,4,2,24,22,2,24,OKTOBER
SULAWESI BARAT,MAMUJU,SIMBORO DAN KEPULAUAN,SUMARE,51,23,10,5,5,1,0,0,4,3,3,5,8,8,0,6,10,9,1,4,8,6,2,1,17,11,6,14,OKTOBER
SULAWESI BARAT,MAMUJU,SIMBORO DAN KEPULAUAN,BOTTENG UTARA,53,70,25,14,2,1,0,19,2,4,3,2,6,2,4,2,49,48,1,24,13,7,6,5,14,8,6,9,OKTOBER
SULAWESI BARAT,MAMUJU,SIMBORO DAN KEPULAUAN,TAPANDULLU,30,37,32,5,3,3,0,17,10,1,5,20,0,0,0,0,21,18,3,16,15,11,4,8,4,4,0,4,OKTOBER
SULAWESI BARAT,MAMUJU,SIMBORO DAN KEPULAUAN,PATI'DI,45,55,41,40,19,5,5,7,23,3,30,0,4,1,3,1,12,9,3,6,0,0,0,0,2,2,0,1,OKTOBER
SULAWESI BARAT,MAMUJU,TAPALANG BARAT,DUNGKAIT,62,69,51,23,15,5,5,3,28,12,32,4,1,0,1,0,41,28,13,2,0,0,0,0,21,12,9,21,OKTOBER
SULAWESI BARAT,MAMUJU,TAPALANG BARAT,LEBANI,94,55,42,12,7,5,4,37,0,1,34,8,3,3,0,3,45,36,9,22,16,6,10,2,20,7,13,15,OKTOBER
SULAWESI BARAT,MAMUJU,TAPALANG BARAT,LABUANG RANO,35,74,57,27,5,4,2,24,11,10,12,15,0,0,0,0,29,11,18,4,15,4,11,0,32,15,17,7,OKTOBER
SULAWESI BARAT,MAMUJU,TAPALANG BARAT,PASABU,57,62,7,6,6,5,4,2,0,1,0,5,1,0,1,0,10,9,1,4,6,4,2,4,30,16,14,29,OKTOBER
SULAWESI BARAT,MAMUJU,TAPALANG BARAT,TANETE PAO,64,17,7,1,0,0,0,1,0,5,3,4,5,0,5,0,10,9,1,3,1,1,0,1,5,0,5,4,OKTOBER
SULAWESI BARAT,MAMUJU,TAPALANG BARAT,PANGASAAN,68,71,38,16,4,2,1,7,20,1,13,17,8,8,0,1,13,11,2,0,12,7,5,4,27,23,4,11,OKTOBER
SULAWESI BARAT,MAMUJU,TAPALANG BARAT,AHU,83,66,55,25,8,6,6,7,5,31,23,23,3,0,3,0,35,17,18,9,16,0,16,0,54,0,54,41,OKTOBER
SULAWESI BARAT,MAMUJU,BONEHAU,BONEHAU,40,54,53,19,19,11,2,15,28,8,2,24,2,1,1,1,33,15,18,1,15,13,2,5,28,17,11,28,OKTOBER
SULAWESI BARAT,MAMUJU,BONEHAU,SALUTIWO,52,72,62,7,0,0,0,54,8,0,54,8,9,4,5,0,67,34,33,23,58,40,18,17,45,28,17,27,OKTOBER
SULAWESI BARAT,MAMUJU,BONEHAU,BUTTUADA,55,45,4,3,2,2,1,1,1,0,0,0,6,3,3,3,34,9,25,1,22,3,19,1,47,37,10,32,OKTOBER
SULAWESI BARAT,MAMUJU,BONEHAU,TAMALEA,72,75,40,35,9,3,2,24,2,11,2,9,3,2,1,0,31,13,18,11,17,5,12,3,1,0,1,0,OKTOBER
SULAWESI BARAT,MAMUJU,BONEHAU,LUMIKA,80,13,10,0,0,0,0,8,2,0,5,2,14,13,1,12,13,5,8,2,8,7,1,1,0,0,0,0,OKTOBER
SULAWESI BARAT,MAMUJU,BONEHAU,MAPPU,81,66,11,1,1,1,1,3,1,5,10,0,10,10,0,8,27,22,5,21,7,2,5,2,2,0,2,2,OKTOBER
SULAWESI BARAT,MAMUJU,BONEHAU,BANUADA,40,29,21,0,0,0,0,0,13,5,3,10,1,0,1,0,23,18,5,5,20,13,7,5,22,10,12,6,OKTOBER
SULAWESI BARAT,MAMUJU,BONEHAU,HINUA,92,54,10,9,7,7,5,1,4,0,1,0,5,1,4,1,26,11,15,8,16,16,0,8,24,4,20,19,OKTOBER
SULAWESI BARAT,MAMUJU,BONEHAU,KINATANG,41,36,21,18,18,10,7,7,4,0,21,0,8,4,4,4,10,7,3,6,2,2,0,0,19,4,15,0,OKTOBER
SULAWESI BARAT,MAMUJU,KEP. BALA BALAKANG,BALA BALAKANG,60,63,6,5,5,1,0,1,3,0,3,0,1,0,1,0,62,15,47,9,55,51,4,41,10,3,7,7,OKTOBER
SULAWESI BARAT,MAMUJU,KEP. BALA BALAKANG,BALA-BALAKANG TIMUR,44,39,6,2,0,0,0,1,5,0,4,0,3,1,2,1,26,9,17,9,10,2,8,1,36,29,7,29,OKTOBER
SULAWESI BARAT,MAMUJU TENGAH,TOBADAK,MAHAHE,91,64,23,18,6,5,2,6,9,0,3,11,14,5,9,4,40,14,26,5,1,0,1,0,15,11,4,8,NOVEMBER
SULAWESI BARAT,MAMUJU TENGAH,TOBADAK,SALOBAJA,56,79,70,26,18,13,5,63,1,1,12,58,8,7,1,1,40,35,5,27,5,4,1,1,12,10,2,8,NOVEMBER
SULAWESI BARAT,MAMUJU TENGAH,TOBADAK,TOBADAK,98,61,15,11,1,1,0,5,1,3,0,3,6,2,4,0,20,16,4,13,0,0,0,0,6,2,4,3,NOVEMBER
SULAWESI BARAT,MAMUJU TENGAH,TOBADAK,PALONGAAN,84,79,1,0,0,0,0,1,0,0,1,0,12,9,3,7,59,6,53,4,25,0,25,0,46,44,2,30,NOVEMBER
SULAWESI BARAT,MAMUJU TENGAH,TOBADAK,BATU PARIGI,77,61,36,3,0,0,0,19,11,6,25,2,5,3,2,0,14,7,7,7,12,5,7,2,1,1,0,0,NOVEMBER
SULAWESI BARAT,MAMUJU TENGAH,TOBADAK,BAMBADARU,69,19,15,14,7,1,1,14,0,0,1,2,4,0,4,0,16,8,8,8,14,7,7,6,5,4,1,5,NOVEMBER
SULAWESI BARAT,MAMUJU TENGAH,TOBADAK,SEJATI,34,47,47,33,8,1,0,20,3,9,4,29,4,3,1,0,16,11,5,5,0,0,0,0,26,23,3,0,NOVEMBER
SULAWESI BARAT,MAMUJU TENGAH,TOBADAK,SALOADAK,65,32,26,5,2,1,1,16,5,2,16,10,3,2,1,2,32,27,5,27,19,3,16,2,34,34,0,6,NOVEMBER
SULAWESI BARAT,MAMUJU TENGAH,PANGALE,POLO PANGALE,53,45,27,16,5,1,0,23,1,1,6,15,3,0,3,0,23,12,11,4,10,6,4,6,6,1,5,1,NOVEMBER
SULAWESI BARAT,MAMUJU TENGAH,PANGALE,PANGALE,90,56,2,0,0,0,0,2,0,0,0,0,15,4,11,1,26,26,0,2,3,2,1,2,3,3,0,2,NOVEMBER
SULAWESI BARAT,MAMUJU TENGAH,PANGALE,SARTANAMAJU,61,16,8,0,0,0,0,1,4,1,6,0,6,0,6,0,14,5,9,0,0,0,0,0,4,2,2,3,NOVEMBER
SULAWESI BARAT,MAMUJU TENGAH,PANGALE,POLO LERENG,98,73,71,32,13,8,4,23,32,12,44,14,2,0,2,0,60,11,49,5,7,7,0,1,21,6,15,5,NOVEMBER
SULAWESI BARAT,MAMUJU TENGAH,PANGALE,KUO,95,77,2,2,2,2,0,1,0,0,1,0,11,8,3,0,24,16,8,5,12,12,0,10,52,41,11,5,NOVEMBER
SULAWESI BARAT,MAMUJU TENGAH,PANGALE,POLO CAMBA,37,18,10,5,2,2,2,4,4,0,1,6,2,2,0,0,11,7,4,0,8,1,7,0,3,3,0,3,NOVEMBER
SULAWESI BARAT,MAMUJU TENGAH,PANGALE,LAMBA-LAMBA,96,53,14,5,1,1,1,13,0,0,0,1,14,5,9,2,29,16,13,3,22,12,10,11,50,46,4,23,NOVEMBER
SULAWESI BARAT,MAMUJU TENGAH,PANGALE,KOMBILING,93,20,6,6,4,1,0,0,4,2,6,0,17,16,1,10,11,8,3,6,1,1,0,0,5,4,1,3,NOVEMBER
SULAWESI BARAT,MAMUJU TENGAH,PANGALE,LEMO-LEMO,59,54,3,1,1,1,0,0,1,0,3,0,9,5,4,3,21,16,5,6,14,1,13,1,0,0,0,0,NOVEMBER
SULAWESI BARAT,MAMUJU TENGAH,BUDONG-BUDONG,BABANA,30,46,36,23,10,9,3,17,3,4,32,4,1,1,0,0,20,15,5,3,12,6,6,3,35,24,11,17,NOVEMBER
SULAWESI BARAT,MAMUJU TENGAH,BUDONG-BUDONG,LUMU,40,26,16,9,2,1,1,2,11,2,14,1,6,0,6,0,23,18,5,9,7,0,7,0,21,10,11,5,NOVEMBER
SULAWESI BARAT,MAMUJU TENGAH,BUDONG-BUDONG,PONTANAKAYANG,85,43,32,21,4,2,0,8,15,9,4,6,5,3,2,3,42,7,35,0,20,9,11,8,47,28,19,39,NOVEMBER
SULAWESI BARAT,MAMUJU TENGAH,BUDONG-BUDONG,SALOGATTA,96,23,6,2,2,0,0,1,3,2,2,2,10,2,8,2,10,6,4,5,2,0,2,0,4,4,0,1,NOVEMBER
SULAWESI BARAT,MAMUJU TENGAH,BUDONG-BUDONG,KIRE,36,48,35,1,1,0,0,32,3,0,17,6,3,3,0,0,44,16,28,14,10,9,1,9,32,12,20,9,NOVEMBER
SULAWESI BARAT,MAMUJU TENGAH,BUDONG-BUDONG,TINALI,66,57,31,12,10,8,5,1,5,13,14,17,3,3,0,0,41,6,35,4,17,8,9,3,41,3,38,22,NOVEMBER
SULAWESI BARAT,MAMUJU TENGAH,BUDONG-BUDONG,SALUMANURUNG,48,65,5,3,1,1,0,1,4,0,1,1,5,0,5,0,65,28,37,24,9,4,5,0,40,34,6,33,NOVEMBER
SULAWESI BARAT,MAMUJU TENGAH,BUDONG-BUDONG,PASAPA,74,23,13,1,1,1,0,2,0,0,2,3,9,1,8,0,19,7,12,0,11,2,9,0,1,1,0,1,NOVEMBER
SULAWESI BARAT,MAMUJU TENGAH,BUDONG-BUDONG,BOJO,92,25,5,2,1,0,0,4,1,0,5,0,3,0,3,0,18,8,10,0,3,0,3,0,14,5,9,6,NOVEMBER
SULAWESI BARAT,MAMUJU TENGAH,BUDONG-BUDONG,BARAKKANG,78,72,50,4,0,0,0,21,10,5,48,0,6,0,6,0,35,21,14,2,8,5,3,1,51,14,37,8,NOVEMBER
SULAWESI BARAT,MAMUJU TENGAH,BUDONG-BUDONG,LEMBAH HADA,72,72,28,28,6,0,0,8,16,2,26,2,3,3,0,2,18,11,7,7,10,4,6,3,32,22,10,3,NOVEMBER
SULAWESI BARAT,MAMUJU TENGAH,TOPOYO,BUDONG-BUDONG,47,24,13,6,4,3,0,7,5,0,7,6,4,1,3,1,17,6,11,5,9,4,5,0,16,10,6,9,NOVEMBER
SULAWESI BARAT,MAMUJU TENGAH,TOPOYO,TOPOYO,70,25,8,8,2,2,1,5,1,1,6,0,14,11,3,1,21,15,6,11,16,12,4,7,17,17,0,4,NOVEMBER
SULAWESI BARAT,MAMUJU TENGAH,TOPOYO,TUMBU,62,70,52,0,0,0,0,12,28,5,24,13,5,3,2,1,34,28,6,5,12,4,8,4,39,22,17,31,NOVEMBER
SULAWESI BARAT,MAMUJU TENGAH,TOPOYO,KABUBU,93,65,50,48,31,14,0,19,4,26,22,24,8,8,0,3,36,26,10,11,7,1,6,0,9,5,4,0,NOVEMBER
SULAWESI BARAT,MAMUJU TENGAH,TOPOYO,WAEPUTEH,94,57,53,29,10,7,1,23,20,1,39,12,10,2,8,2,28,25,3,8,1,0,1,0,31,16,15,20,NOVEMBER
SULAWESI BARAT,MAMUJU TENGAH,TOPOYO,TANGKOU,57,66,37,2,2,0,0,35,1,1,3,27,9,3,6,1,39,8,31,5,33,20,13,13,21,13,8,19,NOVEMBER
SULAWESI BARAT,MAMUJU TENGAH,TOPOYO,TABOLANG,67,67,9,3,3,1,0,6,1,0,5,2,6,1,5,0,16,6,10,0,4,3,1,2,7,1,6,0,NOVEMBER
SULAWESI BARAT,MAMUJU TENGAH,TOPOYO,PARAILI,82,28,25,5,1,1,1,6,6,3,0,14,11,7,4,0,25,16,9,0,1,0,1,0,2,2,0,2,NOVEMBER
SULAWESI BARAT,MAMUJU TENGAH,TOPOYO,SALUPANGKANG,62,61,9,0,0,0,0,0,9,0,1,2,4,4,0,4,57,15,42,11,19,15,4,0,3,2,1,0,NOVEMBER
SULAWESI BARAT,MAMUJU TENGAH,TOPOYO,SALUPANGKANG IV,65,31,29,10,3,1,0,3,14,3,14,7,5,0,5,0,21,5,16,4,14,7,7,1,18,8,10,17,NOVEMBER
SULAWESI BARAT,MAMUJU TENGAH,TOPOYO,TAPPILINA,42,30,21,17,9,3,1,7,5,4,12,9,0,0,0,0,30,15,15,13,21,4,17,3,15,9,6,3,NOVEMBER
SULAWESI BARAT,MAMUJU TENGAH,TOPOYO,BAMBAMANURUNG,60,45,45,9,8,2,2,40,2,0,26,14,3,3,0,1,11,11,0,6,9,2,7,1,18,11,7,10,NOVEMBER
SULAWESI BARAT,MAMUJU TENGAH,TOPOYO,SALULEKBO,51,45,25,23,7,4,1,16,7,1,6,1,0,0,0,0,25,16,9,6,0,0,0,0,27,10,17,27,NOVEMBER
SULAWESI BARAT,MAMUJU TENGAH,TOPOYO,PANGALLOANG,50,18,6,4,4,1,0,0,4,0,4,1,4,3,1,3,18,9,9,0,15,2,13,0,17,3,14,8,NOVEMBER
SULAWESI BARAT,MAMUJU TENGAH,TOPOYO,SINABATTA,36,56,21,16,6,4,0,8,2,11,9,1,5,3,2,0,35,32,3,19,18,15,3,10,19,10,9,17,NOVEMBER
SULAWESI BARAT,MAMUJU TENGAH,KAROSSA,KAROSSA,90,53,43,0,0,0,0,35,8,0,16,23,1,1,0,0,45,42,3,3,3,1,2,0,18,13,5,15,NOVEMBER
SULAWESI BARAT,MAMUJU TENGAH,KAROSSA,TASOKKO,89,27,14,5,5,2,0,4,6,4,7,0,17,0,17,0,24,12,12,8,18,8,10,6,17,11,6,17,NOVEMBER
SULAWESI BARAT,MAMUJU TENGAH,KAROSSA,LARA,66,20,7,4,0,0,0,1,1,4,7,0,12,3,9,3,19,6,13,4,17,4,13,1,26,22,4,19,NOVEMBER
SULAWESI BARAT,MAMUJU TENGAH,KAROSSA,KADAILA,68,49,6,6,4,4,2,1,0,1,4,2,5,0,5,0,23,7,16,6,19,3,16,1,19,1,18,1,NOVEMBER
SULAWESI BARAT,MAMUJU TENGAH,KAROSSA,KAYU CALLA,100,46,1,0,0,0,0,0,1,0,0,0,0,0,0,0,16,6,10,5,14,13,1,11,14,4,10,8,NOVEMBER
SULAWESI BARAT,MAMUJU TENGAH,KAROSSA,LEMBAH HOPO,89,28,16,4,4,3,2,8,2,1,13,1,14,9,5,3,16,10,6,4,0,0,0,0,9,4,5,2,NOVEMBER
SULAWESI BARAT,MAMUJU TENGAH,KAROSSA,BENGGAULU,45,19,4,0,0,0,0,3,0,0,1,0,0,0,0,0,19,16,3,16,9,5,4,0,7,0,7,5,NOVEMBER
SULAWESI BARAT,MAMUJU TENGAH,KAROSSA,SUKA MAJU,95,67,16,16,12,8,7,6,3,0,0,4,2,2,0,1,60,51,9,38,14,1,13,1,44,20,24,9,NOVEMBER
SULAWESI BARAT,MAMUJU TENGAH,KAROSSA,KAMBUNONG,57,47,44,7,7,2,2,11,24,0,28,0,9,0,9,0,38,20,18,5,17,7,10,0,46,44,2,14,NOVEMBER
SULAWESI BARAT,MAMUJU TENGAH,KAROSSA,SALUBIRO,63,54,26,5,0,0,0,16,10,0,4,18,5,3,2,1,46,25,21,16,42,22,20,6,17,11,6,3,NOVEMBER
SULAWESI BARAT,MAMUJU TENGAH,KAROSSA,SANJANGO,34,66,33,3,3,3,1,23,2,5,2,27,5,2,3,0,22,6,16,3,1,0,1,0,26,16,10,9,NOVEMBER
SULAWESI BARAT,PASANGKAYU,BAMBAIRA,TAMPAURE,98,79,32,1,1,0,0,16,15,1,29,2,15,10,5,9,35,17,18,14,31,6,25,3,51,16,35,31,NOVEMBER
SULAWESI BARAT,PASANGKAYU,BAMBAIRA,BAMBAIRA,32,70,49,12,8,1,0,32,16,1,27,1,3,3,0,0,35,20,15,20,25,25,0,23,45,1,44,28,NOVEMBER
SULAWESI BARAT,PASANGKAYU,BAMBAIRA,KASOLOANG,77,16,0,0,0,0,0,0,0,0,0,0,2,1,1,1,12,12,0,2,5,1,4,1,8,0,8,5,NOVEMBER
SULAWESI BARAT,PASANGKAYU,BAMBAIRA,KALUKU NANGKA,87,25,24,22,0,0,0,5,4,10,2,20,4,3,1,0,11,11,0,5,11,5,6,0,23,11,12,1,NOVEMBER
SULAWESI BARAT,PASANGKAYU,BAMBALAMOTU,RANDOMAYANG,53,44,16,0,0,0,0,9,6,1,11,4,8,7,1,1,25,20,5,20,3,2,1,2,8,4,4,6,NOVEMBER
SULAWESI BARAT,PASANGKAYU,BAMBALAMOTU,BAMBALAMOTU,77,39,0,0,0,0,0,0,0,0,0,0,6,5,1,4,38,30,8,16,10,8,2,8,9,0,9,5,NOVEMBER
SULAWESI BARAT,PASANGKAYU,BAMBALAMOTU,POLEWALI,49,33,0,0,0,0,0,0,0,0,0,0,3,1,2,1,14,7,7,0,9,3,6,0,21,19,2,15,NOVEMBER
SULAWESI BARAT,PASANGKAYU,BAMBALAMOTU,PANGIANG,59,64,19,14,11,0,0,12,3,2,17,0,4,3,1,2,32,17,15,10,13,5,8,3,14,0,14,10,NOVEMBER
SULAWESI BARAT,PASANGKAYU,BAMBALAMOTU,KALOLA,88,75,9,2,0,0,0,1,4,1,0,0,3,0,3,0,56,48,8,8,25,24,1,14,26,18,8,14,NOVEMBER
SULAWESI BARAT,PASANGKAYU,BAMBALAMOTU,WULAI,47,23,7,1,0,0,0,7,0,0,3,1,7,2,5,2,19,13,6,6,13,8,5,5,16,10,6,12,NOVEMBER
SULAWESI BARAT,PASANGKAYU,BARAS,BARAS,88,60,54,42,30,11,4,17,3,3,3,45,3,2,1,0,34,15,19,1,19,8,11,2,27,10,17,15,NOVEMBER
SULAWESI BARAT,PASANGKAYU,BARAS,BULU PARIGI,92,76,67,8,2,1,1,11,36,18,3,9,9,8,1,0,12,11,1,7,8,6,2,1,53,26,27,42,NOVEMBER
SULAWESI BARAT,PASANGKAYU,BARAS,BALANTI,33,51,7,2,0,0,0,3,3,0,7,0,5,3,2,0,10,10,0,10,0,0,0,0,28,18,10,5,NOVEMBER
SULAWESI BARAT,PASANGKAYU,BARAS,MOTU,80,74,22,0,0,0,0,15,2,4,13,1,13,11,2,6,10,5,5,5,4,3,1,1,46,34,12,16,NOVEMBER
SULAWESI BARAT,PASANGKAYU,BARAS,TOWONI,96,63,30,30,4,0,0,15,7,3,3,15,14,7,7,0,43,28,15,22,13,9,4,6,22,6,16,17,NOVEMBER
SULAWESI BARAT,PASANGKAYU,BARAS,KASANO,69,27,13,7,7,2,1,3,3,3,5,8,8,7,1,3,12,11,1,7,8,4,4,1,16,11,5,11,NOVEMBER
SULAWESI BARAT,PASANGKAYU,BULU TABA,SUMBER SARI,37,69,49,42,5,0,0,13,20,5,44,1,4,4,0,0,44,27,17,17,35,17,18,1,56,1,55,36,NOVEMBER
SULAWESI BARAT,PASANGKAYU,BULU TABA,LELEJAE,30,28,26,22,13,9,5,21,0,0,5,11,4,1,3,0,20,13,7,9,19,7,12,0,34,10,24,19,NOVEMBER
SULAWESI BARAT,PASANGKAYU,BULU TABA,BUKIT HARAPAN,84,13,12,4,0,0,0,11,1,0,1,10,2,2,0,0,11,9,2,2,6,4,2,2,15,4,11,6,NOVEMBER
SULAWESI BARAT,PASANGKAYU,BULU TABA,LILIMORI,57,79,30,8,5,0,0,13,14,1,18,7,1,0,1,0,79,63,16,42,58,54,4,52,51,6,45,41,NOVEMBER
SULAWESI BARAT,PASANGKAYU,BULU TABA,KARAVE,59,74,47,33,16,10,9,3,34,0,31,7,2,0,2,0,51,6,45,1,8,5,3,0,33,18,15,28,NOVEMBER
SULAWESI BARAT,PASANGKAYU,BULU TABA,KASTABUANA,95,49,26,26,7,6,6,1,13,3,17,8,7,3,4,3,38,24,14,8,3,3,0,2,30,3,27,4,NOVEMBER
SULAWESI BARAT,PASANGKAYU,BULU TABA,OMPI,72,79,67,43,30,21,0,25,30,11,15,49,11,3,8,2,14,7,7,0,3,1,2,0,26,6,20,25,NOVEMBER
SULAWESI BARAT,PASANGKAYU,DAPURANG,DAPURANG,81,70,48,7,3,1,1,28,14,0,19,13,15,8,7,4,18,16,2,6,2,1,1,1,0,0,0,0,NOVEMBER
SULAWESI BARAT,PASANGKAYU,DAPURANG,BENGGAULU,93,48,5,1,1,1,1,0,4,0,1,0,14,0,14,0,33,31,2,27,26,1,25,1,26,4,22,5,NOVEMBER
SULAWESI BARAT,PASANGKAYU,DAPURANG,TIRTABUANA,67,17,13,1,0,0,0,0,10,0,11,2,1,0,1,0,16,11,5,1,4,3,1,3,6,0,6,3,NOVEMBER
SULAWESI BARAT,PASANGKAYU,DAPURANG,BULU BONGGU,66,51,45,8,0,0,0,29,16,0,44,0,10,0,10,0,39,37,2,37,24,0,24,0,16,4,12,9,NOVEMBER
SULAWESI BARAT,PASANGKAYU,DAPURANG,SARASA,73,79,58,18,0,0,0,50,7,0,31,21,7,0,7,0,38,37,1,3,1,0,1,0,13,3,10,10,NOVEMBER
SULAWESI BARAT,PASANGKAYU,DURIPOKU,TAMMARUNANG,40,44,33,9,8,3,0,12,8,2,29,3,1,1,0,0,14,13,1,2,10,1,9,0,35,19,16,7,NOVEMBER
SULAWESI BARAT,PASANGKAYU,DURIPOKU,SAPTANAJAYA,47,49,15,15,15,4,1,7,3,0,11,3,6,1,5,1,37,8,29,8,14,1,13,1,44,22,22,10,NOVEMBER
SULAWESI BARAT,PASANGKAYU,DURIPOKU,TARANGGI,76,60,1,0,0,0,0,0,0,0,0,0,15,0,15,0,11,11,0,5,7,2,5,2,7,0,7,3,NOVEMBER
SULAWESI BARAT,PASANGKAYU,DURIPOKU,SIPAKAINGA,45,60,52,38,31,29,21,10,5,14,23,21,1,1,0,1,47,11,36,5,13,10,3,3,52,43,9,6,NOVEMBER
SULAWESI BARAT,PASANGKAYU,LARIANG,KULU,34,19,7,4,3,2,2,4,0,1,5,1,4,4,0,2,15,12,3,9,11,11,0,5,12,10,2,6,NOVEMBER
SULAWESI BARAT,PASANGKAYU,LARIANG,PARABU,57,12,4,3,2,1,1,0,1,0,2,1,2,0,2,0,11,11,0,6,9,6,3,3,10,7,3,4,NOVEMBER
SULAWESI BARAT,PASANGKAYU,LARIANG,KENANGAN,45,59,31,9,6,0,0,26,1,0,23,3,1,1,0,0,58,21,37,12,50,44,6,6,88,24,64,67,NOVEMBER
SULAWESI BARAT,PASANGKAYU,LARIANG,BAJAWALI,63,47,28,2,1,1,0,25,0,2,2,15,9,2,7,1,37,23,14,19,2,0,2,0,24,9,15,12,NOVEMBER
SULAWESI BARAT,PASANGKAYU,LARIANG,SINGGANI,94,54,33,17,9,4,1,8,17,5,21,7,12,4,8,2,14,13,1,1,6,2,4,0,5,3,2,4,NOVEMBER
SULAWESI BARAT,PASANGKAYU,LARIANG,BATU MATORU,55,53,13,3,1,1,0,3,9,1,13,0,2,2,0,1,48,18,30,1,7,5,2,0,30,10,20,26,NOVEMBER
SULAWESI BARAT,PASANGKAYU,LARIANG,BAMBAKORO,31,42,29,26,19,3,3,17,3,1,8,2,3,3,0,0,22,18,4,12,13,4,9,2,22,18,4,11,NOVEMBER
SULAWESI BARAT,PASANGKAYU,PASANGKAYU,KARYA BERSAMA,77,23,12,4,0,0,0,12,0,0,12,0,10,2,8,1,18,7,11,0,13,11,2,3,15,13,2,1,NOVEMBER
SULAWESI BARAT,PASANGKAYU,PASANGKAYU,AKO,32,43,36,24,15,8,2,17,5,4,0,23,2,2,0,0,11,10,1,1,0,0,0,0,27,27,0,24,NOVEMBER
SULAWESI BARAT,PASANGKAYU,PASANGKAYU,PASANGKAYU,43,27,5,4,3,1,1,2,0,0,0,3,7,6,1,4,17,12,5,0,10,10,0,7,10,1,9,0,NOVEMBER
SULAWESI BARAT,PASANGKAYU,PASANGKAYU,MARTAJAYA,43,57,54,17,2,0,0,5,24,8,24,9,1,0,1,0,54,38,16,6,3,3,0,2,18,0,18,14,NOVEMBER
SULAWESI BARAT,PASANGKAYU,PASANGKAYU,PAKAVA,57,61,12,8,7,7,0,6,6,0,6,1,2,0,2,0,55,14,41,12,29,22,7,5,12,10,2,7,NOVEMBER
SULAWESI BARAT,PASANGKAYU,PASANGKAYU,GUNUNG SARI,41,51,45,22,12,10,2,30,6,2,14,29,6,5,1,3,16,12,4,3,13,5,8,5,12,6,6,6,NOVEMBER
SULAWESI BARAT,PASANGKAYU,PEDONGGA,MALEI,42,15,1,0,0,0,0,1,0,0,1,0,4,3,1,2,11,6,5,1,7,1,6,1,10,7,3,6,NOVEMBER
SULAWESI BARAT,PASANGKAYU,PEDONGGA,PEDANDA,94,18,12,1,0,0,0,0,7,4,0,10,18,16,2,2,10,7,3,3,3,1,2,1,0,0,0,0,NOVEMBER
SULAWESI BARAT,PASANGKAYU,PEDONGGA,BATU OGE,98,73,66,14,2,1,1,33,1,11,36,13,0,0,0,0,69,9,60,9,35,25,10,3,77,12,65,41,NOVEMBER
SULAWESI BARAT,PASANGKAYU,PEDONGGA,MARTASARI,89,25,22,0,0,0,0,4,0,11,8,11,7,1,6,1,22,17,5,13,19,6,13,3,10,1,9,3,NOVEMBER
SULAWESI BARAT,PASANGKAYU,SARJO,SARJO,90,54,36,31,0,0,0,30,4,0,18,18,8,7,1,7,27,9,18,2,7,3,4,1,32,10,22,22,NOVEMBER
SULAWESI BARAT,PASANGKAYU,SARJO,MAPONU,33,24,0,0,0,0,0,0,0,0,0,0,3,2,1,0,19,16,3,14,17,13,4,4,32,4,28,15,NOVEMBER
SULAWESI BARAT,PASANGKAYU,SARJO,LETAWA,92,70,36,19,0,0,0,14,1,0,18,8,2,0,2,0,20,12,8,4,12,8,4,2,43,13,30,20,NOVEMBER
SULAWESI BARAT,PASANGKAYU,SARJO,SARUDE,88,11,2,1,0,0,0,1,0,0,0,1,17,12,5,6,11,7,4,4,10,10,0,3,16,10,6,15,NOVEMBER
SULAWESI BARAT,PASANGKAYU,SARUDU,DODA,65,58,8,5,2,0,0,6,1,1,3,3,1,1,0,0,46,18,28,3,21,5,16,5,11,0,11,1,NOVEMBER
SULAWESI BARAT,PASANGKAYU,SARUDU,SARUDU,97,43,23,21,0,0,0,19,1,0,22,0,6,1,5,1,38,6,32,4,2,1,1,1,7,2,5,1,NOVEMBER
SULAWESI BARAT,PASANGKAYU,SARUDU,BULU MARIO,63,50,32,12,12,8,2,2,21,5,32,0,7,3,4,2,32,22,10,12,18,11,7,0,49,23,26,0,NOVEMBER
SULAWESI BARAT,PASANGKAYU,SARUDU,KUMASARI,68,63,4,0,0,0,0,2,1,1,3,0,6,0,6,0,31,9,22,5,1,0,1,0,25,18,7,24,NOVEMBER
SULAWESI BARAT,PASANGKAYU,SARUDU,PATIKA,45,23,14,7,3,1,0,0,10,2,2,11,2,1,1,1,22,20,2,4,17,16,1,0,9,5,4,3,NOVEMBER
SULAWESI BARAT,PASANGKAYU,TIKKE RAYA,MAKMUR JAYA,57,59,33,27,20,5,2,27,2,0,29,0,5,2,3,2,18,14,4,0,14,9,5,0,53,9,44,23,NOVEMBER
SULAWESI BARAT,PASANGKAYU,TIKKE RAYA,LARIANG,76,23,7,6,5,0,0,1,5,0,0,2,2,0,2,0,15,15,0,5,14,13,1,7,12,11,1,2,NOVEMBER
SULAWESI BARAT,PASANGKAYU,TIKKE RAYA,TIKKE,30,62,46,28,26,5,2,0,2,41,8,26,3,3,0,0,57,57,0,17,23,22,1,16,64,12,52,5,NOVEMBER
SULAWESI BARAT,PASANGKAYU,TIKKE RAYA,PAJALELE,86,71,66,27,8,0,0,51,12,0,32,21,3,0,3,0,54,11,43,7,1,1,0,0,25,3,22,23,NOVEMBER
SULAWESI BARAT,PASANGKAYU,TIKKE RAYA,JENGENG RAYA,91,37,9,4,4,4,2,4,2,1,7,1,11,10,1,10,25,21,4,3,22,9,13,0,3,1,2,0,NOVEMBER
SULAWESI BARAT,MAJENE,BANGGAE,BANGGAE,46,78,67,12,0,0,0,42,25,0,1,15,0,0,0,0,52,50,2,7,15,2,13,1,27,22,5,15,NOVEMBER
SULAWESI BARAT,MAJENE,BANGGAE,BARU,93,40,27,6,1,1,1,4,11,3,20,4,1,1,0,0,31,11,20,10,14,6,8,2,14,0,14,1,NOVEMBER
SULAWESI BARAT,MAJENE,BANGGAE,PANGALI ALI,54,74,72,11,2,0,0,36,31,2,66,0,3,0,3,0,19,18,1,10,8,1,7,1,54,17,37,17,NOVEMBER
SULAWESI BARAT,MAJENE,BANGGAE,TOTOLI,96,29,22,8,4,3,3,18,0,0,9,3,6,4,2,2,25,8,17,2,23,15,8,10,40,4,36,9,NOVEMBER
SULAWESI BARAT,MAJENE,BANGGAE,RANGAS,41,73,63,10,5,4,1,41,3,17,35,28,8,8,0,4,26,14,12,5,19,19,0,18,28,6,22,4,NOVEMBER
SULAWESI BARAT,MAJENE,BANGGAE,GALUNG,84,29,9,1,1,0,0,7,2,0,6,0,16,4,12,3,21,11,10,10,16,7,9,0,33,19,14,20,NOVEMBER
SULAWESI BARAT,MAJENE,BANGGAE,PALIPI SOREANG,48,27,18,12,1,0,0,10,5,0,6,4,9,9,0,5,14,13,1,2,14,4,10,2,30,24,6,29,NOVEMBER
SULAWESI BARAT,MAJENE,BANGGAE,PAMBOBORANG,60,58,28,24,11,9,2,17,9,0,13,4,3,1,2,0,42,23,19,18,26,26,0,26,65,63,2,61,NOVEMBER
SULAWESI BARAT,MAJENE,BANGGAE TIMUR,BAURUNG,57,15,9,0,0,0,0,4,3,1,3,5,3,0,3,0,14,9,5,5,7,1,6,0,2,0,2,0,NOVEMBER
SULAWESI BARAT,MAJENE,BANGGAE TIMUR,BARUGA,90,22,15,5,2,2,2,13,0,0,14,0,1,0,1,0,16,11,5,10,8,4,4,0,10,9,1,9,NOVEMBER
SULAWESI BARAT,MAJENE,BANGGAE TIMUR,BARUGA DHUA,82,31,1,1,0,0,0,0,1,0,1,0,3,2,1,2,30,25,5,3,27,7,20,1,21,4,17,14,NOVEMBER
SULAWESI BARAT,MAJENE,BANGGAE TIMUR,LABUANG,60,60,39,6,3,3,2,21,10,6,39,0,6,2,4,2,26,11,15,1,6,5,1,1,16,9,7,12,NOVEMBER
SULAWESI BARAT,MAJENE,BANGGAE TIMUR,TANDE,80,60,32,12,3,2,0,7,2,7,14,1,3,1,2,1,40,29,11,29,29,9,20,5,14,11,3,7,NOVEMBER
SULAWESI BARAT,MAJENE,BANGGAE TIMUR,LEMBANG,58,38,31,13,6,1,1,22,8,0,10,21,9,2,7,2,31,13,18,6,21,4,17,2,3,1,2,1,NOVEMBER
SULAWESI BARAT,MAJENE,BANGGAE TIMUR,LABUANG UTARA,86,11,0,0,0,0,0,0,0,0,0,0,12,7,5,2,10,6,4,3,2,2,0,1,4,1,3,0,NOVEMBER
SULAWESI BARAT,MAJENE,BANGGAE TIMUR,TANDE TIMUR,54,62,22,4,1,0,0,19,3,0,18,0,9,3,6,1,44,38,6,8,29,4,25,1,36,32,4,0,NOVEMBER
SULAWESI BARAT,MAJENE,BANGGAE TIMUR,BUTTU BARUGA,92,78,78,5,1,1,1,77,0,0,12,25,1,0,1,0,42,33,9,12,26,0,26,0,14,2,12,12,NOVEMBER
SULAWESI BARAT,MAJENE,MALUNDA,MALUNDA,40,30,8,7,0,0,0,6,1,1,3,1,1,1,0,0,10,6,4,6,1,0,1,0,19,12,7,6,NOVEMBER
SULAWESI BARAT,MAJENE,MALUNDA,LAMUNGANG BATU,31,62,28,23,22,8,4,24,0,0,2,25,1,1,0,1,27,10,17,2,23,7,16,5,53,36,17,37,NOVEMBER
SULAWESI BARAT,MAJENE,MALUNDA,BAMBANGAN,65,54,17,15,10,1,1,6,6,4,11,4,13,2,11,2,31,17,14,13,0,0,0,0,18,10,8,18,NOVEMBER
SULAWESI BARAT,MAJENE,MALUNDA,LOMBANG,71,60,42,36,14,14,0,22,5,7,28,8,4,4,0,2,16,12,4,11,14,1,13,0,25,16,9,4,NOVEMBER
SULAWESI BARAT,MAJENE,MALUNDA,LOMBONG,34,47,27,21,5,3,0,14,11,0,1,16,4,1,3,0,25,25,0,21,16,3,13,3,47,20,27,25,NOVEMBER
SULAWESI BARAT,MAJENE,MALUNDA,MEKKATTA,67,11,1,0,0,0,0,0,1,0,1,0,8,5,3,1,11,5,6,4,10,7,3,1,8,0,8,4,NOVEMBER
SULAWESI BARAT,MAJENE,MALUNDA,MALIAYA,99,60,59,29,17,12,9,5,39,1,23,3,6,6,0,0,51,14,37,2,5,5,0,2,41,9,32,24,NOVEMBER
SULAWESI BARAT,MAJENE,MALUNDA,LOMBANG TIMUR,45,31,15,15,12,7,4,0,6,2,1,5,9,8,1,5,10,6,4,4,7,7,0,2,0,0,0,0,NOVEMBER
SULAWESI BARAT,MAJENE,MALUNDA,SALUTAHONGAN,41,62,38,33,33,4,0,37,1,0,7,19,0,0,0,0,50,15,35,13,10,9,1,5,48,25,23,42,NOVEMBER
SULAWESI BARAT,MAJENE,MALUNDA,LOMBONG TIMUR,42,40,35,17,16,13,10,10,3,1,28,7,6,4,2,2,13,7,6,5,11,7,4,2,1,1,0,0,NOVEMBER
SULAWESI BARAT,MAJENE,MALUNDA,MEKKATTA SELATAN,42,31,3,0,0,0,0,2,1,0,0,0,8,8,0,1,25,16,9,4,10,10,0,0,19,18,1,18,NOVEMBER
SULAWESI BARAT,MAJENE,MALUNDA,KAYUANGIN,99,29,18,15,13,8,7,5,3,0,15,0,9,8,1,0,14,5,9,3,2,0,2,0,11,8,3,8,NOVEMBER
SULAWESI BARAT,MAJENE,PAMBOANG,LALAMPANUA,73,57,51,40,3,3,3,40,1,2,39,2,11,6,5,1,21,21,0,9,10,2,8,0,37,23,14,35,NOVEMBER
SULAWESI BARAT,MAJENE,PAMBOANG,SIRINDU,91,67,8,7,1,1,1,4,3,0,5,0,0,0,0,0,26,10,16,0,15,9,6,8,29,17,12,29,NOVEMBER
SULAWESI BARAT,MAJENE,PAMBOANG,ADOLANG,66,53,10,1,1,0,0,3,2,3,0,6,9,5,4,1,40,17,23,13,22,12,10,8,58,45,13,41,NOVEMBER
SULAWESI BARAT,MAJENE,PAMBOANG,BABABULO,92,35,9,2,2,0,0,6,1,2,4,3,11,11,0,10,17,6,11,1,15,0,15,0,3,2,1,2,NOVEMBER
SULAWESI BARAT,MAJENE,PAMBOANG,BONDE,85,62,24,22,14,4,4,16,2,2,21,3,12,4,8,2,27,12,15,9,10,2,8,1,53,19,34,49,NOVEMBER
SULAWESI BARAT,MAJENE,PAMBOANG,BETTENG,45,48,20,8,4,0,0,5,7,5,20,0,2,1,1,0,19,9,10,5,9,9,0,4,14,13,1,12,NOVEMBER
SULAWESI BARAT,MAJENE,PAMBOANG,SIMBANG,35,54,14,4,3,1,1,7,1,3,12,2,0,0,0,0,17,17,0,15,11,6,5,0,11,10,1,4,NOVEMBER
SULAWESI BARAT,MAJENE,PAMBOANG,BONDE UTARA,58,42,9,3,1,0,0,3,4,0,4,0,8,2,6,2,28,6,22,1,26,17,9,17,52,46,6,10,NOVEMBER
SULAWESI BARAT,MAJENE,PAMBOANG,BABABULO UTARA,95,41,12,2,1,1,1,6,4,1,10,0,18,7,11,5,37,10,27,9,15,10,5,4,10,6,4,0,NOVEMBER
SULAWESI BARAT,MAJENE,PAMBOANG,BUTTU PAMBOANG,61,36,17,9,4,1,1,8,5,0,7,3,12,11,1,4,10,10,0,2,7,1,6,0,15,8,7,0,NOVEMBER
SULAWESI BARAT,MAJENE,PAMBOANG,BANUA ADOLANG,74,63,18,3,3,2,1,3,9,3,17,1,1,0,1,0,54,12,42,9,16,7,9,4,12,10,2,1,NOVEMBER
SULAWESI BARAT,MAJENE,PAMBOANG,ADOLANG DHUA,77,73,69,52,32,4,1,68,0,0,67,0,1,1,0,0,51,17,34,16,5,2,3,2,21,14,7,12,NOVEMBER
SULAWESI BARAT,MAJENE,PAMBOANG,TINAMBUNG,98,17,5,1,0,0,0,4,0,1,1,4,2,1,1,1,12,12,0,0,6,5,1,4,15,7,8,3,NOVEMBER
SULAWESI BARAT,MAJENE,PAMBOANG,PESULOANG,79,73,38,36,3,0,0,7,10,15,31,4,8,8,0,7,15,10,5,9,7,7,0,2,47,45,2,42,NOVEMBER
SULAWESI BARAT,MAJENE,PAMBOANG,BALOMBONG,53,29,8,1,0,0,0,8,0,0,8,0,8,4,4,1,16,14,2,6,0,0,0,0,16,0,16,9,NOVEMBER
SULAWESI BARAT,MAJENE,SENDANA,MOSSO,97,65,0,0,0,0,0,0,0,0,0,0,11,5,6,5,16,8,8,3,5,4,1,3,44,14,30,37,NOVEMBER
SULAWESI BARAT,MAJENE,SENDANA,MOSSO DHUA,99,19,10,1,0,0,0,6,1,2,5,0,4,2,2,1,18,11,7,9,0,0,0,0,8,6,2,7,NOVEMBER
SULAWESI BARAT,MAJENE,SENDANA,TOTOLISI SENDANA,43,61,44,23,20,19,19,8,13,0,8,12,8,8,0,4,37,36,1,22,28,15,13,5,34,33,1,9,NOVEMBER
SULAWESI BARAT,MAJENE,SENDANA,TALLUBANUA,93,31,0,0,0,0,0,0,0,0,0,0,16,3,13,0,17,17,0,7,11,8,3,7,29,14,15,6,NOVEMBER
SULAWESI BARAT,MAJENE,SENDANA,LALATEDZONG,31,29,1,0,0,0,0,0,1,0,0,1,5,1,4,0,19,11,8,11,16,5,11,3,36,25,11,32,NOVEMBER
SULAWESI BARAT,MAJENE,SENDANA,BINANGA,42,55,29,11,5,4,1,19,3,5,26,0,7,1,6,0,12,9,3,4,6,2,4,0,5,2,3,4,NOVEMBER
SULAWESI BARAT,MAJENE,SENDANA,PUTTADA,94,30,2,2,0,0,0,0,0,1,2,0,16,14,2,9,12,9,3,7,1,1,0,0,12,1,11,9,NOVEMBER
SULAWESI BARAT,MAJENE,SENDANA,PAMINGGALAN,62,59,43,5,0,0,0,11,26,2,29,7,5,1,4,0,13,5,8,3,13,7,6,6,52,31,21,0,NOVEMBER
SULAWESI BARAT,MAJENE,SENDANA,LEPPANGANG,94,55,21,5,4,2,0,1,5,1,11,10,17,17,0,6,15,14,1,7,5,1,4,1,20,4,16,18,NOVEMBER
SULAWESI BARAT,MAJENE,SENDANA,PUNDAU,80,77,32,30,11,10,3,16,3,9,12,4,7,6,1,4,65,17,48,12,18,2,16,2,43,22,21,27,NOVEMBER
SULAWESI BARAT,MAJENE,SENDANA,SENDANA,76,72,55,33,25,24,20,24,8,0,51,3,13,10,3,10,52,36,16,21,29,23,6,6,76,5,71,3,NOVEMBER
SULAWESI BARAT,MAJENE,SENDANA,BANUA SENDANA,69,63,29,8,1,0,0,14,2,9,17,8,4,3,1,2,34,20,14,3,24,11,13,4,19,17,2,18,NOVEMBER
SULAWESI BARAT,MAJENE,SENDANA,TALLUBANUA UTARA,38,76,19,13,1,0,0,10,9,0,17,0,6,5,1,0,60,46,14,32,49,12,37,2,33,10,23,0,NOVEMBER
SULAWESI BARAT,MAJENE,SENDANA,LIMBORO RAMBU-RAMBU,30,68,5,4,4,2,2,3,0,0,3,1,6,3,3,2,51,51,0,30,29,16,13,13,60,13,47,23,NOVEMBER
SULAWESI BARAT,MAJENE,SENDANA,LIMBUA,44,22,18,16,0,0,0,17,0,0,2,14,5,0,5,0,14,14,0,10,3,2,1,2,10,1,9,0,NOVEMBER
SULAWESI BARAT,MAJENE,SENDANA,BUKIT SAMANG,48,32,12,10,2,2,0,2,5,4,0,12,3,0,3,0,24,13,11,10,7,0,7,0,8,0,8,7,NOVEMBER
SULAWESI BARAT,MAJENE,TAMMERODO SENDANA,SEPPONG,31,64,15,1,0,0,0,10,5,0,7,6,3,1,2,0,15,9,6,5,5,3,2,2,48,1,47,44,NOVEMBER
SULAWESI BARAT,MAJENE,TAMMERODO SENDANA,TAMMERODO,50,80,65,13,0,0,0,19,43,0,60,4,9,6,3,5,53,28,25,4,2,2,0,1,53,22,31,14,NOVEMBER
SULAWESI BARAT,MAJENE,TAMMERODO SENDANA,ULIDANG,39,78,35,32,28,18,17,5,7,0,27,1,3,3,0,2,14,5,9,2,13,5,8,2,57,1,56,44,NOVEMBER
SULAWESI BARAT,MAJENE,TAMMERODO SENDANA,TALLAMBALAO,46,14,6,0,0,0,0,0,6,0,4,1,3,1,2,0,11,11,0,7,11,9,2,1,8,5,3,7,NOVEMBER
SULAWESI BARAT,MAJENE,TAMMERODO SENDANA,TAMMERODO UTARA,54,61,33,3,1,1,1,0,0,18,0,9,2,2,0,1,12,12,0,8,9,8,1,6,43,43,0,28,NOVEMBER
SULAWESI BARAT,MAJENE,TAMMERODO SENDANA,MANYAMBA,65,27,9,9,1,0,0,8,1,0,8,0,7,7,0,0,10,10,0,2,9,7,2,1,27,19,8,24,NOVEMBER
SULAWESI BARAT,MAJENE,TAMMERODO SENDANA,AWO,33,42,0,0,0,0,0,0,0,0,0,0,0,0,0,0,25,10,15,9,7,4,3,3,8,8,0,6,NOVEMBER
SULAWESI BARAT,MAJENE,TUBO SENDANA,ONANG,39,72,40,18,8,0,0,24,15,1,0,19,7,5,2,0,20,20,0,15,12,0,12,0,58,38,20,48,NOVEMBER
SULAWESI BARAT,MAJENE,TUBO SENDANA,TUBO,88,14,9,4,4,4,3,1,5,0,2,2,2,0,2,0,12,8,4,0,9,5,4,5,13,13,0,8,NOVEMBER
SULAWESI BARAT,MAJENE,TUBO SENDANA,ONANG UTARA,47,38,4,4,2,2,2,2,0,0,4,0,5,0,5,0,30,28,2,2,16,13,3,12,22,8,14,6,NOVEMBER
SULAWESI BARAT,MAJENE,TUBO SENDANA,TUBO SELATAN,46,29,14,7,7,4,4,9,1,0,13,1,1,0,1,0,15,9,6,8,1,0,1,0,2,1,1,2,NOVEMBER
SULAWESI BARAT,MAJENE,TUBO SENDANA,BONDE BONDE,90,22,12,3,2,1,1,4,0,4,2,10,5,5,0,4,15,11,4,9,15,8,7,4,0,0,0,0,NOVEMBER
SULAWESI BARAT,MAJENE,TUBO SENDANA,TUBO TENGAH,52,67,59,21,20,14,14,33,12,0,53,1,0,0,0,0,29,14,15,10,9,8,1,5,42,31,11,12,NOVEMBER
SULAWESI BARAT,MAJENE,TUBO SENDANA,TUBO POANG,40,59,48,44,20,9,5,40,0,3,6,12,8,6,2,4,47,32,15,8,35,0,35,0,58,2,56,3,NOVEMBER
SULAWESI BARAT,MAJENE,ULUMANDA,KABIRAAN,78,54,30,17,8,4,2,4,14,9,7,11,13,13,0,6,52,36,16,22,52,49,3,46,55,19,36,30,NOVEMBER
SULAWESI BARAT,MAJENE,ULUMANDA,SAMBABO,54,20,18,2,1,0,0,9,0,5,0,1,5,5,0,1,14,8,6,2,11,6,5,6,18,18,0,8,NOVEMBER
SULAWESI BARAT,MAJENE,ULUMANDA,TANDEALLO,91,29,24,3,2,0,0,22,2,0,23,1,8,4,4,0,19,10,9,5,19,12,7,1,7,3,4,0,NOVEMBER
SULAWESI BARAT,MAJENE,ULUMANDA,ULUMANDA,85,76,20,1,0,0,0,11,4,1,8,2,11,10,1,7,62,51,11,2,44,23,21,8,74,40,34,11,NOVEMBER
SULAWESI BARAT,MAJENE,ULUMANDA,SALUTAMBUNG,97,59,36,0,0,0,0,7,8,20,27,4,10,7,3,3,19,7,12,2,5,4,1,3,5,4,1,1,NOVEMBER
SULAWESI BARAT,MAJENE,ULUMANDA,POPENGA,84,42,1,1,0,0,0,1,0,0,0,1,14,13,1,10,17,6,11,6,0,0,0,0,5,5,0,2,NOVEMBER
SULAWESI BARAT,MAJENE,ULUMANDA,SULAI,78,45,17,10,0,0,0,12,0,3,16,0,4,4,0,0,10,6,4,3,9,4,5,2,10,3,7,4,NOVEMBER
SULAWESI BARAT,MAJENE,ULUMANDA,PANGGALO,63,80,78,64,13,10,9,43,8,1,38,17,9,1,8,0,69,29,40,18,26,19,7,19,23,11,12,4,NOVEMBER
SULAWESI BARAT,MAMASA,ARALLE,ARALLE,61,30,16,9,6,6,0,16,0,0,14,0,9,1,8,0,26,23,3,18,1,1,0,0,20,10,10,3,NOVEMBER
SULAWESI BARAT,MAMASA,ARALLE,RALLE ANAK,64,17,7,0,0,0,0,0,5,0,5,2,9,3,6,1,12,8,4,4,3,1,2,0,13,0,13,3,NOVEMBER
SULAWESI BARAT,MAMASA,ARALLE,PANETEAN,55,80,57,44,1,0,0,55,1,0,14,17,9,3,6,0,65,30,35,25,14,1,13,1,28,18,10,11,NOVEMBER
SULAWESI BARAT,MAMASA,ARALLE,UHAILANU,34,64,17,16,2,0,0,3,13,1,5,0,3,1,2,1,55,6,49,6,23,16,7,13,3,2,1,3,NOVEMBER
SULAWESI BARAT,MAMASA,ARALLE,ARALLE UTARA,71,53,19,3,0,0,0,14,3,0,7,6,0,0,0,0,43,6,37,2,1,1,0,1,1,0,1,1,NOVEMBER
SULAWESI BARAT,MAMASA,ARALLE,UHAIDAHO,93,34,8,5,1,0,0,3,5,0,5,3,10,9,1,7,20,5,15,3,3,0,3,0,26,11,15,13,NOVEMBER
SULAWESI BARAT,MAMASA,ARALLE,BARURU,56,62,35,24,2,2,2,10,9,11,29,3,2,0,2,0,32,29,3,15,25,3,22,0,51,13,38,22,NOVEMBER
SULAWESI BARAT,MAMASA,ARALLE,RALLEANAK UTARA,77,58,45,7,6,2,0,0,14,17,28,9,11,3,8,3,24,5,19,2,1,0,1,0,8,0,8,5,NOVEMBER
SULAWESI BARAT,MAMASA,ARALLE,PAMOSEANG PANGGA,44,12,9,5,1,0,0,1,1,6,4,5,6,5,1,3,11,7,4,3,3,0,3,0,1,1,0,1,NOVEMBER
SULAWESI BARAT,MAMASA,ARALLE,KALABE,78,50,49,3,3,2,0,32,17,0,39,5,3,3,0,0,46,5,41,5,37,24,13,7,60,15,45,50,NOVEMBER
SULAWESI BARAT,MAMASA,ARALLE,ARALLE SELATAN,98,10,1,0,0,0,0,1,0,0,1,0,12,10,2,5,10,9,1,0,9,5,4,5,9,5,4,2,NOVEMBER
SULAWESI BARAT,MAMASA,ARALLE,HAHANGAN,48,31,7,3,3,3,2,3,0,2,4,2,1,0,1,0,21,21,0,16,0,0,0,0,7,6,1,7,NOVEMBER
SULAWESI BARAT,MAMASA,BALLA,BALLA,77,48,38,27,24,15,10,14,3,5,36,2,8,8,0,5,35,21,14,3,0,0,0,0,14,9,5,9,NOVEMBER
SULAWESI BARAT,MAMASA,BALLA,BALLA BARAT,53,16,15,7,6,2,2,12,0,1,9,2,6,0,6,0,10,8,2,5,6,1,5,1,5,3,2,1,NOVEMBER
SULAWESI BARAT,MAMASA,BALLA,BALLA SATANETEAN,90,27,21,3,0,0,0,18,0,0,10,5,11,1,10,0,23,19,4,5,20,17,3,10,15,12,3,11,NOVEMBER
SULAWESI BARAT,MAMASA,BALLA,BALLA TUMUKA,89,31,4,1,0,0,0,1,3,0,1,0,1,0,1,0,31,18,13,5,7,3,4,3,7,5,2,0,NOVEMBER
SULAWESI BARAT,MAMASA,BALLA,SEPAKUAN,64,18,9,3,2,0,0,1,7,1,5,4,2,1,1,1,17,8,9,3,0,0,0,0,11,1,10,4,NOVEMBER
SULAWESI BARAT,MAMASA,BALLA,PIDARA,72,58,29,5,4,4,1,28,0,0,0,28,7,0,7,0,21,10,11,10,21,19,2,16,22,20,2,15,NOVEMBER
SULAWESI BARAT,MAMASA,BALLA,BAMBAPUANG,70,16,4,0,0,0,0,3,1,0,2,2,10,8,2,2,11,11,0,8,1,1,0,0,1,1,0,0,NOVEMBER
SULAWESI BARAT,MAMASA,BALLA,BALLA TIMUR,94,34,32,5,4,0,0,1,4,20,2,7,10,3,7,1,21,15,6,14,15,0,15,0,11,0,11,11,NOVEMBER
SULAWESI BARAT,MAMASA,BAMBANG,MOKALLANG,35,67,52,14,1,1,0,9,9,0,32,3,4,4,0,4,55,20,35,15,26,7,19,3,20,5,15,19,NOVEMBER
SULAWESI BARAT,MAMASA,BAMBANG,MASOSO,86,39,36,16,1,0,0,12,15,3,26,8,1,0,1,0,15,7,8,5,11,4,7,2,2,1,1,0,NOVEMBER
SULAWESI BARAT,MAMASA,BAMBANG,SALUASSING,85,69,18,13,2,2,1,6,7,4,13,5,4,2,2,0,59,40,19,13,33,29,4,28,21,8,13,14,NOVEMBER
SULAWESI BARAT,MAMASA,BAMBANG,SALUBULO,69,12,7,7,6,0,0,3,3,1,0,0,1,0,1,0,10,10,0,2,9,2,7,2,13,9,4,7,NOVEMBER
SULAWESI BARAT,MAMASA,BAMBANG,SALUKADI,38,30,0,0,0,0,0,0,0,0,0,0,0,0,0,0,23,14,9,9,20,4,16,4,15,1,14,13,NOVEMBER
SULAWESI BARAT,MAMASA,BAMBANG,SALUKEPOPOK,59,78,6,6,3,1,0,5,0,0,0,5,1,0,1,0,48,22,26,9,11,8,3,0,46,29,17,0,NOVEMBER
SULAWESI BARAT,MAMASA,BAMBANG,ULUMAMBI BARAT,57,52,6,4,3,3,1,3,2,0,1,0,4,3,1,3,52,52,0,3,33,22,11,10,53,31,22,53,NOVEMBER
SULAWESI BARAT,MAMASA,BAMBANG,LIMBADEBATA,73,77,41,0,0,0,0,33,7,0,35,6,7,5,2,3,19,19,0,13,7,4,3,2,33,31,2,30,NOVEMBER
SULAWESI BARAT,MAMASA,BAMBANG,TANETE TOMBA,93,11,4,2,2,2,1,3,0,0,2,2,8,2,6,0,10,5,5,5,9,6,3,3,10,7,3,10,NOVEMBER
SULAWESI BARAT,MAMASA,BAMBANG,BAMBANG,88,48,21,7,2,0,0,11,3,4,20,0,12,6,6,2,17,17,0,17,7,6,1,6,31,14,17,0,NOVEMBER
SULAWESI BARAT,MAMASA,BAMBANG,RANTELEMO,99,80,76,30,6,6,2,3,53,11,27,33,0,0,0,0,13,11,2,1,0,0,0,0,12,11,1,5,NOVEMBER
SULAWESI BARAT,MAMASA,BAMBANG,SALUDENGEN,31,55,28,2,0,0,0,24,4,0,0,18,3,3,0,3,20,18,2,0,0,0,0,0,19,13,6,18,NOVEMBER
SULAWESI BARAT,MAMASA,BAMBANG,ULUMAMBI,64,10,10,9,2,0,0,1,8,1,2,1,2,0,2,0,10,7,3,6,3,1,2,1,10,4,6,4,NOVEMBER
SULAWESI BARAT,MAMASA,BAMBANG,BAMBANG TIMUR,91,46,42,18,18,3,2,9,5,4,19,3,15,4,11,1,34,29,5,6,15,1,14,0,26,17,9,19,NOVEMBER
SULAWESI BARAT,MAMASA,BAMBANG,MINANGA,66,51,40,17,8,7,1,1,4,6,24,1,3,3,0,3,28,26,2,9,4,0,4,0,37,32,5,15,NOVEMBER
SULAWESI BARAT,MAMASA,BAMBANG,SIKAMASE,37,50,50,48,40,8,2,39,4,2,1,0,1,0,1,0,28,18,10,0,14,11,3,0,47,15,32,0,NOVEMBER
SULAWESI BARAT,MAMASA,BAMBANG,RANTETARIMA,72,39,0,0,0,0,0,0,0,0,0,0,6,5,1,4,36,27,9,21,34,7,27,3,5,3,2,3,NOVEMBER
SULAWESI BARAT,MAMASA,BAMBANG,SALURURU,68,67,63,24,0,0,0,43,19,1,56,4,0,0,0,0,37,33,4,1,3,1,2,1,40,38,2,4,NOVEMBER
SULAWESI BARAT,MAMASA,BAMBANG,SALUTABANG,78,79,47,39,23,22,4,9,34,0,6,9,2,2,0,0,16,12,4,10,9,8,1,8,54,17,37,7,NOVEMBER
SULAWESI BARAT,MAMASA,BAMBANG,BALATANA,33,18,7,3,1,1,1,5,0,0,0,6,6,4,2,0,18,16,2,5,5,1,4,1,11,4,7,4,NOVEMBER
SULAWESI BARAT,MAMASA,BUNTUMALANGKA,BUNTUMALANGKA,98,55,1,0,0,0,0,1,0,0,0,0,18,13,5,12,27,8,19,2,12,5,7,0,1,0,1,1,NOVEMBER
SULAWESI BARAT,MAMASA,BUNTUMALANGKA,RANTEBERAN,61,71,11,4,2,1,0,6,3,0,7,1,5,1,4,1,24,14,10,6,14,8,6,7,62,49,13,40,NOVEMBER
SULAWESI BARAT,MAMASA,BUNTUMALANGKA,KEBANGA,95,32,13,7,0,0,0,6,7,0,0,8,9,7,2,2,17,15,2,10,5,0,5,0,17,14,3,1,NOVEMBER
SULAWESI BARAT,MAMASA,BUNTUMALANGKA,SALURINDU,68,48,14,8,6,3,0,8,3,3,11,3,9,5,4,0,44,18,26,17,44,25,19,10,55,12,43,8,NOVEMBER
SULAWESI BARAT,MAMASA,BUNTUMALANGKA,TAORA,92,17,12,6,1,0,0,2,10,0,0,11,7,5,2,3,10,9,1,3,8,8,0,3,9,9,0,1,NOVEMBER
SULAWESI BARAT,MAMASA,BUNTUMALANGKA,KABAE,68,73,9,3,0,0,0,2,5,2,7,2,1,0,1,0,35,16,19,9,22,13,9,10,41,13,28,21,NOVEMBER
SULAWESI BARAT,MAMASA,BUNTUMALANGKA,SALUTAMBUN BARAT,63,79,6,4,2,0,0,0,0,0,6,0,0,0,0,0,59,59,0,27,15,9,6,6,0,0,0,0,NOVEMBER
SULAWESI BARAT,MAMASA,BUNTUMALANGKA,PENATANGAN,57,51,24,22,10,2,1,14,3,0,24,0,10,5,5,1,15,6,9,0,4,2,2,0,23,19,4,23,NOVEMBER
SULAWESI BARAT,MAMASA,BUNTUMALANGKA,SALUTAMBUN TIMUR,86,39,26,12,5,0,0,1,21,3,21,4,6,4,2,1,13,7,6,3,10,6,4,2,12,11,1,3,NOVEMBER
SULAWESI BARAT,MAMASA,BUNTUMALANGKA,SALUTAMBUN,45,44,41,39,14,11,6,17,7,2,37,4,2,1,1,0,23,8,15,3,16,15,1,13,26,6,20,4,NOVEMBER
SULAWESI BARAT,MAMASA,BUNTUMALANGKA,ARALLE TIMUR,76,25,8,8,5,5,5,2,0,0,8,0,9,8,1,4,23,15,8,2,15,5,10,0,16,9,7,9,NOVEMBER
SULAWESI BARAT,MAMASA,MAMASA,MAMASA,37,21,15,14,4,0,0,6,2,6,0,13,1,0,1,0,12,6,6,6,8,4,4,4,4,1,3,4,NOVEMBER
SULAWESI BARAT,MAMASA,MAMASA,RAMBUSARATU,88,67,21,4,3,1,1,12,5,1,6,11,10,4,6,2,35,28,7,16,31,10,21,8,42,8,34,11,NOVEMBER
SULAWESI BARAT,MAMASA,MAMASA,OSANGO,38,39,16,0,0,0,0,8,5,2,4,2,5,0,5,0,10,9,1,7,4,1,3,0,8,5,3,8,NOVEMBER
SULAWESI BARAT,MAMASA,MAMASA,LAMBANAN,45,13,13,3,0,0,0,9,0,1,10,0,3,0,3,0,10,8,2,7,5,1,4,1,8,0,8,2,NOVEMBER
SULAWESI BARAT,MAMASA,MAMASA,LEMBANA SALULO,54,26,8,5,3,3,3,5,0,0,6,0,8,0,8,0,13,10,3,4,9,8,1,7,19,2,17,8,NOVEMBER
SULAWESI BARAT,MAMASA,MAMASA,TAUPE,74,32,18,11,9,8,1,5,4,8,15,2,5,1,4,1,19,16,3,7,4,0,4,0,7,5,2,4,NOVEMBER
SULAWESI BARAT,MAMASA,MAMASA,BUNTU BUDA,84,68,0,0,0,0,0,0,0,0,0,0,7,4,3,2,52,22,30,18,19,15,4,12,42,32,10,28,NOVEMBER
SULAWESI BARAT,MAMASA,MAMASA,TONDOK BAKARU,60,69,36,2,1,0,0,33,2,0,31,1,2,1,1,1,10,8,2,6,8,3,5,1,30,7,23,2,NOVEMBER
SULAWESI BARAT,MAMASA,MAMASA,PEBASSIAN,79,39,11,3,0,0,0,2,9,0,2,6,0,0,0,0,29,22,7,3,0,0,0,0,15,1,14,7,NOVEMBER
SULAWESI BARAT,MAMASA,MAMASA,MAMBULILING,68,61,15,4,4,1,0,13,0,2,9,4,9,6,3,3,15,12,3,2,10,2,8,0,8,3,5,3,NOVEMBER
SULAWESI BARAT,MAMASA,MAMASA,BOMBONG LAMBE,92,29,19,10,10,0,0,15,1,3,8,11,3,0,3,0,26,26,0,12,15,8,7,1,11,6,5,9,NOVEMBER
SULAWESI BARAT,MAMASA,MAMASA,BUBUN BATU,44,76,34,30,29,18,4,1,23,0,8,3,5,2,3,1,51,49,2,49,39,29,10,15,47,1,46,29,NOVEMBER
SULAWESI BARAT,MAMASA,MAMBI,MAMBI,83,26,11,6,2,0,0,9,0,0,8,1,2,0,2,0,17,11,6,9,17,13,4,6,20,3,17,1,NOVEMBER
SULAWESI BARAT,MAMASA,MAMBI,TALIPUKKI,66,23,20,6,3,2,0,10,8,2,7,5,3,2,1,0,22,14,8,2,20,8,12,5,24,11,13,3,NOVEMBER
SULAWESI BARAT,MAMASA,MAMBI,RANTEBULAHAN,53,50,2,0,0,0,0,0,2,0,0,1,5,4,1,4,33,7,26,2,31,17,14,11,9,8,1,7,NOVEMBER
SULAWESI BARAT,MAMASA,MAMBI,SONDONGLAYU,34,32,11,6,1,0,0,11,0,0,7,3,1,1,0,1,28,5,23,2,24,1,23,1,22,13,9,7,NOVEMBER
SULAWESI BARAT,MAMASA,MAMBI,SALUBANUA,97,46,24,21,10,8,4,6,13,0,4,9,14,13,1,8,26,10,16,9,7,6,1,3,35,13,22,0,NOVEMBER
SULAWESI BARAT,MAMASA,MAMBI,TAPALINA,62,44,43,9,8,5,0,10,17,10,42,1,5,1,4,1,32,11,21,1,15,11,4,11,24,8,16,23,NOVEMBER
SULAWESI BARAT,MAMASA,MAMBI,SENDANA,61,22,5,3,1,0,0,4,0,0,4,0,12,4,8,3,14,13,1,8,3,0,3,0,5,2,3,4,NOVEMBER
SULAWESI BARAT,MAMASA,MAMBI,PAMOSEAN,34,79,31,17,11,4,0,20,2,9,22,9,5,4,1,0,71,12,59,12,43,28,15,1,78,74,4,11,NOVEMBER
SULAWESI BARAT,MAMASA,MAMBI,SELUMAKA,67,26,22,1,1,0,0,5,0,16,19,0,7,6,1,2,24,14,10,1,15,7,8,6,8,4,4,6,NOVEMBER
SULAWESI BARAT,MAMASA,MAMBI,BUJUNG MANURUNG,37,56,47,30,14,14,9,12,17,6,21,18,7,0,7,0,21,8,13,3,2,0,2,0,33,5,28,28,NOVEMBER
SULAWESI BARAT,MAMASA,MAMBI,SALU ALO,36,35,31,31,11,10,3,18,5,1,8,23,6,5,1,3,23,13,10,1,0,0,0,0,13,1,12,9,NOVEMBER
SULAWESI BARAT,MAMASA,MAMBI,INDOBANUA,58,35,33,31,11,8,8,2,9,3,26,4,8,0,8,0,24,17,7,17,10,4,6,0,15,3,12,6,NOVEMBER
SULAWESI BARAT,MAMASA,MAMBI,SALUDURIAN,31,68,19,11,1,1,1,0,13,2,1,0,3,3,0,0,27,16,11,14,10,5,5,0,1,1,0,1,NOVEMBER
SULAWESI BARAT,MAMASA,MEHALAAN,MEHALAAN,76,44,7,0,0,0,0,6,1,0,4,3,4,1,3,1,26,5,21,5,25,7,18,1,31,17,14,2,NOVEMBER
SULAWESI BARAT,MAMASA,MEHALAAN,BOTTENG,94,12,9,9,2,1,0,9,0,0,2,0,9,4,5,1,11,11,0,6,4,1,3,1,0,0,0,0,NOVEMBER
SULAWESI BARAT,MAMASA,MEHALAAN,SALUKONTA,45,53,12,7,7,5,2,2,0,3,4,7,3,3,0,2,51,14,37,5,31,24,7,19,6,3,3,6,NOVEMBER
SULAWESI BARAT,MAMASA,MEHALAAN,MESAKADA,68,46,24,10,8,6,1,0,7,12,21,3,8,5,3,5,10,9,1,2,7,6,1,3,28,21,7,20,NOVEMBER
SULAWESI BARAT,MAMASA,MEHALAAN,MEHALAAN BARAT,39,51,14,1,1,0,0,5,3,0,12,1,1,1,0,1,44,42,2,0,22,18,4,1,45,38,7,34,NOVEMBER
SULAWESI BARAT,MAMASA,MEHALAAN,SALUAHOK,47,22,11,3,2,2,2,7,2,0,11,0,2,2,0,1,18,13,5,10,1,1,0,0,14,10,4,5,NOVEMBER
SULAWESI BARAT,MAMASA,MEHALAAN,SALUBALO,86,61,32,8,0,0,0,22,7,1,26,1,15,7,8,0,17,6,11,1,11,3,8,3,25,20,5,13,NOVEMBER
SULAWESI BARAT,MAMASA,MEHALAAN,PASSEMBUK,98,41,28,7,5,0,0,24,3,0,15,8,11,9,2,5,25,24,1,21,6,2,4,2,33,10,23,10,NOVEMBER
SULAWESI BARAT,MAMASA,MEHALAAN,KONDO,39,75,65,31,12,11,9,12,39,0,54,0,7,3,4,3,33,23,10,8,8,2,6,1,21,4,17,3,NOVEMBER
SULAWESI BARAT,MAMASA,MEHALAAN,LEKO SUKAMAJU,44,38,23,7,1,0,0,22,0,0,2,0,8,1,7,1,22,19,3,12,1,0,1,0,18,14,4,1,NOVEMBER
SULAWESI BARAT,MAMASA,MEHALAAN,ULUMEA,30,29,25,8,8,2,0,25,0,0,11,10,1,0,1,0,12,8,4,2,9,4,5,1,17,2,15,0,NOVEMBER
SULAWESI BARAT,MAMASA,MESSAWA,MESSAWA,68,22,12,9,3,3,2,8,1,0,0,8,3,2,1,2,22,11,11,6,11,2,9,1,21,13,8,1,NOVEMBER
SULAWESI BARAT,MAMASA,MESSAWA,RIPPUNG,74,42,30,22,2,2,0,7,2,5,24,6,10,5,5,0,35,26,9,11,26,13,13,10,51,24,27,41,NOVEMBER
SULAWESI BARAT,MAMASA,MESSAWA,MAKUANG,42,28,16,13,10,8,6,4,1,5,2,14,0,0,0,0,23,19,4,0,23,17,6,6,28,15,13,11,NOVEMBER
SULAWESI BARAT,MAMASA,MESSAWA,SEPANG,99,70,33,3,2,2,2,28,1,1,2,28,13,0,13,0,49,37,12,13,42,40,2,33,70,15,55,25,NOVEMBER
SULAWESI BARAT,MAMASA,MESSAWA,MALIMBONG,62,80,4,4,3,2,0,4,0,0,4,0,1,1,0,0,61,10,51,7,58,39,19,8,14,13,1,13,NOVEMBER
SULAWESI BARAT,MAMASA,MESSAWA,MATANDE,98,30,26,20,13,10,9,15,0,1,14,3,11,9,2,6,25,13,12,2,22,5,17,2,27,25,2,20,NOVEMBER
SULAWESI BARAT,MAMASA,MESSAWA,SIPAI,51,76,51,13,12,11,3,21,27,0,27,11,8,0,8,0,66,30,36,10,26,21,5,7,77,34,43,5,NOVEMBER
SULAWESI BARAT,MAMASA,MESSAWA,PASMA MAMBU,77,65,28,16,16,5,1,21,0,4,14,1,0,0,0,0,47,31,16,23,42,8,34,4,55,38,17,48,NOVEMBER
SULAWESI BARAT,MAMASA,MESSAWA,TANETE BATU,40,71,44,9,7,7,4,35,5,0,23,15,1,1,0,0,59,29,30,4,50,25,25,2,13,3,10,6,NOVEMBER
SULAWESI BARAT,MAMASA,NOSU,NOSU,67,51,21,5,3,3,0,10,7,1,4,13,9,4,5,2,34,8,26,7,24,22,2,11,47,18,29,39,NOVEMBER
SULAWESI BARAT,MAMASA,NOSU,MINANGA,34,18,15,12,5,2,2,12,1,0,5,4,2,0,2,0,10,10,0,8,10,4,6,0,18,6,12,18,NOVEMBER
SULAWESI BARAT,MAMASA,NOSU,BATUPAPAN,44,76,50,22,9,8,4,11,7,15,38,10,2,2,0,1,51,8,43,4,39,2,37,2,75,29,46,31,NOVEMBER
SULAWESI BARAT,MAMASA,NOSU,MASEWWE,51,11,0,0,0,0,0,0,0,0,0,0,10,9,1,4,10,8,2,7,4,0,4,0,0,0,0,0,NOVEMBER
SULAWESI BARAT,MAMASA,NOSU,SIWI,58,39,11,0,0,0,0,3,7,1,3,3,11,7,4,2,10,8,2,1,4,3,1,0,9,0,9,3,NOVEMBER
SULAWESI BARAT,MAMASA,NOSU,MINANGA TIMUR,59,51,39,8,7,6,4,9,4,6,28,4,5,1,4,1,41,5,36,3,18,5,13,2,40,24,16,14,NOVEMBER
SULAWESI BARAT,MAMASA,NOSU,PARINDING,92,30,11,0,0,0,0,7,3,1,1,0,15,6,9,6,16,10,6,0,3,0,3,0,14,5,9,13,NOVEMBER
SULAWESI BARAT,MAMASA,PANA,PANA,66,61,3,3,2,0,0,1,1,1,2,0,4,3,1,0,15,8,7,2,3,0,3,0,1,0,1,1,NOVEMBER
SULAWESI BARAT,MAMASA,PANA,MANIPI,53,15,11,2,1,1,0,3,7,0,7,3,7,3,4,0,14,8,6,0,10,0,10,0,7,3,4,2,NOVEMBER
SULAWESI BARAT,MAMASA,PANA,MAMULLU,63,79,3,2,0,0,0,3,0,0,2,1,12,2,10,0,36,12,24,4,14,11,3,5,2,0,2,0,NOVEMBER
SULAWESI BARAT,MAMASA,PANA,SAPAN,98,60,57,49,19,10,5,39,4,1,24,28,0,0,0,0,24,22,2,16,24,2,22,1,55,46,9,12,NOVEMBER
SULAWESI BARAT,MAMASA,PANA,DATUBARINGAN,92,32,12,12,11,4,0,2,6,2,3,2,11,7,4,5,16,9,7,4,0,0,0,0,19,10,9,8,NOVEMBER
SULAWESI BARAT,MAMASA,PANA,PANURA,78,13,4,1,0,0,0,2,0,0,0,2,9,7,2,7,12,5,7,4,4,2,2,0,13,5,8,8,NOVEMBER
SULAWESI BARAT,MAMASA,PANA,TALLANG BULAWAN,36,14,2,2,0,0,0,0,1,1,0,1,2,2,0,2,11,7,4,3,0,0,0,0,4,4,0,3,NOVEMBER
SULAWESI BARAT,MAMASA,PANA,KARAKA,58,45,21,14,10,5,5,8,3,3,1,20,10,0,10,0,28,14,14,6,26,21,5,14,22,14,8,15,NOVEMBER
SULAWESI BARAT,MAMASA,PANA,ULUSALU,92,73,69,26,22,17,10,25,2,1,33,4,16,13,3,12,32,6,26,5,11,0,11,0,7,2,5,6,NOVEMBER
SULAWESI BARAT,MAMASA,PANA,WERI,38,29,27,11,2,0,0,1,23,2,15,0,1,1,0,0,17,13,4,1,11,9,2,8,3,3,0,0,NOVEMBER
SULAWESI BARAT,MAMASA,PANA,SALUTAMBUN,35,75,64,36,36,8,8,39,11,0,0,29,5,2,3,0,27,15,12,14,4,1,3,1,38,36,2,5,NOVEMBER
SULAWESI BARAT,MAMASA,PANA,SALOAN,55,72,35,15,15,1,1,5,21,5,1,16,4,1,3,0,10,9,1,4,4,0,4,0,7,2,5,4,NOVEMBER
SULAWESI BARAT,MAMASA,PANA,ULUSALU INDAH,81,73,1,0,0,0,0,1,0,0,0,1,8,3,5,2,48,6,42,1,0,0,0,0,31,6,25,0,NOVEMBER
SULAWESI BARAT,MAMASA,RANTEBULAHAN TIMUR,SALUMOKANAN,43,50,11,6,3,1,0,4,7,0,10,1,1,1,0,0,42,31,11,4,39,29,10,26,74,37,37,18,NOVEMBER
SULAWESI BARAT,MAMASA,RANTEBULAHAN TIMUR,SALUMOKANAN BARAT,39,70,10,9,8,4,4,5,0,1,6,0,7,4,3,2,66,61,5,3,44,41,3,27,44,26,18,30,NOVEMBER
SULAWESI BARAT,MAMASA,RANTEBULAHAN TIMUR,BUANGIN,53,73,62,55,36,5,1,30,8,13,40,0,2,2,0,1,31,13,18,3,26,14,12,10,40,17,23,7,NOVEMBER
SULAWESI BARAT,MAMASA,RANTEBULAHAN TIMUR,BAMBANG BUDA,37,48,0,0,0,0,0,0,0,0,0,0,2,0,2,0,25,25,0,22,25,1,24,1,9,4,5,4,NOVEMBER
SULAWESI BARAT,MAMASA,RANTEBULAHAN TIMUR,LEKO,46,54,11,1,1,0,0,1,7,2,7,4,5,1,4,1,34,24,10,6,33,19,14,17,15,2,13,0,NOVEMBER
SULAWESI BARAT,MAMASA,RANTEBULAHAN TIMUR,KIRAK,56,35,20,2,0,0,0,18,2,0,15,0,5,1,4,0,15,15,0,12,12,8,4,5,13,3,10,5,NOVEMBER
SULAWESI BARAT,MAMASA,RANTEBULAHAN TIMUR,SALUMOKANAN UTARA,57,42,7,2,1,0,0,2,0,5,4,0,3,2,1,2,33,6,27,5,29,2,27,0,16,11,5,7,NOVEMBER
SULAWESI BARAT,MAMASA,RANTEBULAHAN TIMUR,SAMPALE,65,41,22,1,1,0,0,17,1,4,1,21,12,4,8,4,11,6,5,0,8,6,2,2,2,1,1,0,NOVEMBER
SULAWESI BARAT,MAMASA,SESENAPADANG,OROBUA,80,45,7,5,4,2,1,4,0,1,5,0,15,7,8,5,27,26,1,6,4,0,4,0,7,6,1,4,NOVEMBER
SULAWESI BARAT,MAMASA,SESENAPADANG,PALADAN,90,54,17,16,13,7,5,12,0,0,17,0,11,9,2,6,42,6,36,2,13,0,13,0,20,3,17,9,NOVEMBER
SULAWESI BARAT,MAMASA,SESENAPADANG,OROBUA TIMUR,73,70,58,27,7,7,2,42,6,6,49,5,11,11,0,2,22,12,10,3,19,13,6,4,39,16,23,26,NOVEMBER
SULAWESI BARAT,MAMASA,SESENAPADANG,RANTE PUANG,43,30,28,21,7,2,1,18,1,6,9,3,8,8,0,6,10,5,5,0,3,1,2,0,20,3,17,16,NOVEMBER
SULAWESI BARAT,MAMASA,SESENAPADANG,SATENETEAN,46,51,11,4,4,0,0,9,0,1,9,2,7,0,7,0,44,24,20,10,34,15,19,10,2,0,2,0,NOVEMBER
SULAWESI BARAT,MAMASA,SESENAPADANG,LISUAN ADA,95,59,48,28,17,7,4,43,1,0,30,6,16,15,1,15,57,21,36,19,16,5,11,3,17,0,17,9,NOVEMBER
SULAWESI BARAT,MAMASA,SESENAPADANG,OROBUA SELATAN,52,16,10,10,3,3,2,8,0,0,7,1,1,0,1,0,15,12,3,11,0,0,0,0,3,2,1,0,NOVEMBER
SULAWESI BARAT,MAMASA,SESENAPADANG,MALANGKENA PADANG,51,57,14,10,5,5,3,8,0,1,4,7,9,0,9,0,40,39,1,25,25,24,1,10,3,2,1,0,NOVEMBER
SULAWESI BARAT,MAMASA,SESENAPADANG,MALIMBONG,65,65,46,22,13,12,7,2,26,1,36,0,1,0,1,0,42,42,0,15,8,5,3,1,23,10,13,0,NOVEMBER
SULAWESI BARAT,MAMASA,SESENAPADANG,MARAMPAN OROBUA,79,75,9,7,5,1,1,7,1,0,7,2,2,1,1,0,45,18,27,2,37,19,18,5,19,8,11,16,NOVEMBER
SULAWESI BARAT,MAMASA,SUMARORONG,SUMARORONG,36,16,2,1,0,0,0,0,0,0,2,0,6,5,1,1,15,7,8,7,14,6,8,3,12,10,2,1,NOVEMBER
SULAWESI BARAT,MAMASA,SUMARORONG,TABONE,39,45,17,8,3,0,0,14,1,0,14,0,7,5,2,5,29,27,2,27,10,10,0,3,27,7,20,22,NOVEMBER
SULAWESI BARAT,MAMASA,SUMARORONG,BATANG URU,94,69,35,16,13,1,0,23,11,0,30,5,4,3,1,0,10,7,3,2,10,10,0,9,36,27,9,3,NOVEMBER
SULAWESI BARAT,MAMASA,SUMARORONG,SASAKAN,89,33,5,4,4,0,0,0,2,2,5,0,2,2,0,2,24,13,11,12,14,5,9,5,16,4,12,3,NOVEMBER
SULAWESI BARAT,MAMASA,SUMARORONG,TADISI,38,67,12,6,4,3,0,5,2,1,3,8,4,4,0,1,57,55,2,0,9,5,4,3,0,0,0,0,NOVEMBER
SULAWESI BARAT,MAMASA,SUMARORONG,SIBANAWA,47,50,48,28,5,1,1,41,5,0,46,1,6,4,2,4,45,10,35,9,41,19,22,17,33,1,32,6,NOVEMBER
SULAWESI BARAT,MAMASA,SUMARORONG,BATANGNGURU TIMUR,44,12,10,10,5,0,0,1,1,6,10,0,4,2,2,2,11,8,3,6,5,2,3,0,11,3,8,1,NOVEMBER
SULAWESI BARAT,MAMASA,SUMARORONG,SALUBALO,81,46,27,4,2,1,0,2,25,0,16,7,9,7,2,4,11,8,3,5,1,0,1,0,17,9,8,10,NOVEMBER
SULAWESI BARAT,MAMASA,SUMARORONG,BANEA,46,73,40,34,28,22,14,0,0,1,13,11,8,8,0,1,27,19,8,19,12,8,4,3,5,4,1,4,NOVEMBER
SULAWESI BARAT,MAMASA,SUMARORONG,RANTE KAMASE,69,67,48,30,15,6,6,34,8,0,35,5,1,0,1,0,16,15,1,1,14,8,6,5,57,19,38,22,NOVEMBER
SULAWESI BARAT,MAMASA,TABANG,TABANG,75,75,28,24,12,4,2,23,3,0,14,10,10,10,0,9,72,12,60,5,43,6,37,2,4,4,0,1,NOVEMBER
SULAWESI BARAT,MAMASA,TABANG,TADOKALUA,42,31,26,4,0,0,0,7,15,2,8,17,1,0,1,0,14,7,7,1,1,1,0,0,16,0,16,12,NOVEMBER
SULAWESI BARAT,MAMASA,TABANG,TABANG BARAT,76,49,22,8,1,0,0,13,8,1,4,7,2,2,0,1,29,10,19,2,26,26,0,4,51,26,25,6,NOVEMBER
SULAWESI BARAT,MAMASA,TABANG,MASUPU,46,65,50,47,46,10,1,49,0,0,11,27,7,3,4,2,57,46,11,0,27,11,16,9,20,5,15,6,NOVEMBER
SULAWESI BARAT,MAMASA,TABANG,KALAMA,73,26,20,2,0,0,0,5,0,4,13,5,10,9,1,8,16,16,0,13,10,10,0,5,26,4,22,17,NOVEMBER
SULAWESI BARAT,MAMASA,TABANG,BAKADISURA,36,64,37,18,9,9,2,1,14,13,32,1,2,2,0,2,43,12,31,3,30,14,16,10,13,9,4,6,NOVEMBER
SULAWESI BARAT,MAMASA,TABANG,SALUKONA,35,71,33,21,19,0,0,13,10,10,22,5,0,0,0,0,17,9,8,4,7,1,6,0,37,28,9,30,NOVEMBER
SULAWESI BARAT,MAMASA,TABULAHAN,LAKAHANG,50,74,54,25,15,11,8,10,35,0,47,5,2,0,2,0,55,8,47,6,0,0,0,0,16,3,13,13,NOVEMBER
SULAWESI BARAT,MAMASA,TABULAHAN,PERIANGAN,51,20,15,12,9,1,0,8,3,4,4,2,6,3,3,2,18,17,1,3,9,5,4,3,12,6,6,10,NOVEMBER
SULAWESI BARAT,MAMASA,TABULAHAN,MALATIRO,77,24,20,7,7,0,0,5,13,1,3,17,1,0,1,0,13,5,8,3,8,1,7,0,3,1,2,0,NOVEMBER
SULAWESI BARAT,MAMASA,TABULAHAN,TABULAHAN,95,75,49,1,0,0,0,36,9,4,6,40,18,18,0,12,75,64,11,32,24,18,6,15,76,65,11,64,NOVEMBER
SULAWESI BARAT,MAMASA,TABULAHAN,SALULEANG,91,44,13,0,0,0,0,12,1,0,5,6,4,2,2,2,11,5,6,3,8,6,2,3,15,8,7,0,NOVEMBER
SULAWESI BARAT,MAMASA,TABULAHAN,TAMPAK KURRA,37,46,46,15,6,2,2,25,9,2,19,26,5,0,5,0,14,7,7,7,1,1,0,0,17,10,7,13,NOVEMBER
SULAWESI BARAT,MAMASA,TABULAHAN,GANDANG DEWATA,82,70,63,50,45,7,7,37,13,3,8,54,12,5,7,2,64,55,9,17,2,0,2,0,33,9,24,7,NOVEMBER
SULAWESI BARAT,MAMASA,TABULAHAN,BURANA,58,26,16,6,0,0,0,14,0,0,6,1,2,2,0,0,17,17,0,1,4,4,0,3,15,11,4,4,NOVEMBER
SULAWESI BARAT,MAMASA,TABULAHAN,SALUBAKKA,64,43,36,19,6,2,0,0,1,16,12,17,10,6,4,0,39,6,33,2,22,19,3,15,42,7,35,36,NOVEMBER
SULAWESI BARAT,MAMASA,TABULAHAN,PANGANDARAN,59,30,5,2,1,1,1,1,1,2,3,2,2,0,2,0,25,6,19,4,8,4,4,0,23,4,19,17,NOVEMBER
SULAWESI BARAT,MAMASA,TABULAHAN,TALOPAK,98,27,11,5,5,3,1,6,1,1,11,0,19,19,0,13,17,6,11,5,3,2,1,2,13,1,12,10,NOVEMBER
SULAWESI BARAT,MAMASA,TABULAHAN,PEU',83,59,3,3,0,0,0,3,0,0,2,1,0,0,0,0,10,6,4,0,7,6,1,6,1,1,0,1,NOVEMBER
SULAWESI BARAT,MAMASA,TABULAHAN,TIMORO,76,38,32,12,2,2,0,29,3,0,27,3,8,5,3,4,38,36,2,5,17,2,15,2,15,15,0,14,NOVEMBER
SULAWESI BARAT,MAMASA,TABULAHAN,LAKAHANG UTAMA,49,13,7,2,2,0,0,7,0,0,5,1,9,3,6,1,10,8,2,3,5,5,0,0,13,10,3,12,NOVEMBER
SULAWESI BARAT,MAMASA,TANDUK KALUA,MINAKE,97,59,29,8,5,4,4,11,14,0,17,2,7,4,3,4,45,41,4,40,15,3,12,1,9,7,2,4,NOVEMBER
SULAWESI BARAT,MAMASA,TANDUK KALUA,MALABO,89,10,5,3,1,1,1,2,2,0,3,2,10,4,6,0,10,9,1,2,7,7,0,6,10,8,2,4,NOVEMBER
SULAWESI BARAT,MAMASA,TANDUK KALUA,SINDAGAMANIK,41,44,42,6,1,1,1,28,1,8,40,0,5,3,2,0,29,20,9,17,24,2,22,2,2,1,1,1,NOVEMBER
SULAWESI BARAT,MAMASA,TANDUK KALUA,PARONDOBULAWAN,56,43,36,5,2,1,0,22,9,1,3,19,7,3,4,3,13,11,2,8,7,6,1,0,8,6,2,3,NOVEMBER
SULAWESI BARAT,MAMASA,TANDUK KALUA,TAMALANTIK,36,57,0,0,0,0,0,0,0,0,0,0,5,5,0,4,30,17,13,4,1,0,1,0,10,10,0,10,NOVEMBER
SULAWESI BARAT,MAMASA,TANDUK KALUA,MANNABABA,72,78,54,5,3,2,1,1,34,7,11,9,10,2,8,0,68,22,46,4,9,9,0,0,46,8,38,15,NOVEMBER
SULAWESI BARAT,MAMASA,TANDUK KALUA,MESAKADA,98,80,62,0,0,0,0,61,0,0,51,2,6,4,2,4,28,20,8,2,1,0,1,0,10,9,1,10,NOVEMBER
SULAWESI BARAT,MAMASA,TANDUK KALUA,BALLABATU,86,31,30,21,1,1,0,9,10,2,19,3,7,2,5,2,25,19,6,11,24,23,1,14,4,3,1,4,NOVEMBER
SULAWESI BARAT,MAMASA,TANDUK KALUA,PAMBE,42,17,0,0,0,0,0,0,0,0,0,0,4,3,1,0,17,6,11,3,0,0,0,0,9,4,5,9,NOVEMBER
SULAWESI BARAT,MAMASA,TANDUK KALUA,SALURANO,73,48,7,2,1,0,0,7,0,0,5,1,5,5,0,3,21,20,1,11,19,11,8,1,23,20,3,22,NOVEMBER
SULAWESI BARAT,MAMASA,TANDUK KALUA,TALIMBUNG,47,66,37,34,6,4,1,29,3,0,0,32,2,2,0,2,37,35,2,25,18,15,3,11,8,2,6,2,NOVEMBER
SULAWESI BARAT,MAMASA,TANDUK KALUA,KANAN,90,31,8,3,1,0,0,3,3,0,3,2,8,8,0,3,14,13,1,3,9,1,8,1,22,15,7,9,NOVEMBER
SULAWESI BARAT,MAMASA,TAWALIAN,TAWALIAN,37,56,19,16,4,0,0,5,9,1,11,0,5,5,0,0,46,41,5,28,2,2,0,2,9,9,0,2,NOVEMBER
SULAWESI BARAT,MAMASA,TAWALIAN,TAWALIAN TIMUR,56,28,8,4,2,2,0,6,2,0,0,8,5,4,1,4,17,10,7,5,11,6,5,6,4,0,4,2,NOVEMBER
SULAWESI BARAT,MAMASA,TAWALIAN,KARIANGO,72,70,6,6,1,1,1,2,3,0,2,1,5,4,1,3,11,5,6,0,11,7,4,2,46,10,36,31,NOVEMBER
SULAWESI BARAT,MAMASA,TAWALIAN,RANTETANGNGA,80,75,65,40,2,2,2,28,25,0,64,1,6,4,2,1,34,12,22,11,7,0,7,0,15,7,8,4,NOVEMBER
SULAWESI BARAT,POLEWALI MANDAR,ALLU,PETOOSANG,80,23,7,4,4,4,1,2,4,0,4,1,13,6,7,0,15,10,5,1,7,5,2,0,5,1,4,3,NOVEMBER
SULAWESI BARAT,POLEWALI MANDAR,ALLU,MOMBI,32,21,7,6,5,0,0,5,1,0,3,0,3,1,2,0,11,10,1,0,11,4,7,4,23,12,11,7,NOVEMBER
SULAWESI BARAT,POLEWALI MANDAR,ALLU,KALUMAMMANG,48,34,32,24,0,0,0,20,3,6,0,8,3,1,2,1,34,5,29,1,26,7,19,6,25,15,10,5,NOVEMBER
SULAWESI BARAT,POLEWALI MANDAR,ALLU,PAO-PAO,87,15,9,6,6,6,2,2,5,0,0,4,5,0,5,0,15,8,7,0,0,0,0,0,0,0,0,0,NOVEMBER
SULAWESI BARAT,POLEWALI MANDAR,ALLU,PUPPU URING,98,48,32,10,4,4,4,14,4,4,15,1,17,10,7,9,34,28,6,7,33,21,12,19,60,9,51,24,NOVEMBER
SULAWESI BARAT,POLEWALI MANDAR,ALLU,SARAGIAN,72,62,60,32,0,0,0,24,9,15,42,10,3,3,0,3,40,16,24,5,16,1,15,1,33,17,16,9,NOVEMBER
SULAWESI BARAT,POLEWALI MANDAR,ALLU,SAYOANG,70,75,59,30,12,4,1,15,32,4,37,17,8,8,0,2,11,6,5,6,5,5,0,1,37,2,35,27,NOVEMBER
SULAWESI BARAT,POLEWALI MANDAR,ALLU,ALU,85,21,1,0,0,0,0,1,0,0,1,0,9,3,6,2,21,13,8,9,5,4,1,0,0,0,0,0,NOVEMBER
SULAWESI BARAT,POLEWALI MANDAR,ANREAPI,ANREAPI,30,35,32,3,3,2,1,30,0,1,23,3,6,6,0,2,35,6,29,3,17,10,7,6,33,22,11,3,NOVEMBER
SULAWESI BARAT,POLEWALI MANDAR,ANREAPI,DUAMPANUA,100,77,61,34,2,0,0,30,23,0,11,31,19,11,8,1,51,37,14,9,38,9,29,5,72,4,68,53,NOVEMBER
SULAWESI BARAT,POLEWALI MANDAR,ANREAPI,KELAPA DUA,80,36,15,0,0,0,0,5,2,1,12,2,12,4,8,4,31,24,7,1,11,2,9,1,21,4,17,19,NOVEMBER
SULAWESI BARAT,POLEWALI MANDAR,ANREAPI,PAPPANDANGAN,79,55,39,27,22,12,5,15,5,2,9,9,9,3,6,3,28,15,13,13,13,4,9,0,23,1,22,13,NOVEMBER
SULAWESI BARAT,POLEWALI MANDAR,ANREAPI,KUNYI,39,18,16,11,2,0,0,6,3,7,13,2,0,0,0,0,16,13,3,9,0,0,0,0,11,9,2,11,NOVEMBER
SULAWESI BARAT,POLEWALI MANDAR,BALANIPA,BALANIPA,30,35,19,18,0,0,0,11,5,3,2,3,5,4,1,4,26,26,0,3,3,3,0,2,14,10,4,5,NOVEMBER
SULAWESI BARAT,POLEWALI MANDAR,BALANIPA,TAMMAJARRA,90,80,41,3,0,0,0,15,1,8,13,14,6,4,2,3,62,28,34,21,60,59,1,54,57,51,6,44,NOVEMBER
SULAWESI BARAT,POLEWALI MANDAR,BALANIPA,TAMANGGALLE,61,62,5,4,0,0,0,5,0,0,0,3,4,4,0,2,34,5,29,5,21,17,4,4,54,32,22,30,NOVEMBER
SULAWESI BARAT,POLEWALI MANDAR,BALANIPA,MOSSO,52,23,2,2,1,0,0,0,0,0,1,1,7,3,4,2,15,7,8,4,8,7,1,3,15,11,4,1,NOVEMBER
SULAWESI BARAT,POLEWALI MANDAR,BALANIPA,GALUNG TULUK,41,78,59,28,19,6,3,6,27,4,30,13,5,3,2,0,42,17,25,16,38,13,25,9,47,4,43,36,NOVEMBER
SULAWESI BARAT,POLEWALI MANDAR,BALANIPA,SABANG SUBIK,55,64,30,3,3,3,1,16,6,4,6,7,9,1,8,1,26,26,0,22,2,1,1,1,33,19,14,12,NOVEMBER
SULAWESI BARAT,POLEWALI MANDAR,BALANIPA,PAMBUSUANG,70,27,8,7,2,2,0,5,2,1,6,1,12,6,6,1,23,17,6,3,23,1,22,0,28,18,10,8,NOVEMBER
SULAWESI BARAT,POLEWALI MANDAR,BALANIPA,BALA,57,24,19,10,0,0,0,13,5,0,9,10,6,5,1,4,20,19,1,0,17,0,17,0,27,22,5,0,NOVEMBER
SULAWESI BARAT,POLEWALI MANDAR,BALANIPA,LAMBANAN,80,66,50,24,9,2,1,35,14,0,28,14,1,1,0,0,39,13,26,3,27,19,8,3,42,8,34,16,NOVEMBER
SULAWESI BARAT,POLEWALI MANDAR,BALANIPA,LEGO,91,52,41,30,14,11,9,26,0,6,5,13,16,11,5,3,13,5,8,1,11,4,7,3,23,1,22,19,NOVEMBER
SULAWESI BARAT,POLEWALI MANDAR,BALANIPA,PALLIS,69,32,14,12,11,9,3,7,3,0,10,1,12,0,12,0,28,26,2,18,23,0,23,0,16,1,15,10,NOVEMBER
SULAWESI BARAT,POLEWALI MANDAR,BINUANG,AMASSANGAN,65,19,1,0,0,0,0,1,0,0,0,1,10,6,4,5,12,5,7,0,4,4,0,3,5,0,5,2,NOVEMBER
SULAWESI BARAT,POLEWALI MANDAR,BINUANG,TONYAMAN,48,35,16,6,1,0,0,15,1,0,8,5,7,3,4,2,23,10,13,2,20,20,0,6,24,11,13,18,NOVEMBER
SULAWESI BARAT,POLEWALI MANDAR,BINUANG,KUAJANG,31,28,12,0,0,0,0,10,0,1,4,2,0,0,0,0,16,10,6,9,8,7,1,5,21,4,17,7,NOVEMBER
SULAWESI BARAT,POLEWALI MANDAR,BINUANG,PAKU,66,40,26,9,1,1,0,24,0,0,9,0,3,3,0,0,26,11,15,9,2,2,0,2,20,13,7,18,NOVEMBER
SULAWESI BARAT,POLEWALI MANDAR,BINUANG,MIRRING,97,56,53,4,2,0,0,37,3,7,3,30,16,15,1,4,30,14,16,2,26,23,3,14,48,40,8,13,NOVEMBER
SULAWESI BARAT,POLEWALI MANDAR,BINUANG,BATETANGNGA,59,27,24,6,1,0,0,15,4,1,7,6,8,5,3,0,24,21,3,14,15,15,0,9,32,14,18,12,NOVEMBER
SULAWESI BARAT,POLEWALI MANDAR,BINUANG,MAMMI,37,30,20,2,2,2,0,4,0,0,8,5,0,0,0,0,26,10,16,1,17,12,5,4,29,23,6,18,NOVEMBER
SULAWESI BARAT,POLEWALI MANDAR,BINUANG,KALEOK,95,77,17,1,0,0,0,10,1,2,7,5,18,17,1,6,31,30,1,12,10,10,0,7,29,16,13,3,NOVEMBER
SULAWESI BARAT,POLEWALI MANDAR,BINUANG,AMOLA,30,10,9,1,1,1,1,1,1,1,5,2,3,1,2,0,10,6,4,0,4,2,2,1,8,2,6,6,NOVEMBER
SULAWESI BARAT,POLEWALI MANDAR,BINUANG,REA,48,28,7,3,3,3,3,1,3,0,0,3,8,0,8,0,17,10,7,9,4,2,2,2,6,0,6,0,NOVEMBER
SULAWESI BARAT,POLEWALI MANDAR,BULO,BULO,94,11,5,2,0,0,0,4,0,1,0,5,0,0,0,0,10,5,5,2,5,2,3,2,6,0,6,6,NOVEMBER
SULAWESI BARAT,POLEWALI MANDAR,BULO,PULLIWA,64,77,68,39,23,1,0,67,1,0,44,14,3,2,1,1,13,6,7,6,0,0,0,0,31,25,6,20,NOVEMBER
SULAWESI BARAT,POLEWALI MANDAR,BULO,PATAMBANUA,92,59,28,7,7,2,2,16,0,8,21,2,8,5,3,3,20,12,8,4,17,1,16,0,0,0,0,0,NOVEMBER
SULAWESI BARAT,POLEWALI MANDAR,BULO,KAROMBANG,44,49,42,2,2,2,0,31,7,3,32,8,2,0,2,0,19,15,4,4,5,1,4,0,17,12,5,6,NOVEMBER
SULAWESI BARAT,POLEWALI MANDAR,BULO,DAALA TIMUR,53,77,46,35,35,2,2,1,28,3,9,24,10,7,3,4,73,39,34,3,52,5,47,1,9,4,5,0,NOVEMBER
SULAWESI BARAT,POLEWALI MANDAR,BULO,LENGGO,59,46,17,2,1,1,1,2,12,2,0,2,1,0,1,0,18,17,1,0,2,2,0,1,16,12,4,7,NOVEMBER
SULAWESI BARAT,POLEWALI MANDAR,BULO,SABURA,31,27,6,4,2,2,2,3,1,0,2,3,5,3,2,0,19,10,9,1,19,13,6,2,3,2,1,2,NOVEMBER
SULAWESI BARAT,POLEWALI MANDAR,BULO,SEPPORRAKI,82,36,23,8,2,2,0,3,7,8,9,6,1,1,0,0,28,7,21,2,1,0,1,0,19,6,13,14,NOVEMBER
SULAWESI BARAT,POLEWALI MANDAR,BULO,IHING,47,78,34,7,7,7,2,30,0,1,14,13,8,6,2,0,14,9,5,9,2,2,0,0,2,0,2,2,NOVEMBER
SULAWESI BARAT,POLEWALI MANDAR,CAMPALAGIAN,PAPPANG,54,80,10,1,0,0,0,8,2,0,0,9,5,1,4,1,25,25,0,15,22,8,14,4,67,31,36,62,NOVEMBER
SULAWESI BARAT,POLEWALI MANDAR,CAMPALAGIAN,LALIKO,51,32,29,13,13,8,7,17,5,0,1,6,1,0,1,0,25,10,15,2,14,6,8,2,35,29,6,10,NOVEMBER
SULAWESI BARAT,POLEWALI MANDAR,CAMPALAGIAN,BONDE,35,32,32,2,0,0,0,30,2,0,24,6,6,4,2,3,20,17,3,10,18,3,15,2,18,18,0,15,NOVEMBER
SULAWESI BARAT,POLEWALI MANDAR,CAMPALAGIAN,KATUMBANGAN LEMO,88,57,49,23,9,3,1,38,3,6,42,6,3,1,2,1,21,11,10,6,7,7,0,4,37,12,25,11,NOVEMBER
SULAWESI BARAT,POLEWALI MANDAR,CAMPALAGIAN,PANYAMPA,34,62,23,21,0,0,0,16,3,1,21,1,0,0,0,0,19,13,6,1,14,0,14,0,49,3,46,1,NOVEMBER
SULAWESI BARAT,POLEWALI MANDAR,CAMPALAGIAN,SURUANG,90,68,12,0,0,0,0,8,1,0,11,1,4,1,3,0,15,5,10,2,6,3,3,0,38,1,37,5,NOVEMBER
SULAWESI BARAT,POLEWALI MANDAR,CAMPALAGIAN,LAMPOKO,32,43,3,2,1,1,0,3,0,0,0,2,0,0,0,0,36,22,14,6,19,16,3,11,6,6,0,2,NOVEMBER
SULAWESI BARAT,POLEWALI MANDAR,CAMPALAGIAN,KATUMBANGAN,86,72,9,1,1,0,0,1,6,1,5,0,9,6,3,2,51,21,30,18,0,0,0,0,46,42,4,10,NOVEMBER
SULAWESI BARAT,POLEWALI MANDAR,CAMPALAGIAN,LAPEO,86,38,14,13,2,1,1,5,0,7,10,0,11,6,5,5,18,10,8,10,9,9,0,5,16,7,9,6,NOVEMBER
SULAWESI BARAT,POLEWALI MANDAR,CAMPALAGIAN,PARAPPE,95,57,21,17,17,13,10,5,5,0,12,8,14,12,2,11,26,13,13,9,1,0,1,0,29,21,8,16,NOVEMBER
SULAWESI BARAT,POLEWALI MANDAR,CAMPALAGIAN,ONGKO,35,68,3,1,0,0,0,3,0,0,3,0,7,1,6,0,39,32,7,6,11,3,8,1,40,6,34,18,NOVEMBER
SULAWESI BARAT,POLEWALI MANDAR,CAMPALAGIAN,KENJE,33,80,70,42,23,9,0,56,9,2,33,6,3,3,0,3,51,44,7,35,17,9,8,2,51,31,20,23,NOVEMBER
SULAWESI BARAT,POLEWALI MANDAR,CAMPALAGIAN,SUMARRANG,64,26,8,2,2,2,0,3,4,1,5,1,12,12,0,3,11,6,5,6,7,4,3,3,1,1,0,1,NOVEMBER
SULAWESI BARAT,POLEWALI MANDAR,CAMPALAGIAN,BOTTO,78,29,7,3,3,1,1,2,3,0,1,2,3,0,3,0,29,13,16,8,6,1,5,0,10,3,7,7,NOVEMBER
SULAWESI BARAT,POLEWALI MANDAR,CAMPALAGIAN,GATTUNGAN,36,46,45,11,2,1,0,6,2,26,45,0,1,0,1,0,40,9,31,7,17,2,15,1,15,14,1,9,NOVEMBER
SULAWESI BARAT,POLEWALI MANDAR,CAMPALAGIAN,PADANG TIMUR,86,15,4,2,2,1,0,3,0,1,0,1,7,7,0,3,12,8,4,4,1,0,1,0,10,6,4,8,NOVEMBER
SULAWESI BARAT,POLEWALI MANDAR,CAMPALAGIAN,PADANG,65,54,12,5,1,1,0,0,2,9,7,1,9,1,8,1,48,37,11,14,33,10,23,6,50,1,49,4,NOVEMBER
SULAWESI BARAT,POLEWALI MANDAR,CAMPALAGIAN,LAGI-AGI,94,24,4,2,0,0,0,0,2,0,4,0,12,8,4,7,12,5,7,0,5,1,4,1,16,3,13,4,NOVEMBER
SULAWESI BARAT,POLEWALI MANDAR,LIMBORO,LIMBORO,86,77,25,15,11,3,0,1,13,9,2,2,4,1,3,0,50,26,24,0,43,35,8,35,88,31,57,16,NOVEMBER
SULAWESI BARAT,POLEWALI MANDAR,LIMBORO,LEMBANG LEMBANG,65,16,6,1,1,0,0,6,0,0,0,0,6,6,0,5,15,12,3,8,15,11,4,3,1,0,1,0,NOVEMBER
SULAWESI BARAT,POLEWALI MANDAR,LIMBORO,TANDASURA,64,77,59,7,3,1,1,53,0,0,34,13,4,0,4,0,50,17,33,16,34,28,6,6,36,16,20,23,NOVEMBER
SULAWESI BARAT,POLEWALI MANDAR,LIMBORO,SAMASUNDU,48,70,32,6,4,1,0,25,2,2,13,3,9,6,3,5,31,27,4,13,27,9,18,4,19,18,1,13,NOVEMBER
SULAWESI BARAT,POLEWALI MANDAR,LIMBORO,NAPO,83,13,2,1,1,1,1,1,0,0,1,0,5,3,2,3,12,7,5,5,7,2,5,2,12,12,0,5,NOVEMBER
SULAWESI BARAT,POLEWALI MANDAR,LIMBORO,TODANG TODANG,100,26,11,11,7,5,4,6,1,0,1,5,12,8,4,0,18,18,0,17,12,5,7,1,14,7,7,11,NOVEMBER
SULAWESI BARAT,POLEWALI MANDAR,LIMBORO,PENDULANGAN,74,53,50,0,0,0,0,34,11,4,35,6,10,1,9,0,42,5,37,4,11,0,11,0,15,3,12,7,NOVEMBER
SULAWESI BARAT,POLEWALI MANDAR,LIMBORO,RENGGEANG,41,65,49,39,13,0,0,29,16,3,27,3,5,0,5,0,10,7,3,1,6,0,6,0,19,2,17,6,NOVEMBER
SULAWESI BARAT,POLEWALI MANDAR,LIMBORO,SALARRI,77,42,22,19,18,9,7,9,5,1,2,12,13,6,7,0,24,8,16,6,21,10,11,10,5,5,0,3,NOVEMBER
SULAWESI BARAT,POLEWALI MANDAR,LIMBORO,TANGAN BARU,68,74,74,51,15,2,0,71,0,1,41,25,6,4,2,0,51,38,13,38,19,3,16,2,28,18,10,10,NOVEMBER
SULAWESI BARAT,POLEWALI MANDAR,LIMBORO,PALECE,81,61,33,5,5,5,1,7,1,19,31,0,6,6,0,6,38,21,17,18,26,7,19,6,57,9,48,6,NOVEMBER
SULAWESI BARAT,POLEWALI MANDAR,LUYO,BATUPANGA,60,23,12,7,2,0,0,6,1,1,12,0,0,0,0,0,18,14,4,1,9,5,4,0,6,3,3,6,NOVEMBER
SULAWESI BARAT,POLEWALI MANDAR,LUYO,MAMBU,45,67,10,6,1,0,0,6,4,0,8,0,9,0,9,0,64,5,59,5,11,11,0,9,46,3,43,18,NOVEMBER
SULAWESI BARAT,POLEWALI MANDAR,LUYO,TENGGELANG,35,47,38,18,6,3,0,27,2,4,38,0,4,1,3,1,30,10,20,3,5,4,1,4,27,11,16,18,NOVEMBER
SULAWESI BARAT,POLEWALI MANDAR,LUYO,BARU,69,62,20,6,2,1,1,12,5,0,16,0,5,3,2,3,38,20,18,18,29,14,15,13,1,0,1,0,NOVEMBER
SULAWESI BARAT,POLEWALI MANDAR,LUYO,PUSSUI,62,75,32,3,2,0,0,14,10,6,24,5,12,8,4,3,47,17,30,17,44,29,15,5,40,40,0,21,NOVEMBER
SULAWESI BARAT,POLEWALI MANDAR,LUYO,MAPILI BARAT,37,38,0,0,0,0,0,0,0,0,0,0,3,1,2,0,17,5,12,1,10,6,4,0,25,2,23,11,NOVEMBER
SULAWESI BARAT,POLEWALI MANDAR,LUYO,SAMBALI WALI,79,15,12,6,4,3,2,1,2,0,10,1,5,4,1,4,11,11,0,5,9,5,4,4,8,1,7,5,NOVEMBER
SULAWESI BARAT,POLEWALI MANDAR,LUYO,BATUPANGA DAALA,86,77,55,47,16,13,1,16,21,0,26,13,6,0,6,0,55,9,46,3,47,12,35,0,69,31,38,63,NOVEMBER
SULAWESI BARAT,POLEWALI MANDAR,LUYO,LUYO,43,70,12,6,0,0,0,10,0,2,6,2,7,2,5,1,46,37,9,6,38,26,12,24,10,5,5,2,NOVEMBER
SULAWESI BARAT,POLEWALI MANDAR,LUYO,PUSSUI BARAT,79,12,7,5,0,0,0,4,3,0,5,1,7,3,4,1,11,7,4,4,1,1,0,0,5,1,4,0,NOVEMBER
SULAWESI BARAT,POLEWALI MANDAR,LUYO,PUCCADI,80,39,34,29,5,3,1,31,1,1,5,10,6,1,5,0,15,7,8,1,6,3,3,3,11,8,3,0,NOVEMBER
SULAWESI BARAT,POLEWALI MANDAR,MAPILLI,MAPILI,57,60,21,6,3,3,3,18,0,0,2,15,9,2,7,1,33,9,24,8,18,16,2,3,44,33,11,0,NOVEMBER
SULAWESI BARAT,POLEWALI MANDAR,MAPILLI,UGIBARU,96,17,16,10,1,0,0,15,0,0,2,1,11,2,9,0,17,8,9,2,10,0,10,0,18,0,18,5,NOVEMBER
SULAWESI BARAT,POLEWALI MANDAR,MAPILLI,RUMPA,67,33,2,1,1,1,1,0,1,0,0,0,3,1,2,0,20,6,14,1,10,7,3,2,17,17,0,11,NOVEMBER
SULAWESI BARAT,POLEWALI MANDAR,MAPILLI,KURMA,69,55,4,2,0,0,0,1,3,0,2,0,12,4,8,1,51,8,43,4,10,0,10,0,15,13,2,9,NOVEMBER
SULAWESI BARAT,POLEWALI MANDAR,MAPILLI,BUKU,38,40,3,3,2,0,0,2,1,0,2,0,3,1,2,1,25,14,11,8,22,8,14,1,43,6,37,15,NOVEMBER
SULAWESI BARAT,POLEWALI MANDAR,MAPILLI,BONNE BONNE,100,41,13,0,0,0,0,8,2,1,1,5,2,1,1,0,10,6,4,0,6,2,4,2,13,3,10,12,NOVEMBER
SULAWESI BARAT,POLEWALI MANDAR,MAPILLI,BEROANGIN,80,60,34,22,19,11,0,22,6,4,20,13,0,0,0,0,34,26,8,22,10,6,4,5,37,27,10,23,NOVEMBER
SULAWESI BARAT,POLEWALI MANDAR,MAPILLI,SEGERANG,81,48,3,0,0,0,0,1,1,0,1,1,16,4,12,3,16,6,10,4,9,5,4,1,2,2,0,1,NOVEMBER
SULAWESI BARAT,POLEWALI MANDAR,MAPILLI,BONRA,73,73,43,6,4,3,0,41,2,0,6,15,5,5,0,3,63,10,53,2,13,7,6,7,34,0,34,25,NOVEMBER
SULAWESI BARAT,POLEWALI MANDAR,MAPILLI,SATTOKO,40,47,39,15,2,1,1,0,18,16,34,4,2,1,1,1,18,13,5,4,2,2,0,2,0,0,0,0,NOVEMBER
SULAWESI BARAT,POLEWALI MANDAR,MAPILLI,RAPPANG BARAT,98,57,2,2,0,0,0,2,0,0,0,1,9,9,0,8,51,32,19,27,42,1,41,0,16,11,5,3,NOVEMBER
SULAWESI BARAT,POLEWALI MANDAR,MAPILLI,LANDI KANUSUANG,53,55,15,1,0,0,0,5,6,1,7,2,0,0,0,0,24,6,18,0,22,7,15,3,9,7,2,1,NOVEMBER
SULAWESI BARAT,POLEWALI MANDAR,MATAKALI,MATAKALI,59,17,4,3,1,0,0,1,2,0,3,1,7,6,1,1,15,9,6,6,14,9,5,3,17,11,6,5,NOVEMBER
SULAWESI BARAT,POLEWALI MANDAR,MATAKALI,PETAMPANUA,58,45,37,27,2,2,2,21,3,5,15,14,8,5,3,4,24,15,9,9,13,1,12,1,28,25,3,14,NOVEMBER
SULAWESI BARAT,POLEWALI MANDAR,MATAKALI,BARUMBUNG,55,68,47,4,4,2,1,46,0,0,23,0,7,2,5,2,58,42,16,13,44,6,38,3,38,15,23,9,NOVEMBER
SULAWESI BARAT,POLEWALI MANDAR,MATAKALI,PASIANG,61,51,0,0,0,0,0,0,0,0,0,0,1,1,0,1,49,12,37,5,31,16,15,3,21,8,13,17,NOVEMBER
SULAWESI BARAT,POLEWALI MANDAR,MATAKALI,TONROLIMA,46,40,34,21,19,11,1,29,1,3,18,7,6,5,1,2,26,22,4,7,18,2,16,1,1,0,1,0,NOVEMBER
SULAWESI BARAT,POLEWALI MANDAR,MATAKALI,INDOMAKKOMBONG,59,11,2,2,2,1,0,1,1,0,1,0,11,3,8,0,10,9,1,4,6,3,3,2,13,6,7,7,NOVEMBER
SULAWESI BARAT,POLEWALI MANDAR,MATAKALI,BUNGA-BUNGA,69,43,33,29,0,0,0,6,15,0,2,15,10,5,5,3,21,5,16,5,14,3,11,3,25,15,10,18,NOVEMBER
SULAWESI BARAT,POLEWALI MANDAR,MATANGNGA,MATANGNGA,71,11,7,3,0,0,0,1,2,2,4,3,13,6,7,6,10,5,5,0,0,0,0,0,4,3,1,2,NOVEMBER
SULAWESI BARAT,POLEWALI MANDAR,MATANGNGA,LILLI,86,15,11,0,0,0,0,10,0,0,3,0,14,2,12,1,10,6,4,2,7,5,2,1,4,4,0,0,NOVEMBER
SULAWESI BARAT,POLEWALI MANDAR,MATANGNGA,RANGOAN,39,21,12,6,5,1,0,0,2,10,12,0,2,0,2,0,14,10,4,8,9,7,2,0,2,2,0,0,NOVEMBER
SULAWESI BARAT,POLEWALI MANDAR,MATANGNGA,TAPUA,69,41,31,1,1,1,1,26,2,2,19,2,12,6,6,5,30,24,6,4,4,3,1,2,27,24,3,24,NOVEMBER
SULAWESI BARAT,POLEWALI MANDAR,MATANGNGA,MAMBU TAPUA,32,20,3,1,1,0,0,0,0,3,0,3,6,3,3,2,20,19,1,13,4,4,0,4,5,5,0,2,NOVEMBER
SULAWESI BARAT,POLEWALI MANDAR,MATANGNGA,BA'BA TAPUA,84,35,25,8,3,1,0,23,2,0,1,16,6,6,0,5,14,10,4,4,2,2,0,0,3,2,1,2,NOVEMBER
SULAWESI BARAT,POLEWALI MANDAR,MATANGNGA,KATIMBANG,46,73,39,23,0,0,0,24,0,8,21,8,6,3,3,0,19,17,2,14,15,3,12,1,40,20,20,1,NOVEMBER
SULAWESI BARAT,POLEWALI MANDAR,POLEWALI,POLEWALI,45,36,8,0,0,0,0,5,3,0,3,1,3,3,0,3,26,19,7,17,26,25,1,19,31,26,5,22,NOVEMBER
SULAWESI BARAT,POLEWALI MANDAR,POLEWALI,WATTANG,91,44,2,0,0,0,0,0,0,1,1,1,2,2,0,0,27,26,1,14,18,14,4,3,23,6,17,0,NOVEMBER
SULAWESI BARAT,POLEWALI MANDAR,POLEWALI,SULEWATANG,69,25,23,22,0,0,0,5,18,0,14,6,9,0,9,0,13,12,1,7,3,3,0,2,1,0,1,1,NOVEMBER
SULAWESI BARAT,POLEWALI MANDAR,POLEWALI,LANTORA,58,20,0,0,0,0,0,0,0,0,0,0,11,7,4,6,19,17,2,0,18,2,16,0,2,2,0,2,NOVEMBER
SULAWESI BARAT,POLEWALI MANDAR,POLEWALI,TAKATIDUNG,40,72,2,1,1,0,0,1,0,1,2,0,8,0,8,0,40,8,32,2,14,6,8,4,1,1,0,0,NOVEMBER
SULAWESI BARAT,POLEWALI MANDAR,POLEWALI,PEKKABATA,58,71,58,25,8,7,1,29,14,7,6,42,3,0,3,0,70,32,38,11,29,6,23,6,69,67,2,51,NOVEMBER
SULAWESI BARAT,POLEWALI MANDAR,POLEWALI,MADATE,54,28,16,5,2,0,0,1,6,7,6,3,2,2,0,0,12,9,3,1,3,3,0,2,1,1,0,0,NOVEMBER
SULAWESI BARAT,POLEWALI MANDAR,POLEWALI,MANDING,37,74,40,24,17,7,6,18,12,4,20,18,1,0,1,0,46,22,24,18,36,4,32,0,11,8,3,10,NOVEMBER
SULAWESI BARAT,POLEWALI MANDAR,POLEWALI,DARMA,53,45,39,29,6,4,4,11,24,0,34,3,2,1,1,1,30,17,13,4,10,1,9,1,0,0,0,0,NOVEMBER
SULAWESI BARAT,POLEWALI MANDAR,TAPANGO,PELITAKAN,46,34,32,8,6,5,2,14,5,0,5,5,7,0,7,0,25,20,5,2,13,13,0,12,20,7,13,20,NOVEMBER
SULAWESI BARAT,POLEWALI MANDAR,TAPANGO,TAPANGO,59,23,0,0,0,0,0,0,0,0,0,0,6,6,0,1,17,12,5,5,14,6,8,3,14,14,0,12,NOVEMBER
SULAWESI BARAT,POLEWALI MANDAR,TAPANGO,RAPPANG,88,11,2,0,0,0,0,1,1,0,1,0,6,3,3,2,10,9,1,4,3,1,2,1,10,1,9,10,NOVEMBER
SULAWESI BARAT,POLEWALI MANDAR,TAPANGO,DAKKA,54,55,51,1,1,0,0,27,22,2,14,8,3,0,3,0,15,7,8,0,11,10,1,7,20,2,18,10,NOVEMBER
SULAWESI BARAT,POLEWALI MANDAR,TAPANGO,BATU,36,44,8,6,0,0,0,7,1,0,6,2,5,3,2,1,38,12,26,0,23,11,12,11,0,0,0,0,NOVEMBER
SULAWESI BARAT,POLEWALI MANDAR,TAPANGO,RISO,76,43,31,12,1,0,0,29,1,0,7,23,10,8,2,3,20,7,13,3,8,7,1,1,5,5,0,3,NOVEMBER
SULAWESI BARAT,POLEWALI MANDAR,TAPANGO,PALATTA,98,48,27,17,11,6,1,2,19,3,10,7,18,14,4,0,23,22,1,16,16,14,2,8,36,3,33,17,NOVEMBER
SULAWESI BARAT,POLEWALI MANDAR,TAPANGO,TAPANGO BARAT,49,46,23,17,5,1,0,9,3,4,14,3,4,3,1,3,43,14,29,6,14,2,12,0,14,11,3,10,NOVEMBER
SULAWESI BARAT,POLEWALI MANDAR,TAPANGO,KURRAK,79,41,32,20,17,2,0,15,12,4,25,2,5,4,1,0,21,9,12,6,0,0,0,0,2,2,0,0,NOVEMBER
SULAWESI BARAT,POLEWALI MANDAR,TAPANGO,BUSSU,79,56,51,50,41,8,3,13,21,7,47,4,15,8,7,6,15,7,8,3,10,0,10,0,48,19,29,12,NOVEMBER
SULAWESI BARAT,POLEWALI MANDAR,TAPANGO,TUTTULA,61,30,1,1,1,1,0,1,0,0,0,0,12,9,3,2,22,22,0,2,0,0,0,0,19,0,19,19,NOVEMBER
SULAWESI BARAT,POLEWALI MANDAR,TAPANGO,JAMBU MALEA,93,61,44,3,3,1,0,36,0,5,44,0,6,2,4,0,21,18,3,7,21,9,12,8,44,39,5,31,NOVEMBER
SULAWESI BARAT,POLEWALI MANDAR,TAPANGO,KALIMBUA,99,46,23,6,6,5,5,7,5,2,4,3,15,4,11,3,10,6,4,5,0,0,0,0,0,0,0,0,NOVEMBER
SULAWESI BARAT,POLEWALI MANDAR,TAPANGO,BANATO REJO,54,61,18,18,7,3,3,7,1,7,18,0,3,3,0,2,17,15,2,8,14,8,6,3,31,18,13,15,NOVEMBER
SULAWESI BARAT,POLEWALI MANDAR,TINAMBUNG,TINAMBUNG,100,45,11,0,0,0,0,0,0,9,8,2,13,13,0,6,19,18,1,0,1,1,0,0,11,10,1,4,NOVEMBER
SULAWESI BARAT,POLEWALI MANDAR,TINAMBUNG,KARAMA,94,26,2,2,2,2,0,1,0,0,0,1,14,10,4,9,15,12,3,7,14,8,6,6,1,1,0,1,NOVEMBER
SULAWESI BARAT,POLEWALI MANDAR,TINAMBUNG,TANGNGA TANGNGA,52,51,25,16,2,1,0,4,0,3,23,1,2,0,2,0,34,19,15,19,13,0,13,0,46,12,34,2,NOVEMBER
SULAWESI BARAT,POLEWALI MANDAR,TINAMBUNG,LEKOPADIS,65,31,15,13,7,3,1,13,1,0,4,3,6,2,4,0,22,20,2,12,19,16,3,11,15,11,4,9,NOVEMBER
SULAWESI BARAT,POLEWALI MANDAR,TINAMBUNG,GALUNG LOMBOK,79,16,5,2,1,1,0,2,3,0,3,1,13,1,12,1,13,9,4,6,5,0,5,0,4,0,4,3,NOVEMBER
SULAWESI BARAT,POLEWALI MANDAR,TINAMBUNG,TANDUNG,88,41,10,3,1,1,1,9,0,0,2,0,4,3,1,1,19,13,6,8,14,2,12,0,8,6,2,3,NOVEMBER
SULAWESI BARAT,POLEWALI MANDAR,TINAMBUNG,BATULAYA,35,48,47,47,32,13,4,28,10,3,29,16,6,0,6,0,30,11,19,8,19,2,17,2,20,15,5,5,NOVEMBER
SULAWESI BARAT,POLEWALI MANDAR,TINAMBUNG,SEPABATU,59,51,14,12,9,9,0,13,1,0,2,7,8,2,6,1,14,10,4,2,8,5,3,2,32,28,4,15,NOVEMBER
SULAWESI BARAT,POLEWALI MANDAR,TUTAR,TARAMANU,75,80,53,45,28,6,1,17,20,10,44,8,15,0,15,0,14,8,6,1,6,5,1,0,35,13,22,23,NOVEMBER
SULAWESI BARAT,POLEWALI MANDAR,TUTAR,AMBOPADANG,76,41,34,15,14,3,0,27,1,2,16,8,2,2,0,1,35,26,9,24,26,16,10,14,36,35,1,19,NOVEMBER
SULAWESI BARAT,POLEWALI MANDAR,TUTAR,TUBBI,56,23,1,1,1,0,0,1,0,0,1,0,5,5,0,2,16,7,9,7,15,3,12,2,11,2,9,4,NOVEMBER
SULAWESI BARAT,POLEWALI MANDAR,TUTAR,RATTE,48,38,22,10,1,0,0,8,2,11,1,21,2,1,1,1,24,19,5,14,6,4,2,3,27,27,0,8,NOVEMBER
SULAWESI BARAT,POLEWALI MANDAR,TUTAR,BESOANGIN,41,42,36,8,1,1,1,12,21,2,7,18,8,0,8,0,19,6,13,1,16,10,6,10,20,16,4,10,NOVEMBER
SULAWESI BARAT,POLEWALI MANDAR,TUTAR,PIRIANG TAPIKO,92,75,34,21,10,6,1,33,0,0,34,0,16,7,9,7,35,22,13,22,14,0,14,0,3,2,1,0,NOVEMBER
SULAWESI BARAT,POLEWALI MANDAR,TUTAR,PEBURRU,64,63,4,3,1,1,0,2,2,0,0,2,3,1,2,1,57,32,25,13,30,23,7,22,63,34,29,23,NOVEMBER
SULAWESI BARAT,POLEWALI MANDAR,TUTAR,TALOBA,59,42,37,17,6,0,0,6,29,0,17,8,3,2,1,1,31,15,16,3,11,3,8,3,19,16,3,11,NOVEMBER
SULAWESI BARAT,POLEWALI MANDAR,TUTAR,POLLEWANI,31,15,9,8,5,2,1,5,2,0,8,1,2,1,1,0,12,5,7,3,10,6,4,4,2,0,2,0,NOVEMBER
SULAWESI BARAT,POLEWALI MANDAR,TUTAR,ARABUA,72,60,55,27,20,17,1,26,4,23,18,36,4,4,0,2,55,34,21,27,7,3,4,3,48,3,45,22,NOVEMBER
SULAWESI BARAT,POLEWALI MANDAR,TUTAR,BESOANGIN UTARA,91,10,0,0,0,0,0,0,0,0,0,0,14,14,0,4,10,7,3,4,1,0,1,0,0,0,0,0,NOVEMBER
SULAWESI BARAT,POLEWALI MANDAR,TUTAR,PODA,95,50,43,10,7,4,3,18,3,7,7,24,17,13,4,10,49,43,6,18,20,18,2,2,27,7,20,24,NOVEMBER
SULAWESI BARAT,POLEWALI MANDAR,TUTAR,TARAMANU TUA,67,33,22,15,5,2,1,7,14,0,20,0,5,5,0,0,28,11,17,7,25,25,0,23,26,14,12,25,NOVEMBER
SULAWESI BARAT,POLEWALI MANDAR,WONOMULYO,SIDODADI,92,68,5,0,0,0,0,3,2,0,0,4,9,8,1,2,38,30,8,21,7,6,1,0,21,2,19,1,NOVEMBER
SULAWESI BARAT,POLEWALI MANDAR,WONOMULYO,SIDOREJO,48,63,54,4,0,0,0,13,12,18,9,2,6,3,3,1,38,10,28,0,37,0,37,0,50,10,40,45,NOVEMBER
SULAWESI BARAT,POLEWALI MANDAR,WONOMULYO,SUMBEREJO,75,62,51,9,5,1,1,25,17,5,45,3,7,1,6,0,33,5,28,0,2,0,2,0,33,13,20,18,NOVEMBER
SULAWESI BARAT,POLEWALI MANDAR,WONOMULYO,BUMIAYU,34,40,30,10,5,1,0,3,22,3,30,0,3,0,3,0,40,31,9,16,33,28,5,12,17,8,9,8,NOVEMBER
SULAWESI BARAT,POLEWALI MANDAR,WONOMULYO,KEBUNSARI,80,48,26,0,0,0,0,6,13,3,7,18,0,0,0,0,10,7,3,0,7,0,7,0,14,8,6,5,NOVEMBER
SULAWESI BARAT,POLEWALI MANDAR,WONOMULYO,BANUA BARU,42,27,1,0,0,0,0,0,0,1,0,1,5,1,4,1,27,11,16,3,11,4,7,3,11,3,8,2,NOVEMBER
SULAWESI BARAT,POLEWALI MANDAR,WONOMULYO,NEPO,81,60,22,16,3,0,0,3,8,9,0,5,7,0,7,0,22,5,17,1,19,11,8,0,53,39,14,30,NOVEMBER
SULAWESI BARAT,POLEWALI MANDAR,WONOMULYO,SUGIHWARAS,51,75,4,3,0,0,0,2,1,1,1,2,5,2,3,0,18,12,6,5,0,0,0,0,17,12,5,14,NOVEMBER
SULAWESI BARAT,POLEWALI MANDAR,WONOMULYO,CAMPURJO,71,27,10,2,1,0,0,5,0,5,6,3,9,0,9,0,18,18,0,16,3,3,0,2,21,16,5,16,NOVEMBER
SULAWESI BARAT,POLEWALI MANDAR,WONOMULYO,BUMIMULYO,99,74,54,22,0,0,0,36,14,3,20,27,2,1,1,1,16,6,10,3,0,0,0,0,22,14,8,14,NOVEMBER
SULAWESI BARAT,POLEWALI MANDAR,WONOMULYO,TUMPILING,77,34,26,4,0,0,0,10,1,10,19,1,15,10,5,1,22,17,5,15,1,1,0,0,9,0,9,0,NOVEMBER
SULAWESI BARAT,POLEWALI MANDAR,WONOMULYO,BAKKA-BAKKA,42,16,10,6,6,3,0,1,1,3,9,0,7,3,4,0,10,7,3,0,6,4,2,1,14,2,12,6,NOVEMBER
SULAWESI BARAT,POLEWALI MANDAR,WONOMULYO,ARJO SARI,51,15,7,5,2,0,0,1,1,4,2,2,4,4,0,4,11,11,0,10,1,0,1,0,0,0,0,0,NOVEMBER
SULAWESI BARAT,POLEWALI MANDAR,WONOMULYO,GALESON,86,35,14,10,2,2,1,6,7,0,2,3,4,4,0,3,15,13,2,13,2,1,1,1,20,20,0,6,NOVEMBER
SULAWESI BARAT,MAMUJU,MAMUJU,BINANGA,56,19,4,1,0,0,0,4,0,0,3,0,10,2,8,1,11,9,2,8,8,1,7,1,1,0,1,1,NOVEMBER
SULAWESI BARAT,MAMUJU,MAMUJU,MAMUNYU,92,16,16,4,3,0,0,16,0,0,6,6,14,11,3,3,16,7,9,7,2,0,2,0,6,6,0,3,NOVEMBER
SULAWESI BARAT,MAMUJU,MAMUJU,KAREMA,88,40,3,2,2,0,0,2,1,0,3,0,0,0,0,0,30,15,15,2,11,8,3,2,12,2,10,1,NOVEMBER
SULAWESI BARAT,MAMUJU,MAMUJU,RIMUKU,36,13,5,0,0,0,0,1,2,0,5,0,6,1,5,0,12,9,3,3,10,3,7,0,12,11,1,6,NOVEMBER
SULAWESI BARAT,MAMUJU,MAMUJU,BAMBU,85,76,16,3,0,0,0,10,2,2,6,10,13,3,10,0,73,36,37,2,34,9,25,9,20,18,2,0,NOVEMBER
SULAWESI BARAT,MAMUJU,MAMUJU,KARAMPUANG,32,12,2,1,1,1,0,0,1,1,1,1,0,0,0,0,12,9,3,1,8,4,4,3,3,2,1,3,NOVEMBER
SULAWESI BARAT,MAMUJU,MAMUJU,TADUI,41,19,8,2,2,1,1,0,3,4,4,2,4,0,4,0,12,10,2,10,11,6,5,2,4,2,2,3,NOVEMBER
SULAWESI BARAT,MAMUJU,MAMUJU,BATU PANNU,58,24,24,14,8,0,0,15,7,0,17,1,8,4,4,3,10,7,3,4,8,7,1,2,16,4,12,10,NOVEMBER
SULAWESI BARAT,MAMUJU,TAPALANG,GALUNG,98,66,50,45,12,10,10,13,6,21,49,1,16,3,13,1,37,29,8,29,2,2,0,1,19,19,0,11,NOVEMBER
SULAWESI BARAT,MAMUJU,TAPALANG,KASAMBANG,38,60,54,8,4,2,0,21,4,21,34,4,0,0,0,0,48,9,39,5,31,5,26,3,16,5,11,9,NOVEMBER
SULAWESI BARAT,MAMUJU,TAPALANG,DAYANGINNA,100,76,26,18,2,2,1,21,3,1,5,6,20,13,7,11,76,52,24,40,11,8,3,7,40,13,27,25,NOVEMBER
SULAWESI BARAT,MAMUJU,TAPALANG,OROBATU,55,73,47,44,41,23,7,4,23,4,25,4,4,0,4,0,17,15,2,0,7,3,4,2,9,8,1,8,NOVEMBER
SULAWESI BARAT,MAMUJU,TAPALANG,TAKANDEANG,46,36,13,10,5,2,1,9,0,3,10,1,9,8,1,1,12,12,0,11,2,1,1,1,18,17,1,5,NOVEMBER
SULAWESI BARAT,MAMUJU,TAPALANG,BELA,100,69,46,0,0,0,0,29,5,0,1,17,5,1,4,0,28,7,21,0,28,5,23,3,21,14,7,4,NOVEMBER
SULAWESI BARAT,MAMUJU,TAPALANG,TAAN,95,26,9,5,5,5,5,2,2,0,3,6,3,0,3,0,17,15,2,2,10,2,8,1,18,13,5,4,NOVEMBER
SULAWESI BARAT,MAMUJU,TAPALANG,TAMPALANG,69,52,8,4,1,1,1,1,0,6,3,0,2,2,0,2,20,12,8,8,19,3,16,1,50,8,42,14,NOVEMBER
SULAWESI BARAT,MAMUJU,TAPALANG,RANTEDODA,37,60,41,4,1,0,0,26,9,6,21,16,4,4,0,0,14,8,6,5,8,3,5,2,33,23,10,27,NOVEMBER
SULAWESI BARAT,MAMUJU,TAPALANG,KOPEANG,82,31,25,15,6,4,2,11,7,5,25,0,15,0,15,0,20,9,11,8,5,3,2,2,1,0,1,0,NOVEMBER
SULAWESI BARAT,MAMUJU,KALUKKU,SINYONYOI,45,52,12,5,5,3,3,0,4,2,7,3,3,1,2,1,15,11,4,2,13,6,7,5,6,6,0,1,NOVEMBER
SULAWESI BARAT,MAMUJU,KALUKKU,BEBANGA,33,62,59,1,1,0,0,59,0,0,31,2,4,0,4,0,48,6,42,0,27,18,9,0,53,19,34,33,NOVEMBER
SULAWESI BARAT,MAMUJU,KALUKKU,KALUKKU,61,27,10,5,5,4,4,2,1,1,9,1,4,4,0,4,17,13,4,4,8,6,2,1,21,13,8,5,NOVEMBER
SULAWESI BARAT,MAMUJU,KALUKKU,SINYONYOI SELATAN,48,47,32,7,1,0,0,23,3,1,13,7,6,2,4,2,15,13,2,7,10,4,6,3,0,0,0,0,NOVEMBER
SULAWESI BARAT,MAMUJU,KALUKKU,SONDOANG,94,24,23,21,9,7,7,4,2,5,6,13,9,2,7,1,22,11,11,9,21,5,16,2,15,11,4,8,NOVEMBER
SULAWESI BARAT,MAMUJU,KALUKKU,BERU-BERU,32,33,27,19,7,5,5,6,2,8,6,16,2,1,1,1,17,12,5,1,15,15,0,13,21,18,3,0,NOVEMBER
SULAWESI BARAT,MAMUJU,KALUKKU,BELANG BELANG,31,19,19,2,2,1,0,12,4,3,8,6,1,1,0,0,13,11,2,6,2,1,1,1,15,14,1,1,NOVEMBER
SULAWESI BARAT,MAMUJU,KALUKKU,KABULOANG,87,43,41,24,1,0,0,1,34,6,2,37,3,3,0,0,40,37,3,6,39,22,17,5,31,20,11,17,NOVEMBER
SULAWESI BARAT,MAMUJU,KALUKKU,KEANG,78,16,1,0,0,0,0,0,0,0,0,1,12,2,10,2,14,9,5,3,5,3,2,3,8,5,3,5,NOVEMBER
SULAWESI BARAT,MAMUJU,KALUKKU,POKKANG,68,21,15,13,8,4,4,0,8,0,15,0,12,3,9,0,20,14,6,10,2,0,2,0,4,4,0,3,NOVEMBER
SULAWESI BARAT,MAMUJU,KALUKKU,GULILING,61,57,41,3,2,2,2,25,11,0,26,9,4,1,3,1,39,14,25,2,20,17,3,16,35,27,8,15,NOVEMBER
SULAWESI BARAT,MAMUJU,KALUKKU,UHAIMATE,73,48,12,0,0,0,0,12,0,0,8,0,7,2,5,0,39,13,26,5,29,3,26,1,24,8,16,14,NOVEMBER
SULAWESI BARAT,MAMUJU,KALUKKU,KALUKKU BARAT,41,23,2,2,1,0,0,2,0,0,1,0,2,1,1,0,18,9,9,8,7,4,3,3,11,5,6,10,NOVEMBER
SULAWESI BARAT,MAMUJU,KALUKKU,PAMMULUKANG,54,19,3,1,0,0,0,3,0,0,2,0,4,3,1,3,17,10,7,9,4,3,1,3,8,5,3,3,NOVEMBER
SULAWESI BARAT,MAMUJU,KALUMPANG,KALUMPANG,66,21,11,10,9,3,2,6,2,0,8,0,6,6,0,6,20,9,11,9,4,2,2,2,2,1,1,2,NOVEMBER
SULAWESI BARAT,MAMUJU,KALUMPANG,KARATAUN,64,58,5,0,0,0,0,1,3,1,2,0,3,0,3,0,28,28,0,14,13,13,0,2,28,27,1,1,NOVEMBER
SULAWESI BARAT,MAMUJU,KALUMPANG,KARAMA,98,11,9,2,0,0,0,8,0,1,1,6,5,1,4,0,11,11,0,8,8,7,1,0,3,1,2,3,NOVEMBER
SULAWESI BARAT,MAMUJU,KALUMPANG,SIRAUN,77,72,3,0,0,0,0,3,0,0,0,2,9,3,6,2,30,12,18,4,8,1,7,1,49,45,4,36,NOVEMBER
SULAWESI BARAT,MAMUJU,KALUMPANG,TUMOGA,45,37,14,14,5,4,4,3,5,2,7,5,2,0,2,0,23,10,13,1,12,8,4,3,22,18,4,4,NOVEMBER
SULAWESI BARAT,MAMUJU,KALUMPANG,SALUMAKKI,57,38,3,3,3,3,1,2,0,0,0,1,8,7,1,3,30,21,9,19,11,10,1,0,31,7,24,21,NOVEMBER
SULAWESI BARAT,MAMUJU,KALUMPANG,POLIO,71,28,10,1,1,0,0,9,1,0,7,0,13,9,4,8,23,18,5,9,20,10,10,3,16,8,8,3,NOVEMBER
SULAWESI BARAT,MAMUJU,KALUMPANG,LIMBONG,39,26,26,10,6,0,0,19,5,1,2,8,6,0,6,0,22,12,10,5,14,13,1,3,27,14,13,1,NOVEMBER
SULAWESI BARAT,MAMUJU,KALUMPANG,SANDAPANG,39,61,39,17,10,6,6,33,0,0,22,12,5,2,3,2,28,21,7,15,25,12,13,7,17,15,2,7,NOVEMBER
SULAWESI BARAT,MAMUJU,KALUMPANG,KONDO BULO,72,58,38,14,6,0,0,20,8,2,2,8,10,3,7,3,27,13,14,13,20,10,10,4,60,56,4,44,NOVEMBER
SULAWESI BARAT,MAMUJU,KALUMPANG,MAKKALIKI,59,14,9,5,5,2,1,0,2,6,3,1,0,0,0,0,13,7,6,6,11,5,6,1,14,7,7,2,NOVEMBER
SULAWESI BARAT,MAMUJU,KALUMPANG,BATU MAKKADA,95,12,8,1,1,1,0,0,6,1,8,0,3,2,1,0,11,6,5,1,6,6,0,6,0,0,0,0,NOVEMBER
SULAWESI BARAT,MAMUJU,KALUMPANG,LASA',91,24,11,2,1,1,0,6,4,0,2,1,8,4,4,3,19,16,3,9,0,0,0,0,10,6,4,10,NOVEMBER
SULAWESI BARAT,MAMUJU,PAPALANG,TOABO,42,37,15,8,4,4,0,3,9,0,3,3,2,2,0,0,31,25,6,8,11,8,3,2,36,24,12,5,NOVEMBER
SULAWESI BARAT,MAMUJU,PAPALANG,PAPALANG,61,15,6,2,2,0,0,2,0,0,3,3,1,0,1,0,11,6,5,2,10,2,8,1,10,8,2,8,NOVEMBER
SULAWESI BARAT,MAMUJU,PAPALANG,BONDA,56,42,0,0,0,0,0,0,0,0,0,0,9,1,8,0,18,18,0,8,16,9,7,8,39,2,37,36,NOVEMBER
SULAWESI BARAT,MAMUJU,PAPALANG,TOPORE,32,22,1,1,1,1,1,0,0,0,0,0,4,4,0,1,15,6,9,6,11,10,1,1,7,3,4,2,NOVEMBER
SULAWESI BARAT,MAMUJU,PAPALANG,SALUKAYU,81,43,8,5,0,0,0,5,0,3,4,3,3,1,2,1,19,17,2,7,13,2,11,2,37,29,8,24,NOVEMBER
SULAWESI BARAT,MAMUJU,PAPALANG,SUKADAMAI,93,37,33,18,8,5,2,13,13,3,25,2,9,0,9,0,28,25,3,6,19,16,3,1,33,33,0,7,NOVEMBER
SULAWESI BARAT,MAMUJU,PAPALANG,BODA-BODA,42,38,1,0,0,0,0,1,0,0,1,0,5,5,0,5,23,21,2,11,1,1,0,0,4,1,3,2,NOVEMBER
SULAWESI BARAT,MAMUJU,PAPALANG,SISANGO,64,21,9,8,3,0,0,3,4,2,9,0,6,3,3,1,12,5,7,4,0,0,0,0,8,8,0,4,NOVEMBER
SULAWESI BARAT,MAMUJU,PAPALANG,BATU AMPA,52,39,31,15,3,0,0,25,3,2,19,12,3,1,2,1,30,27,3,10,5,0,5,0,11,11,0,7,NOVEMBER
SULAWESI BARAT,MAMUJU,SAMPAGA,BUNDE,59,12,1,1,0,0,0,1,0,0,0,0,0,0,0,0,12,11,1,3,6,0,6,0,2,1,1,2,NOVEMBER
SULAWESI BARAT,MAMUJU,SAMPAGA,KALONDING,74,14,2,2,1,0,0,0,0,0,0,1,12,11,1,9,11,7,4,4,6,0,6,0,7,4,3,2,NOVEMBER
SULAWESI BARAT,MAMUJU,SAMPAGA,TARAILU,42,76,7,7,6,5,3,2,0,2,7,0,4,2,2,2,45,5,40,5,3,1,2,1,51,14,37,11,NOVEMBER
SULAWESI BARAT,MAMUJU,SAMPAGA,SAMPAGA,98,54,48,27,2,2,0,39,7,0,40,7,4,0,4,0,32,12,20,7,24,15,9,2,13,13,0,9,NOVEMBER
SULAWESI BARAT,MAMUJU,SAMPAGA,TANAMBUAH,61,26,0,0,0,0,0,0,0,0,0,0,7,0,7,0,14,7,7,7,8,8,0,5,8,6,2,5,NOVEMBER
SULAWESI BARAT,MAMUJU,SAMPAGA,SALUBARANA,90,36,9,7,1,0,0,1,0,3,6,2,16,6,10,4,24,9,15,1,1,1,0,1,4,2,2,4,NOVEMBER
SULAWESI BARAT,MAMUJU,SAMPAGA,LOSSO,63,60,28,0,0,0,0,25,1,0,2,12,3,1,2,0,21,5,16,3,18,18,0,18,0,0,0,0,NOVEMBER
SULAWESI BARAT,MAMUJU,TOMMO,TOMMO,99,80,52,20,1,0,0,40,11,0,39,8,16,7,9,3,17,12,5,9,4,4,0,1,11,3,8,8,NOVEMBER
SULAWESI BARAT,MAMUJU,TOMMO,CAMPALOGA,52,19,7,7,5,5,1,3,1,1,6,0,3,0,3,0,16,14,2,3,12,5,7,0,8,4,4,4,NOVEMBER
SULAWESI BARAT,MAMUJU,TOMMO,BUANA SAKTI,81,53,37,18,11,4,4,5,24,1,7,30,12,12,0,6,31,13,18,6,1,1,0,0,38,0,38,37,NOVEMBER
SULAWESI BARAT,MAMUJU,TOMMO,TAMEMONGGA,95,72,0,0,0,0,0,0,0,0,0,0,1,0,1,0,32,11,21,9,32,18,14,8,15,10,5,15,NOVEMBER
SULAWESI BARAT,MAMUJU,TOMMO,TAMEJARRA,62,38,20,4,4,2,0,9,4,3,1,17,9,9,0,1,13,9,4,5,8,1,7,0,10,10,0,2,NOVEMBER
SULAWESI BARAT,MAMUJU,TOMMO,RANTEMARIO,71,66,40,16,16,1,0,15,8,7,40,0,0,0,0,0,58,29,29,9,10,7,3,4,30,6,24,18,NOVEMBER
SULAWESI BARAT,MAMUJU,TOMMO,MALINO,56,63,20,17,10,6,1,12,6,1,9,3,4,2,2,2,29,5,24,0,29,6,23,0,52,17,35,29,NOVEMBER
SULAWESI BARAT,MAMUJU,TOMMO,KAKULLASANG,68,37,13,0,0,0,0,3,9,1,0,6,11,3,8,3,21,16,5,12,18,12,6,1,13,13,0,11,NOVEMBER
SULAWESI BARAT,MAMUJU,TOMMO,LELING,82,61,61,45,10,7,5,23,28,2,16,23,9,3,6,0,61,33,28,8,45,34,11,24,75,5,70,3,NOVEMBER
SULAWESI BARAT,MAMUJU,TOMMO,KALEPU,86,31,27,15,3,0,0,7,8,10,5,21,15,13,2,2,11,8,3,1,9,3,6,1,25,19,6,7,NOVEMBER
SULAWESI BARAT,MAMUJU,TOMMO,SANDANA,86,64,61,53,53,31,2,46,10,3,35,17,1,0,1,0,61,60,1,9,6,4,2,2,34,22,12,33,NOVEMBER
SULAWESI BARAT,MAMUJU,TOMMO,LELING BARAT,49,41,30,24,16,0,0,11,0,2,28,0,3,2,1,2,30,11,19,2,12,3,9,0,38,31,7,27,NOVEMBER
SULAWESI BARAT,MAMUJU,TOMMO,LELING UTARA,60,70,13,1,0,0,0,7,5,1,13,0,2,0,2,0,20,7,13,7,4,3,1,3,52,40,12,7,NOVEMBER
SULAWESI BARAT,MAMUJU,TOMMO,SALUDENGEN,61,45,34,23,16,5,2,4,4,18,1,9,5,5,0,4,45,14,31,13,0,0,0,0,26,20,6,6,NOVEMBER
SULAWESI BARAT,MAMUJU,SIMBORO DAN KEPULAUAN,SIMBORO,68,60,49,48,36,24,3,42,0,0,14,12,3,1,2,0,18,16,2,4,8,5,3,4,39,29,10,39,NOVEMBER
SULAWESI BARAT,MAMUJU,SIMBORO DAN KEPULAUAN,RANGAS,66,21,20,14,9,4,3,8,9,0,9,2,10,0,10,0,13,10,3,8,9,9,0,4,7,0,7,2,NOVEMBER
SULAWESI BARAT,MAMUJU,SIMBORO DAN KEPULAUAN,BOTTENG,85,75,15,6,3,0,0,7,4,1,6,2,7,1,6,1,40,8,32,7,27,14,13,8,35,5,30,20,NOVEMBER
SULAWESI BARAT,MAMUJU,SIMBORO DAN KEPULAUAN,SALETTO,92,14,1,0,0,0,0,1,0,0,0,0,11,10,1,8,14,14,0,0,8,1,7,1,11,10,1,8,NOVEMBER
SULAWESI BARAT,MAMUJU,SIMBORO DAN KEPULAUAN,SUMARE,44,63,61,44,42,35,22,31,6,0,10,16,8,0,8,0,56,14,42,14,36,4,32,1,68,12,56,54,NOVEMBER
SULAWESI BARAT,MAMUJU,SIMBORO DAN KEPULAUAN,BOTTENG UTARA,48,58,25,4,4,3,0,12,4,1,22,2,8,4,4,3,58,13,45,5,16,1,15,1,47,40,7,30,NOVEMBER
SULAWESI BARAT,MAMUJU,SIMBORO DAN KEPULAUAN,TAPANDULLU,42,16,0,0,0,0,0,0,0,0,0,0,4,3,1,0,10,8,2,4,2,2,0,0,11,7,4,11,NOVEMBER
SULAWESI BARAT,MAMUJU,SIMBORO DAN KEPULAUAN,PATI'DI,90,24,3,2,1,0,0,1,2,0,2,1,7,0,7,0,14,10,4,9,7,4,3,4,12,0,12,2,NOVEMBER
SULAWESI BARAT,MAMUJU,TAPALANG BARAT,DUNGKAIT,39,35,24,14,13,0,0,16,7,0,14,1,5,5,0,3,35,16,19,12,35,17,18,13,34,30,4,28,NOVEMBER
SULAWESI BARAT,MAMUJU,TAPALANG BARAT,LEBANI,91,62,5,5,0,0,0,0,3,0,0,4,16,5,11,0,48,12,36,0,1,0,1,0,18,15,3,2,NOVEMBER
SULAWESI BARAT,MAMUJU,TAPALANG BARAT,LABUANG RANO,100,29,13,5,4,4,4,0,2,7,2,2,7,7,0,7,17,17,0,16,16,16,0,6,7,5,2,5,NOVEMBER
SULAWESI BARAT,MAMUJU,TAPALANG BARAT,PASABU,42,50,50,42,20,0,0,6,43,1,15,32,5,3,2,1,15,15,0,11,0,0,0,0,1,0,1,0,NOVEMBER
SULAWESI BARAT,MAMUJU,TAPALANG BARAT,TANETE PAO,39,62,53,15,5,3,1,44,1,7,7,38,3,1,2,1,36,36,0,6,28,14,14,4,21,13,8,18,NOVEMBER
SULAWESI BARAT,MAMUJU,TAPALANG BARAT,PANGASAAN,32,57,52,27,17,7,0,51,0,0,34,13,0,0,0,0,48,13,35,13,24,20,4,19,9,4,5,8,NOVEMBER
SULAWESI BARAT,MAMUJU,TAPALANG BARAT,AHU,64,27,2,2,2,2,2,0,0,0,2,0,10,6,4,2,13,7,6,5,0,0,0,0,11,8,3,11,NOVEMBER
SULAWESI BARAT,MAMUJU,BONEHAU,BONEHAU,40,31,26,25,19,15,0,10,16,0,1,19,2,0,2,0,14,7,7,2,7,0,7,0,21,16,5,7,NOVEMBER
SULAWESI BARAT,MAMUJU,BONEHAU,SALUTIWO,86,63,29,28,10,5,3,0,17,8,25,0,1,0,1,0,60,27,33,9,5,3,2,2,19,2,17,13,NOVEMBER
SULAWESI BARAT,MAMUJU,BONEHAU,BUTTUADA,71,50,38,15,4,1,0,23,3,5,12,4,9,6,3,3,17,7,10,4,8,5,3,5,28,24,4,23,NOVEMBER
SULAWESI BARAT,MAMUJU,BONEHAU,TAMALEA,95,49,4,0,0,0,0,0,2,1,3,1,8,6,2,1,16,14,2,10,13,2,11,2,14,10,4,13,NOVEMBER
SULAWESI BARAT,MAMUJU,BONEHAU,LUMIKA,85,51,17,12,8,5,2,4,3,3,17,0,14,12,2,3,42,22,20,17,42,23,19,3,16,2,14,6,NOVEMBER
SULAWESI BARAT,MAMUJU,BONEHAU,MAPPU,82,52,34,1,1,0,0,24,3,2,22,2,8,7,1,5,23,17,6,6,22,16,6,12,30,6,24,20,NOVEMBER
SULAWESI BARAT,MAMUJU,BONEHAU,BANUADA,98,79,27,1,0,0,0,27,0,0,9,2,9,6,3,1,79,55,24,16,52,5,47,1,40,4,36,22,NOVEMBER
SULAWESI BARAT,MAMUJU,BONEHAU,HINUA,45,55,50,3,2,0,0,48,1,1,20,14,6,4,2,1,18,6,12,5,4,0,4,0,9,4,5,9,NOVEMBER
SULAWESI BARAT,MAMUJU,BONEHAU,KINATANG,51,42,28,28,6,2,1,3,16,2,14,2,3,0,3,0,15,15,0,8,7,4,3,0,16,0,16,9,NOVEMBER
SULAWESI BARAT,MAMUJU,KEP. BALA BALAKANG,BALA BALAKANG,38,48,25,20,11,8,6,17,1,0,24,1,1,1,0,1,17,14,3,0,11,2,9,2,19,12,7,8,NOVEMBER
SULAWESI BARAT,MAMUJU,KEP. BALA BALAKANG,BALA-BALAKANG TIMUR,79,12,6,2,2,1,0,1,2,0,0,2,5,1,4,1,10,8,2,2,4,2,2,2,8,4,4,7,NOVEMBER
SULAWESI BARAT,MAMUJU TENGAH,TOBADAK,MAHAHE,87,46,20,8,1,1,0,1,16,2,4,9,4,1,3,0,29,26,3,21,13,8,5,2,43,43,0,35,DESEMBER
SULAWESI BARAT,MAMUJU TENGAH,TOBADAK,SALOBAJA,49,56,43,8,0,0,0,19,22,0,35,8,5,0,5,0,28,7,21,5,15,4,11,4,44,19,25,6,DESEMBER
SULAWESI BARAT,MAMUJU TENGAH,TOBADAK,TOBADAK,55,66,40,40,26,3,3,32,5,0,27,7,1,1,0,1,50,45,5,40,43,31,12,18,60,30,30,4,DESEMBER
SULAWESI BARAT,MAMUJU TENGAH,TOBADAK,PALONGAAN,99,17,6,1,0,0,0,6,0,0,6,0,13,10,3,7,12,8,4,1,8,1,7,1,9,7,2,9,DESEMBER
SULAWESI BARAT,MAMUJU TENGAH,TOBADAK,BATU PARIGI,84,75,54,37,0,0,0,53,1,0,16,19,10,4,6,3,69,10,59,4,41,28,13,4,16,0,16,3,DESEMBER
SULAWESI BARAT,MAMUJU TENGAH,TOBADAK,BAMBADARU,78,79,60,40,20,4,0,40,15,5,24,32,11,1,10,0,56,13,43,3,35,32,3,16,8,4,4,2,DESEMBER
SULAWESI BARAT,MAMUJU TENGAH,TOBADAK,SEJATI,40,71,55,27,22,10,5,12,4,24,3,18,8,6,2,4,25,14,11,0,13,1,12,0,12,6,6,2,DESEMBER
SULAWESI BARAT,MAMUJU TENGAH,TOBADAK,SALOADAK,92,45,25,6,2,1,1,19,2,3,22,1,16,7,9,5,37,22,15,4,27,1,26,0,53,0,53,28,DESEMBER
SULAWESI BARAT,MAMUJU TENGAH,PANGALE,POLO PANGALE,82,37,8,3,1,0,0,8,0,0,4,4,16,4,12,4,23,12,11,11,8,6,2,4,31,23,8,31,DESEMBER
SULAWESI BARAT,MAMUJU TENGAH,PANGALE,PANGALE,83,69,7,5,5,0,0,3,0,1,6,1,1,1,0,0,33,12,21,4,16,1,15,0,0,0,0,0,DESEMBER
SULAWESI BARAT,MAMUJU TENGAH,PANGALE,SARTANAMAJU,88,31,11,7,0,0,0,4,6,1,7,4,5,2,3,2,17,6,11,6,15,7,8,5,27,8,19,8,DESEMBER
SULAWESI BARAT,MAMUJU TENGAH,PANGALE,POLO LERENG,75,33,12,2,1,1,0,10,2,0,6,6,6,3,3,0,27,12,15,11,2,2,0,1,19,11,8,15,DESEMBER
SULAWESI BARAT,MAMUJU TENGAH,PANGALE,KUO,39,35,9,6,3,3,2,4,1,1,2,2,4,2,2,0,18,15,3,11,16,7,9,3,2,1,1,0,DESEMBER
SULAWESI BARAT,MAMUJU TENGAH,PANGALE,POLO CAMBA,77,56,48,1,1,0,0,7,13,6,22,9,8,6,2,5,20,15,5,12,4,0,4,0,2,1,1,1,DESEMBER
SULAWESI BARAT,MAMUJU TENGAH,PANGALE,LAMBA-LAMBA,94,37,33,30,22,0,0,15,16,0,17,0,1,1,0,0,36,6,30,4,21,9,12,0,37,4,33,4,DESEMBER
SULAWESI BARAT,MAMUJU TENGAH,PANGALE,KOMBILING,79,22,7,0,0,0,0,6,1,0,1,1,9,2,7,2,21,5,16,4,13,7,6,0,4,4,0,4,DESEMBER
SULAWESI BARAT,MAMUJU TENGAH,PANGALE,LEMO-LEMO,68,62,32,9,0,0,0,3,14,6,23,7,11,7,4,5,37,21,16,17,3,0,3,0,40,40,0,5,DESEMBER
SULAWESI BARAT,MAMUJU TENGAH,BUDONG-BUDONG,BABANA,70,16,1,1,0,0,0,1,0,0,0,1,2,0,2,0,13,6,7,4,10,3,7,2,11,6,5,10,DESEMBER
SULAWESI BARAT,MAMUJU TENGAH,BUDONG-BUDONG,LUMU,32,11,11,2,0,0,0,8,3,0,6,0,5,3,2,1,11,11,0,2,5,0,5,0,1,1,0,0,DESEMBER
SULAWESI BARAT,MAMUJU TENGAH,BUDONG-BUDONG,PONTANAKAYANG,61,74,25,25,6,5,5,17,0,2,13,5,6,2,4,0,73,72,1,10,3,1,2,0,25,13,12,20,DESEMBER
SULAWESI BARAT,MAMUJU TENGAH,BUDONG-BUDONG,SALOGATTA,30,63,35,12,7,3,1,4,2,24,2,2,2,0,2,0,36,22,14,2,16,13,3,6,29,13,16,13,DESEMBER
SULAWESI BARAT,MAMUJU TENGAH,BUDONG-BUDONG,KIRE,65,48,42,14,13,8,7,16,5,8,24,6,8,7,1,2,41,17,24,8,23,16,7,9,18,16,2,10,DESEMBER
SULAWESI BARAT,MAMUJU TENGAH,BUDONG-BUDONG,TINALI,90,79,75,68,30,5,5,10,35,6,3,16,6,3,3,2,19,19,0,5,5,5,0,4,54,51,3,10,DESEMBER
SULAWESI BARAT,MAMUJU TENGAH,BUDONG-BUDONG,SALUMANURUNG,93,64,54,34,16,7,7,44,3,0,3,19,8,2,6,0,56,24,32,19,15,2,13,2,20,19,1,3,DESEMBER
SULAWESI BARAT,MAMUJU TENGAH,BUDONG-BUDONG,PASAPA,79,39,8,1,1,0,0,7,1,0,2,2,13,2,11,2,13,5,8,4,0,0,0,0,7,7,0,6,DESEMBER
SULAWESI BARAT,MAMUJU TENGAH,BUDONG-BUDONG,BOJO,78,71,45,20,12,6,1,21,5,12,2,38,0,0,0,0,45,9,36,8,35,5,30,4,47,8,39,37,DESEMBER
SULAWESI BARAT,MAMUJU TENGAH,BUDONG-BUDONG,BARAKKANG,77,57,45,27,14,2,2,39,3,1,9,18,5,4,1,3,38,32,6,25,10,8,2,3,21,16,5,4,DESEMBER
SULAWESI BARAT,MAMUJU TENGAH,BUDONG-BUDONG,LEMBAH HADA,76,18,12,1,0,0,0,10,0,1,2,1,13,6,7,0,10,5,5,0,3,2,1,1,0,0,0,0,DESEMBER
SULAWESI BARAT,MAMUJU TENGAH,TOPOYO,BUDONG-BUDONG,32,22,8,4,2,2,1,0,7,0,4,3,6,0,6,0,19,17,2,11,9,0,9,0,15,14,1,10,DESEMBER
SULAWESI BARAT,MAMUJU TENGAH,TOPOYO,TOPOYO,40,30,29,7,5,4,0,24,3,1,20,3,7,0,7,0,29,12,17,1,0,0,0,0,12,2,10,7,DESEMBER
SULAWESI BARAT,MAMUJU TENGAH,TOPOYO,TUMBU,62,11,1,1,0,0,0,0,0,0,0,1,3,1,2,1,10,5,5,2,9,1,8,1,6,4,2,6,DESEMBER
SULAWESI BARAT,MAMUJU TENGAH,TOPOYO,KABUBU,98,66,42,14,10,4,2,35,4,0,21,17,5,5,0,5,33,29,4,12,25,7,18,1,55,21,34,1,DESEMBER
SULAWESI BARAT,MAMUJU TENGAH,TOPOYO,WAEPUTEH,40,59,56,29,29,13,11,34,3,2,50,1,7,2,5,2,25,17,8,15,20,9,11,9,13,9,4,0,DESEMBER
SULAWESI BARAT,MAMUJU TENGAH,TOPOYO,TANGKOU,37,16,8,5,4,4,0,0,1,0,5,1,7,7,0,6,13,12,1,2,10,8,2,8,11,7,4,2,DESEMBER
SULAWESI BARAT,MAMUJU TENGAH,TOPOYO,TABOLANG,80,12,11,8,8,6,2,4,5,0,7,1,7,5,2,1,11,8,3,7,1,1,0,0,7,1,6,5,DESEMBER
SULAWESI BARAT,MAMUJU TENGAH,TOPOYO,PARAILI,85,46,10,6,0,0,0,6,4,0,5,1,2,2,0,1,38,17,21,14,4,4,0,0,31,9,22,21,DESEMBER
SULAWESI BARAT,MAMUJU TENGAH,TOPOYO,SALUPANGKANG,83,42,21,13,0,0,0,2,9,3,11,1,12,1,11,1,27,16,11,6,9,9,0,1,5,1,4,0,DESEMBER
SULAWESI BARAT,MAMUJU TENGAH,TOPOYO,SALUPANGKANG IV,57,58,16,3,0,0,0,5,5,2,9,4,6,3,3,3,47,6,41,5,47,44,3,20,31,17,14,4,DESEMBER
SULAWESI BARAT,MAMUJU TENGAH,TOPOYO,TAPPILINA,85,50,16,8,6,6,3,1,3,9,8,0,10,3,7,2,20,6,14,2,1,1,0,0,30,24,6,11,DESEMBER
SULAWESI BARAT,MAMUJU TENGAH,TOPOYO,BAMBAMANURUNG,80,75,28,23,18,13,3,13,2,0,25,1,12,6,6,1,38,11,27,2,37,28,9,13,43,17,26,5,DESEMBER
SULAWESI BARAT,MAMUJU TENGAH,TOPOYO,SALULEKBO,85,22,22,18,0,0,0,21,0,1,17,1,13,13,0,3,19,9,10,0,12,4,8,4,25,5,20,0,DESEMBER
SULAWESI BARAT,MAMUJU TENGAH,TOPOYO,PANGALLOANG,53,48,3,2,2,0,0,3,0,0,3,0,0,0,0,0,14,13,1,8,8,2,6,0,31,30,1,23,DESEMBER
SULAWESI BARAT,MAMUJU TENGAH,TOPOYO,SINABATTA,55,60,9,6,6,4,3,0,1,0,3,5,5,3,2,0,39,8,31,8,3,3,0,1,3,0,3,0,DESEMBER
SULAWESI BARAT,MAMUJU TENGAH,KAROSSA,KAROSSA,39,56,51,0,0,0,0,8,39,0,5,35,7,0,7,0,15,14,1,14,9,1,8,1,15,12,3,10,DESEMBER
SULAWESI BARAT,MAMUJU TENGAH,KAROSSA,TASOKKO,74,61,41,12,10,3,3,32,3,1,28,1,12,11,1,0,22,13,9,6,12,4,8,2,4,4,0,0,DESEMBER
SULAWESI BARAT,MAMUJU TENGAH,KAROSSA,LARA,48,31,10,3,2,1,1,2,5,2,4,0,3,3,0,0,29,24,5,11,2,2,0,0,6,2,4,2,DESEMBER
SULAWESI BARAT,MAMUJU TENGAH,KAROSSA,KADAILA,55,50,17,2,2,1,0,7,0,6,13,0,7,7,0,4,39,14,25,11,6,6,0,5,36,2,34,11,DESEMBER
SULAWESI BARAT,MAMUJU TENGAH,KAROSSA,KAYU CALLA,70,37,4,0,0,0,0,0,3,1,2,0,1,1,0,0,21,13,8,2,9,6,3,1,6,6,0,0,DESEMBER
SULAWESI BARAT,MAMUJU TENGAH,KAROSSA,LEMBAH HOPO,47,10,2,0,0,0,0,2,0,0,1,1,5,5,0,3,10,7,3,6,1,1,0,0,5,3,2,1,DESEMBER
SULAWESI BARAT,MAMUJU TENGAH,KAROSSA,BENGGAULU,81,67,17,1,1,1,1,11,3,2,9,1,16,12,4,1,35,33,2,13,17,8,9,4,8,0,8,4,DESEMBER
SULAWESI BARAT,MAMUJU TENGAH,KAROSSA,SUKA MAJU,34,27,19,14,14,14,10,4,0,0,7,1,1,1,0,1,25,17,8,1,11,8,3,8,17,7,10,7,DESEMBER
SULAWESI BARAT,MAMUJU TENGAH,KAROSSA,KAMBUNONG,32,44,21,20,1,0,0,19,0,0,17,1,0,0,0,0,34,12,22,0,8,6,2,2,1,1,0,0,DESEMBER
SULAWESI BARAT,MAMUJU TENGAH,KAROSSA,SALUBIRO,59,73,23,9,7,6,5,10,6,0,12,4,8,5,3,4,13,6,7,3,5,3,2,3,11,3,8,11,DESEMBER
SULAWESI BARAT,MAMUJU TENGAH,KAROSSA,SANJANGO,31,41,38,19,13,7,3,17,6,3,9,14,6,5,1,4,26,14,12,3,18,16,2,9,39,19,20,25,DESEMBER
SULAWESI BARAT,PASANGKAYU,BAMBAIRA,TAMPAURE,74,67,6,6,2,1,1,5,0,0,2,3,9,4,5,3,41,36,5,9,23,15,8,10,35,13,22,14,DESEMBER
SULAWESI BARAT,PASANGKAYU,BAMBAIRA,BAMBAIRA,50,38,24,2,2,2,0,11,1,3,24,0,1,1,0,0,15,12,3,3,5,3,2,2,19,14,5,19,DESEMBER
SULAWESI BARAT,PASANGKAYU,BAMBAIRA,KASOLOANG,30,23,1,1,1,1,0,1,0,0,1,0,6,2,4,1,22,8,14,2,5,5,0,5,10,9,1,7,DESEMBER
SULAWESI BARAT,PASANGKAYU,BAMBAIRA,KALUKU NANGKA,59,80,66,62,35,26,13,50,1,0,12,42,8,5,3,1,32,28,4,20,1,0,1,0,41,10,31,5,DESEMBER
SULAWESI BARAT,PASANGKAYU,BAMBALAMOTU,RANDOMAYANG,76,21,19,8,8,5,0,6,8,5,8,4,11,0,11,0,14,11,3,11,7,2,5,0,5,0,5,0,DESEMBER
SULAWESI BARAT,PASANGKAYU,BAMBALAMOTU,BAMBALAMOTU,44,50,13,8,4,1,1,7,2,3,4,1,6,6,0,3,46,33,13,9,22,14,8,9,56,9,47,38,DESEMBER
SULAWESI BARAT,PASANGKAYU,BAMBALAMOTU,POLEWALI,60,45,1,1,0,0,0,0,0,1,0,0,6,3,3,3,39,39,0,38,0,0,0,0,16,9,7,2,DESEMBER
SULAWESI BARAT,PASANGKAYU,BAMBALAMOTU,PANGIANG,83,66,46,38,19,13,3,10,31,2,16,11,3,2,1,0,52,41,11,5,37,21,16,13,48,12,36,15,DESEMBER
SULAWESI BARAT,PASANGKAYU,BAMBALAMOTU,KALOLA,84,24,10,10,3,0,0,8,0,2,6,0,15,2,13,1,17,10,7,1,10,3,7,2,8,0,8,7,DESEMBER
SULAWESI BARAT,PASANGKAYU,BAMBALAMOTU,WULAI,57,26,15,3,0,0,0,13,1,1,1,4,7,6,1,6,23,21,2,11,6,4,2,1,10,9,1,10,DESEMBER
SULAWESI BARAT,PASANGKAYU,BARAS,BARAS,69,77,62,57,5,4,3,52,7,0,33,9,8,4,4,0,55,32,23,25,18,11,7,0,32,22,10,7,DESEMBER
SULAWESI BARAT,PASANGKAYU,BARAS,BULU PARIGI,94,31,21,9,2,1,1,11,0,0,0,9,14,7,7,0,19,12,7,9,9,0,9,0,19,18,1,9,DESEMBER
SULAWESI BARAT,PASANGKAYU,BARAS,BALANTI,90,54,7,5,1,0,0,6,0,0,1,2,1,1,0,1,17,14,3,8,7,1,6,0,23,6,17,9,DESEMBER
SULAWESI BARAT,PASANGKAYU,BARAS,MOTU,50,76,22,0,0,0,0,17,1,2,0,0,8,5,3,3,34,34,0,23,20,6,14,3,54,36,18,53,DESEMBER
SULAWESI BARAT,PASANGKAYU,BARAS,TOWONI,92,43,21,16,2,2,2,10,2,3,20,1,10,4,6,3,18,7,11,5,16,16,0,11,10,2,8,7,DESEMBER
SULAWESI BARAT,PASANGKAYU,BARAS,KASANO,48,15,10,8,2,2,1,6,0,3,1,8,4,2,2,2,13,11,2,5,0,0,0,0,5,2,3,5,DESEMBER
SULAWESI BARAT,PASANGKAYU,BULU TABA,SUMBER SARI,84,33,24,7,3,1,1,12,4,5,14,5,8,2,6,2,18,10,8,10,11,4,7,2,33,33,0,24,DESEMBER
SULAWESI BARAT,PASANGKAYU,BULU TABA,LELEJAE,83,28,8,4,0,0,0,3,2,2,3,1,6,0,6,0,16,11,5,6,6,6,0,5,18,5,13,16,DESEMBER
SULAWESI BARAT,PASANGKAYU,BULU TABA,BUKIT HARAPAN,89,80,11,10,4,1,1,5,3,2,9,2,16,11,5,3,35,9,26,0,30,22,8,6,59,0,59,33,DESEMBER
SULAWESI BARAT,PASANGKAYU,BULU TABA,LILIMORI,52,79,58,14,9,6,1,2,52,2,17,25,6,6,0,3,21,15,6,7,13,12,1,6,17,11,6,4,DESEMBER
SULAWESI BARAT,PASANGKAYU,BULU TABA,KARAVE,76,64,13,4,4,2,1,6,2,0,4,2,13,6,7,6,62,51,11,37,47,3,44,2,2,2,0,2,DESEMBER
SULAWESI BARAT,PASANGKAYU,BULU TABA,KASTABUANA,48,75,0,0,0,0,0,0,0,0,0,0,5,5,0,1,14,11,3,10,13,9,4,6,34,5,29,15,DESEMBER
SULAWESI BARAT,PASANGKAYU,BULU TABA,OMPI,71,45,8,7,6,3,0,1,6,1,5,1,5,4,1,4,13,6,7,3,1,1,0,0,27,6,21,13,DESEMBER
SULAWESI BARAT,PASANGKAYU,DAPURANG,DAPURANG,34,25,22,11,2,1,0,13,8,0,19,1,1,1,0,0,12,11,1,10,5,0,5,0,22,15,7,3,DESEMBER
SULAWESI BARAT,PASANGKAYU,DAPURANG,BENGGAULU,91,32,23,23,12,1,0,17,0,1,17,1,5,2,3,0,28,23,5,16,12,5,7,5,9,6,3,9,DESEMBER
SULAWESI BARAT,PASANGKAYU,DAPURANG,TIRTABUANA,30,38,1,0,0,0,0,0,1,0,1,0,4,0,4,0,10,8,2,2,9,6,3,3,29,5,24,2,DESEMBER
SULAWESI BARAT,PASANGKAYU,DAPURANG,BULU BONGGU,69,50,38,20,1,1,0,18,10,4,13,21,7,7,0,1,16,6,10,5,7,1,6,0,0,0,0,0,DESEMBER
SULAWESI BARAT,PASANGKAYU,DAPURANG,SARASA,41,30,11,5,5,3,3,3,1,3,0,4,3,1,2,0,21,12,9,9,19,10,9,6,38,8,30,33,DESEMBER
SULAWESI BARAT,PASANGKAYU,DURIPOKU,TAMMARUNANG,51,62,34,25,15,5,2,8,10,7,9,14,8,3,5,1,28,6,22,1,21,18,3,6,48,24,24,13,DESEMBER
SULAWESI BARAT,PASANGKAYU,DURIPOKU,SAPTANAJAYA,62,44,21,9,8,6,6,8,0,5,14,4,3,0,3,0,41,40,1,37,9,6,3,0,9,2,7,6,DESEMBER
SULAWESI BARAT,PASANGKAYU,DURIPOKU,TARANGGI,87,28,5,1,0,0,0,5,0,0,4,1,4,2,2,0,13,8,5,6,0,0,0,0,5,4,1,4,DESEMBER
SULAWESI BARAT,PASANGKAYU,DURIPOKU,SIPAKAINGA,87,70,35,20,10,4,2,5,0,5,5,4,14,12,2,12,58,45,13,28,23,21,2,20,50,18,32,19,DESEMBER
SULAWESI BARAT,PASANGKAYU,LARIANG,KULU,74,32,26,11,7,3,0,25,0,0,8,12,6,6,0,2,29,27,2,3,13,8,5,0,2,2,0,1,DESEMBER
SULAWESI BARAT,PASANGKAYU,LARIANG,PARABU,80,35,11,11,8,2,0,0,2,7,7,1,4,0,4,0,24,19,5,2,11,6,5,3,6,5,1,5,DESEMBER
SULAWESI BARAT,PASANGKAYU,LARIANG,KENANGAN,95,54,22,7,3,1,1,8,2,8,5,6,5,3,2,2,47,15,32,15,24,10,14,9,38,13,25,7,DESEMBER
SULAWESI BARAT,PASANGKAYU,LARIANG,BAJAWALI,93,46,6,1,1,0,0,6,0,0,3,0,7,5,2,3,45,30,15,18,19,16,3,0,46,29,17,41,DESEMBER
SULAWESI BARAT,PASANGKAYU,LARIANG,SINGGANI,40,31,4,3,1,0,0,0,4,0,0,0,3,0,3,0,22,19,3,13,15,1,14,0,14,2,12,5,DESEMBER
SULAWESI BARAT,PASANGKAYU,LARIANG,BATU MATORU,49,71,52,8,1,0,0,52,0,0,24,7,7,1,6,0,30,6,24,1,7,1,6,1,52,4,48,38,DESEMBER
SULAWESI BARAT,PASANGKAYU,LARIANG,BAMBAKORO,75,47,10,9,0,0,0,1,4,0,8,1,12,8,4,3,32,30,2,1,19,6,13,4,27,7,20,0,DESEMBER
SULAWESI BARAT,PASANGKAYU,PASANGKAYU,KARYA BERSAMA,35,41,23,6,6,6,2,18,2,0,2,18,7,4,3,2,27,20,7,3,27,20,7,5,15,14,1,0,DESEMBER
SULAWESI BARAT,PASANGKAYU,PASANGKAYU,AKO,74,42,20,5,2,1,0,18,2,0,16,0,1,0,1,0,25,8,17,7,4,1,3,0,33,4,29,7,DESEMBER
SULAWESI BARAT,PASANGKAYU,PASANGKAYU,PASANGKAYU,57,77,45,32,25,1,0,45,0,0,26,7,4,3,1,1,65,19,46,18,16,2,14,0,29,3,26,9,DESEMBER
SULAWESI BARAT,PASANGKAYU,PASANGKAYU,MARTAJAYA,94,18,15,6,6,3,3,7,0,5,6,5,15,15,0,10,16,15,1,13,5,5,0,2,14,9,5,13,DESEMBER
SULAWESI BARAT,PASANGKAYU,PASANGKAYU,PAKAVA,85,25,23,12,8,2,0,7,5,5,7,0,17,5,12,5,13,8,5,0,9,4,5,1,9,5,4,2,DESEMBER
SULAWESI BARAT,PASANGKAYU,PASANGKAYU,GUNUNG SARI,41,32,14,2,1,0,0,4,4,3,5,6,4,4,0,1,24,9,15,6,13,11,2,4,12,9,3,3,DESEMBER
SULAWESI BARAT,PASANGKAYU,PEDONGGA,MALEI,87,31,21,5,2,1,1,12,4,1,18,1,5,3,2,2,12,9,3,6,8,2,6,2,11,0,11,1,DESEMBER
SULAWESI BARAT,PASANGKAYU,PEDONGGA,PEDANDA,74,11,0,0,0,0,0,0,0,0,0,0,11,1,10,0,11,11,0,3,11,7,4,3,16,8,8,13,DESEMBER
SULAWESI BARAT,PASANGKAYU,PEDONGGA,BATU OGE,84,72,58,36,20,12,10,1,45,1,8,50,13,10,3,6,59,57,2,3,39,24,15,18,86,64,22,21,DESEMBER
SULAWESI BARAT,PASANGKAYU,PEDONGGA,MARTASARI,51,64,55,5,2,2,2,35,2,11,19,6,10,4,6,1,55,25,30,0,24,9,15,7,57,43,14,31,DESEMBER
SULAWESI BARAT,PASANGKAYU,SARJO,SARJO,95,29,8,2,1,1,0,4,0,2,7,0,14,11,3,4,25,6,19,6,21,0,21,0,31,13,18,8,DESEMBER
SULAWESI BARAT,PASANGKAYU,SARJO,MAPONU,37,59,33,27,14,11,6,5,14,4,15,6,2,1,1,1,49,32,17,5,36,9,27,9,21,8,13,3,DESEMBER
SULAWESI BARAT,PASANGKAYU,SARJO,LETAWA,83,15,15,1,0,0,0,1,4,9,1,14,7,5,2,0,11,6,5,4,11,10,1,8,13,0,13,5,DESEMBER
SULAWESI BARAT,PASANGKAYU,SARJO,SARUDE,43,38,11,4,1,0,0,11,0,0,5,2,8,4,4,4,28,20,8,6,1,1,0,1,13,5,8,3,DESEMBER
SULAWESI BARAT,PASANGKAYU,SARUDU,DODA,35,56,46,38,18,11,9,29,5,0,5,17,5,5,0,4,12,8,4,5,11,7,4,3,50,37,13,12,DESEMBER
SULAWESI BARAT,PASANGKAYU,SARUDU,SARUDU,50,49,23,10,3,3,2,19,1,1,16,7,2,2,0,2,38,22,16,15,3,2,1,2,28,6,22,13,DESEMBER
SULAWESI BARAT,PASANGKAYU,SARUDU,BULU MARIO,41,75,0,0,0,0,0,0,0,0,0,0,0,0,0,0,42,15,27,14,5,1,4,1,34,5,29,15,DESEMBER
SULAWESI BARAT,PASANGKAYU,SARUDU,KUMASARI,47,51,30,20,8,8,0,18,3,3,13,11,3,0,3,0,12,7,5,7,10,4,6,3,18,5,13,14,DESEMBER
SULAWESI BARAT,PASANGKAYU,SARUDU,PATIKA,34,31,6,6,3,1,1,4,1,0,3,3,3,3,0,2,17,7,10,1,1,1,0,0,9,0,9,4,DESEMBER
SULAWESI BARAT,PASANGKAYU,TIKKE RAYA,MAKMUR JAYA,80,22,17,2,2,0,0,0,0,14,2,7,0,0,0,0,15,8,7,8,2,2,0,1,6,3,3,3,DESEMBER
SULAWESI BARAT,PASANGKAYU,TIKKE RAYA,LARIANG,53,24,22,18,16,2,0,3,19,0,17,2,7,2,5,2,14,9,5,4,9,6,3,2,4,0,4,4,DESEMBER
SULAWESI BARAT,PASANGKAYU,TIKKE RAYA,TIKKE,46,76,69,20,1,0,0,44,13,12,27,25,8,6,2,3,54,54,0,30,18,9,9,8,36,30,6,23,DESEMBER
SULAWESI BARAT,PASANGKAYU,TIKKE RAYA,PAJALELE,67,59,44,11,8,4,1,9,8,3,25,10,0,0,0,0,20,10,10,0,14,3,11,1,17,12,5,10,DESEMBER
SULAWESI BARAT,PASANGKAYU,TIKKE RAYA,JENGENG RAYA,80,53,28,9,7,0,0,9,17,1,5,23,1,1,0,1,10,6,4,5,5,1,4,0,35,27,8,9,DESEMBER
SULAWESI BARAT,MAJENE,BANGGAE,BANGGAE,79,31,24,2,0,0,0,7,6,11,19,4,2,2,0,1,13,13,0,2,2,0,2,0,21,17,4,16,DESEMBER
SULAWESI BARAT,MAJENE,BANGGAE,BARU,58,40,21,7,1,0,0,12,1,3,4,2,7,5,2,1,34,10,24,4,11,11,0,4,1,0,1,1,DESEMBER
SULAWESI BARAT,MAJENE,BANGGAE,PANGALI ALI,80,51,16,14,7,1,1,5,0,3,8,3,9,0,9,0,30,28,2,26,20,20,0,19,51,19,32,10,DESEMBER
SULAWESI BARAT,MAJENE,BANGGAE,TOTOLI,54,33,0,0,0,0,0,0,0,0,0,0,3,3,0,3,14,7,7,0,6,6,0,4,14,12,2,4,DESEMBER
SULAWESI BARAT,MAJENE,BANGGAE,RANGAS,79,64,2,2,2,1,1,1,0,0,1,0,15,14,1,8,33,28,5,23,6,5,1,1,15,10,5,10,DESEMBER
SULAWESI BARAT,MAJENE,BANGGAE,GALUNG,40,61,19,17,8,2,2,5,8,0,10,3,1,1,0,0,44,39,5,23,23,23,0,2,44,30,14,3,DESEMBER
SULAWESI BARAT,MAJENE,BANGGAE,PALIPI SOREANG,97,53,38,25,2,0,0,7,1,14,27,8,1,0,1,0,40,11,29,10,13,3,10,0,46,2,44,8,DESEMBER
SULAWESI BARAT,MAJENE,BANGGAE,PAMBOBORANG,72,64,4,3,2,1,0,3,1,0,4,0,5,2,3,1,32,19,13,7,10,2,8,0,4,0,4,4,DESEMBER
SULAWESI BARAT,MAJENE,BANGGAE TIMUR,BAURUNG,89,54,29,29,19,5,4,25,0,0,27,1,13,9,4,4,44,25,19,6,13,13,0,6,7,6,1,0,DESEMBER
SULAWESI BARAT,MAJENE,BANGGAE TIMUR,BARUGA,82,35,23,8,0,0,0,1,11,11,21,0,11,1,10,0,13,8,5,0,6,4,2,1,27,20,7,7,DESEMBER
SULAWESI BARAT,MAJENE,BANGGAE TIMUR,BARUGA DHUA,64,72,2,1,1,1,0,2,0,0,2,0,6,1,5,0,63,17,46,16,60,1,59,0,110,32,78,37,DESEMBER
SULAWESI BARAT,MAJENE,BANGGAE TIMUR,LABUANG,75,23,4,2,1,1,0,0,3,0,0,4,2,0,2,0,21,5,16,5,9,4,5,1,21,8,13,1,DESEMBER
SULAWESI BARAT,MAJENE,BANGGAE TIMUR,TANDE,72,20,9,3,0,0,0,1,7,0,7,1,13,4,9,2,17,9,8,5,17,3,14,2,11,8,3,10,DESEMBER
SULAWESI BARAT,MAJENE,BANGGAE TIMUR,LEMBANG,82,35,4,4,3,3,0,0,4,0,0,2,14,0,14,0,11,9,2,4,9,9,0,2,2,1,1,0,DESEMBER
SULAWESI BARAT,MAJENE,BANGGAE TIMUR,LABUANG UTARA,32,10,4,1,0,0,0,4,0,0,1,0,1,1,0,1,10,7,3,7,8,2,6,2,0,0,0,0,DESEMBER
SULAWESI BARAT,MAJENE,BANGGAE TIMUR,TANDE TIMUR,43,29,13,12,9,9,1,5,7,0,12,0,8,6,2,6,15,8,7,8,13,2,11,1,22,9,13,22,DESEMBER
SULAWESI BARAT,MAJENE,BANGGAE TIMUR,BUTTU BARUGA,70,42,40,39,25,20,13,27,0,0,12,7,9,3,6,0,25,16,9,5,18,11,7,9,39,11,28,32,DESEMBER
SULAWESI BARAT,MAJENE,MALUNDA,MALUNDA,45,16,10,0,0,0,0,4,5,1,8,1,5,4,1,1,11,8,3,8,1,0,1,0,8,3,5,4,DESEMBER
SULAWESI BARAT,MAJENE,MALUNDA,LAMUNGANG BATU,78,64,14,1,0,0,0,7,7,0,12,2,8,0,8,0,62,21,41,6,19,2,17,1,52,6,46,33,DESEMBER
SULAWESI BARAT,MAJENE,MALUNDA,BAMBANGAN,86,62,45,45,20,17,0,35,2,4,25,20,17,13,4,9,28,16,12,5,2,2,0,0,24,11,13,7,DESEMBER
SULAWESI BARAT,MAJENE,MALUNDA,LOMBANG,79,18,15,6,1,1,1,10,0,2,7,4,9,6,3,4,11,10,1,9,11,2,9,2,19,10,9,8,DESEMBER
SULAWESI BARAT,MAJENE,MALUNDA,LOMBONG,30,78,19,18,18,9,6,3,2,2,6,2,4,1,3,1,20,18,2,17,17,3,14,2,3,0,3,2,DESEMBER
SULAWESI BARAT,MAJENE,MALUNDA,MEKKATTA,42,34,15,7,6,3,1,1,5,7,12,1,8,3,5,2,31,14,17,12,1,0,1,0,17,9,8,5,DESEMBER
SULAWESI BARAT,MAJENE,MALUNDA,MALIAYA,37,67,57,9,9,1,1,17,13,10,29,6,4,2,2,1,32,10,22,9,13,10,3,0,43,23,20,15,DESEMBER
SULAWESI BARAT,MAJENE,MALUNDA,LOMBANG TIMUR,76,80,60,18,15,5,5,10,3,30,32,26,5,0,5,0,54,39,15,6,14,12,2,10,64,14,50,54,DESEMBER
SULAWESI BARAT,MAJENE,MALUNDA,SALUTAHONGAN,59,71,44,43,25,0,0,15,24,1,41,2,11,5,6,4,39,11,28,1,9,6,3,3,7,3,4,4,DESEMBER
SULAWESI BARAT,MAJENE,MALUNDA,LOMBONG TIMUR,77,75,31,29,13,0,0,10,19,2,2,11,2,1,1,1,38,23,15,11,1,1,0,0,47,27,20,30,DESEMBER
SULAWESI BARAT,MAJENE,MALUNDA,MEKKATTA SELATAN,76,60,3,3,3,1,1,2,0,0,3,0,12,3,9,3,23,19,4,12,17,17,0,15,8,6,2,6,DESEMBER
SULAWESI BARAT,MAJENE,MALUNDA,KAYUANGIN,52,61,15,0,0,0,0,9,0,5,9,6,0,0,0,0,38,19,19,18,13,4,9,3,3,1,2,2,DESEMBER
SULAWESI BARAT,MAJENE,PAMBOANG,LALAMPANUA,36,68,49,44,31,18,18,18,12,0,17,25,7,7,0,0,46,41,5,8,12,5,7,0,49,37,12,1,DESEMBER
SULAWESI BARAT,MAJENE,PAMBOANG,SIRINDU,53,69,37,7,0,0,0,33,0,3,7,4,5,5,0,2,59,35,24,28,1,1,0,0,26,4,22,12,DESEMBER
SULAWESI BARAT,MAJENE,PAMBOANG,ADOLANG,100,34,1,0,0,0,0,0,1,0,1,0,17,10,7,9,32,10,22,0,19,4,15,1,42,42,0,12,DESEMBER
SULAWESI BARAT,MAJENE,PAMBOANG,BABABULO,47,40,26,1,1,1,0,3,20,2,5,10,7,5,2,5,38,20,18,1,26,3,23,3,42,21,21,3,DESEMBER
SULAWESI BARAT,MAJENE,PAMBOANG,BONDE,97,35,11,7,4,1,1,0,10,0,1,2,19,1,18,1,16,9,7,8,6,0,6,0,18,8,10,4,DESEMBER
SULAWESI BARAT,MAJENE,PAMBOANG,BETTENG,39,34,5,3,0,0,0,2,2,1,1,0,5,5,0,4,18,16,2,10,16,14,2,10,11,10,1,0,DESEMBER
SULAWESI BARAT,MAJENE,PAMBOANG,SIMBANG,86,69,20,6,6,2,1,14,4,1,10,10,4,4,0,0,42,33,9,24,6,5,1,2,43,40,3,18,DESEMBER
SULAWESI BARAT,MAJENE,PAMBOANG,BONDE UTARA,100,72,1,1,0,0,0,1,0,0,0,0,20,20,0,16,12,8,4,3,10,4,6,3,1,0,1,0,DESEMBER
SULAWESI BARAT,MAJENE,PAMBOANG,BABABULO UTARA,42,23,7,0,0,0,0,2,0,5,5,2,1,1,0,1,11,7,4,7,3,1,2,1,2,0,2,2,DESEMBER
SULAWESI BARAT,MAJENE,PAMBOANG,BUTTU PAMBOANG,95,70,61,7,4,3,0,47,8,6,21,7,0,0,0,0,55,44,11,7,13,5,8,0,46,11,35,41,DESEMBER
SULAWESI BARAT,MAJENE,PAMBOANG,BANUA ADOLANG,57,46,7,5,1,0,0,3,0,1,5,1,8,2,6,0,15,8,7,3,13,11,2,5,16,3,13,15,DESEMBER
SULAWESI BARAT,MAJENE,PAMBOANG,ADOLANG DHUA,92,62,58,9,0,0,0,10,20,23,2,19,11,3,8,0,27,8,19,6,3,0,3,0,8,5,3,3,DESEMBER
SULAWESI BARAT,MAJENE,PAMBOANG,TINAMBUNG,66,32,18,17,8,7,2,11,0,5,15,1,3,1,2,1,24,20,4,15,10,7,3,4,18,3,15,12,DESEMBER
SULAWESI BARAT,MAJENE,PAMBOANG,PESULOANG,30,59,26,24,0,0,0,13,11,0,13,3,2,2,0,0,41,30,11,4,38,27,11,22,46,14,32,31,DESEMBER
SULAWESI BARAT,MAJENE,PAMBOANG,BALOMBONG,91,71,57,54,21,10,8,18,18,11,56,1,17,16,1,13,65,49,16,23,42,17,25,14,77,39,38,20,DESEMBER
SULAWESI BARAT,MAJENE,SENDANA,MOSSO,41,60,53,39,0,0,0,32,9,3,28,25,2,1,1,1,24,19,5,11,21,13,8,5,8,6,2,0,DESEMBER
SULAWESI BARAT,MAJENE,SENDANA,MOSSO DHUA,58,13,3,0,0,0,0,0,1,1,2,1,11,8,3,0,11,8,3,0,6,5,1,4,14,10,4,13,DESEMBER
SULAWESI BARAT,MAJENE,SENDANA,TOTOLISI SENDANA,37,57,49,44,28,25,18,10,0,17,37,8,0,0,0,0,54,36,18,6,1,1,0,0,10,9,1,9,DESEMBER
SULAWESI BARAT,MAJENE,SENDANA,TALLUBANUA,65,71,58,39,10,6,3,12,22,16,45,9,13,9,4,1,18,13,5,3,17,15,2,6,49,22,27,8,DESEMBER
SULAWESI BARAT,MAJENE,SENDANA,LALATEDZONG,88,53,41,27,21,5,0,20,14,3,2,22,17,10,7,7,35,12,23,12,31,3,28,3,28,3,25,23,DESEMBER
SULAWESI BARAT,MAJENE,SENDANA,BINANGA,57,68,43,29,15,6,5,27,2,0,39,3,9,8,1,8,63,51,12,36,4,0,4,0,35,5,30,29,DESEMBER
SULAWESI BARAT,MAJENE,SENDANA,PUTTADA,87,69,45,9,5,2,0,33,8,3,33,8,17,10,7,3,66,22,44,6,20,9,11,3,38,9,29,26,DESEMBER
SULAWESI BARAT,MAJENE,SENDANA,PAMINGGALAN,37,24,15,9,3,3,3,9,1,0,3,0,6,2,4,1,14,12,2,4,14,5,9,2,7,1,6,2,DESEMBER
SULAWESI BARAT,MAJENE,SENDANA,LEPPANGANG,82,39,27,10,10,5,3,18,5,1,3,19,10,1,9,1,31,30,1,23,4,1,3,0,5,1,4,4,DESEMBER
SULAWESI BARAT,MAJENE,SENDANA,PUNDAU,63,10,0,0,0,0,0,0,0,0,0,0,7,1,6,0,10,10,0,0,4,3,1,0,8,8,0,7,DESEMBER
SULAWESI BARAT,MAJENE,SENDANA,SENDANA,34,14,5,4,1,1,1,4,0,0,0,2,1,0,1,0,12,8,4,7,10,2,8,1,3,1,2,3,DESEMBER
SULAWESI BARAT,MAJENE,SENDANA,BANUA SENDANA,63,80,67,56,26,25,8,55,0,2,47,3,11,2,9,2,43,10,33,8,39,39,0,0,34,7,27,21,DESEMBER
SULAWESI BARAT,MAJENE,SENDANA,TALLUBANUA UTARA,46,60,45,35,12,3,0,39,5,1,3,18,6,2,4,1,36,10,26,4,23,14,9,13,50,42,8,2,DESEMBER
SULAWESI BARAT,MAJENE,SENDANA,LIMBORO RAMBU-RAMBU,67,21,21,1,0,0,0,9,8,3,9,0,2,1,1,0,21,10,11,8,21,12,9,0,33,0,33,20,DESEMBER
SULAWESI BARAT,MAJENE,SENDANA,LIMBUA,76,63,22,16,14,6,2,2,4,3,5,5,3,0,3,0,11,8,3,0,11,9,2,2,13,6,7,7,DESEMBER
SULAWESI BARAT,MAJENE,SENDANA,BUKIT SAMANG,85,59,19,15,5,4,3,5,2,2,13,5,17,6,11,6,34,8,26,6,2,0,2,0,36,15,21,6,DESEMBER
SULAWESI BARAT,MAJENE,TAMMERODO SENDANA,SEPPONG,79,10,9,3,0,0,0,4,4,1,1,0,4,3,1,1,10,5,5,4,5,1,4,1,8,2,6,7,DESEMBER
SULAWESI BARAT,MAJENE,TAMMERODO SENDANA,TAMMERODO,68,23,12,3,1,0,0,3,4,3,5,1,8,5,3,0,16,15,1,13,2,1,1,1,1,0,1,0,DESEMBER
SULAWESI BARAT,MAJENE,TAMMERODO SENDANA,ULIDANG,93,75,71,1,0,0,0,5,40,17,10,3,5,4,1,3,68,6,62,5,57,1,56,1,57,10,47,25,DESEMBER
SULAWESI BARAT,MAJENE,TAMMERODO SENDANA,TALLAMBALAO,63,46,19,18,15,14,10,6,0,3,17,1,10,4,6,4,45,36,9,12,6,5,1,4,34,7,27,6,DESEMBER
SULAWESI BARAT,MAJENE,TAMMERODO SENDANA,TAMMERODO UTARA,70,47,17,13,5,0,0,14,3,0,1,5,1,1,0,1,43,5,38,0,4,4,0,4,0,0,0,0,DESEMBER
SULAWESI BARAT,MAJENE,TAMMERODO SENDANA,MANYAMBA,75,69,62,48,43,12,5,56,0,0,28,22,15,1,14,1,66,58,8,44,53,17,36,14,36,0,36,28,DESEMBER
SULAWESI BARAT,MAJENE,TAMMERODO SENDANA,AWO,59,75,74,28,10,6,4,33,11,14,51,16,1,0,1,0,46,33,13,6,7,6,1,1,12,4,8,4,DESEMBER
SULAWESI BARAT,MAJENE,TUBO SENDANA,ONANG,97,32,25,9,8,8,0,9,4,6,13,9,14,4,10,0,32,15,17,7,32,13,19,5,3,1,2,1,DESEMBER
SULAWESI BARAT,MAJENE,TUBO SENDANA,TUBO,80,18,7,7,7,4,1,1,1,3,4,1,9,4,5,3,12,8,4,1,11,10,1,9,7,5,2,3,DESEMBER
SULAWESI BARAT,MAJENE,TUBO SENDANA,ONANG UTARA,77,12,0,0,0,0,0,0,0,0,0,0,4,3,1,3,10,9,1,0,2,0,2,0,1,1,0,1,DESEMBER
SULAWESI BARAT,MAJENE,TUBO SENDANA,TUBO SELATAN,59,19,19,19,14,1,0,9,9,1,13,4,10,3,7,3,19,8,11,6,9,6,3,4,12,7,5,5,DESEMBER
SULAWESI BARAT,MAJENE,TUBO SENDANA,BONDE BONDE,84,21,21,1,1,0,0,6,8,7,21,0,14,1,13,1,15,6,9,1,4,2,2,2,17,2,15,14,DESEMBER
SULAWESI BARAT,MAJENE,TUBO SENDANA,TUBO TENGAH,62,41,13,11,6,4,0,10,1,2,12,0,8,2,6,0,15,12,3,3,5,5,0,4,10,1,9,1,DESEMBER
SULAWESI BARAT,MAJENE,TUBO SENDANA,TUBO POANG,95,22,8,2,2,2,0,6,2,0,7,0,4,3,1,3,22,8,14,8,18,11,7,10,16,6,10,12,DESEMBER
SULAWESI BARAT,MAJENE,ULUMANDA,KABIRAAN,79,50,14,2,1,1,0,13,0,0,7,7,5,3,2,1,12,12,0,3,10,6,4,1,4,1,3,4,DESEMBER
SULAWESI BARAT,MAJENE,ULUMANDA,SAMBABO,85,54,22,4,2,1,0,12,4,2,15,2,0,0,0,0,36,8,28,0,4,1,3,0,16,7,9,5,DESEMBER
SULAWESI BARAT,MAJENE,ULUMANDA,TANDEALLO,68,13,12,7,4,1,0,7,1,0,7,2,4,2,2,0,11,10,1,3,10,2,8,0,7,5,2,2,DESEMBER
SULAWESI BARAT,MAJENE,ULUMANDA,ULUMANDA,91,40,3,2,2,2,1,2,0,0,3,0,10,8,2,1,15,15,0,11,8,8,0,0,8,8,0,0,DESEMBER
SULAWESI BARAT,MAJENE,ULUMANDA,SALUTAMBUNG,97,22,17,2,1,1,0,1,7,0,7,7,4,2,2,1,16,14,2,8,13,9,4,2,10,0,10,10,DESEMBER
SULAWESI BARAT,MAJENE,ULUMANDA,POPENGA,66,50,5,4,2,1,0,2,2,1,2,2,3,0,3,0,50,9,41,2,1,0,1,0,15,11,4,0,DESEMBER
SULAWESI BARAT,MAJENE,ULUMANDA,SULAI,79,64,33,9,4,0,0,29,1,3,30,0,15,14,1,6,33,29,4,6,4,0,4,0,38,6,32,5,DESEMBER
SULAWESI BARAT,MAJENE,ULUMANDA,PANGGALO,51,48,11,6,3,3,2,7,2,0,2,7,8,4,4,3,40,36,4,11,38,5,33,0,63,35,28,50,DESEMBER
SULAWESI BARAT,MAMASA,ARALLE,ARALLE,55,30,30,27,2,2,1,7,5,1,1,2,8,7,1,4,23,10,13,4,19,3,16,1,24,12,12,6,DESEMBER
SULAWESI BARAT,MAMASA,ARALLE,RALLE ANAK,58,16,10,5,0,0,0,4,1,2,6,1,7,0,7,0,12,11,1,3,0,0,0,0,9,2,7,6,DESEMBER
SULAWESI BARAT,MAMASA,ARALLE,PANETEAN,78,37,22,21,10,6,1,7,7,3,14,5,9,4,5,4,33,24,9,0,4,0,4,0,6,2,4,2,DESEMBER
SULAWESI BARAT,MAMASA,ARALLE,UHAILANU,48,29,0,0,0,0,0,0,0,0,0,0,1,0,1,0,15,13,2,10,13,8,5,2,19,11,8,11,DESEMBER
SULAWESI BARAT,MAMASA,ARALLE,ARALLE UTARA,87,27,5,4,3,3,1,4,0,0,4,1,16,14,2,3,23,21,2,18,4,2,2,1,9,3,6,0,DESEMBER
SULAWESI BARAT,MAMASA,ARALLE,UHAIDAHO,93,51,10,1,0,0,0,9,0,0,2,7,16,5,11,0,29,7,22,4,18,2,16,0,16,8,8,14,DESEMBER
SULAWESI BARAT,MAMASA,ARALLE,BARURU,35,78,59,45,3,2,1,5,40,5,1,12,1,1,0,1,54,29,25,12,46,45,1,40,4,1,3,0,DESEMBER
SULAWESI BARAT,MAMASA,ARALLE,RALLEANAK UTARA,58,15,2,1,1,1,1,0,0,0,1,1,0,0,0,0,14,14,0,6,6,2,4,0,3,2,1,2,DESEMBER
SULAWESI BARAT,MAMASA,ARALLE,PAMOSEANG PANGGA,39,29,0,0,0,0,0,0,0,0,0,0,5,4,1,0,20,7,13,2,1,1,0,0,14,12,2,1,DESEMBER
SULAWESI BARAT,MAMASA,ARALLE,KALABE,99,70,3,2,0,0,0,2,1,0,0,0,11,11,0,1,11,8,3,6,5,5,0,1,19,7,12,15,DESEMBER
SULAWESI BARAT,MAMASA,ARALLE,ARALLE SELATAN,63,11,10,7,2,2,2,0,0,4,4,0,1,0,1,0,11,5,6,0,1,1,0,1,0,0,0,0,DESEMBER
SULAWESI BARAT,MAMASA,ARALLE,HAHANGAN,62,64,34,28,15,11,3,6,25,0,18,13,0,0,0,0,21,21,0,2,13,11,2,10,36,9,27,1,DESEMBER
SULAWESI BARAT,MAMASA,BALLA,BALLA,43,10,8,0,0,0,0,4,4,0,8,0,1,0,1,0,10,8,2,5,2,0,2,0,8,8,0,4,DESEMBER
SULAWESI BARAT,MAMASA,BALLA,BALLA BARAT,92,17,0,0,0,0,0,0,0,0,0,0,13,5,8,3,14,12,2,6,0,0,0,0,8,4,4,8,DESEMBER
SULAWESI BARAT,MAMASA,BALLA,BALLA SATANETEAN,72,25,4,1,0,0,0,0,0,3,3,1,6,6,0,2,23,8,15,8,2,0,2,0,16,13,3,10,DESEMBER
SULAWESI BARAT,MAMASA,BALLA,BALLA TUMUKA,69,52,22,21,2,0,0,12,1,7,21,0,7,3,4,3,13,5,8,2,11,8,3,6,21,21,0,11,DESEMBER
SULAWESI BARAT,MAMASA,BALLA,SEPAKUAN,51,66,16,10,7,6,6,4,3,2,7,3,0,0,0,0,46,14,32,13,8,6,2,4,25,12,13,18,DESEMBER
SULAWESI BARAT,MAMASA,BALLA,PIDARA,63,46,28,21,14,13,3,1,23,0,17,5,3,1,2,0,36,36,0,27,17,0,17,0,46,32,14,31,DESEMBER
SULAWESI BARAT,MAMASA,BALLA,BAMBAPUANG,84,52,13,0,0,0,0,10,2,0,3,7,0,0,0,0,44,16,28,1,26,10,16,3,61,35,26,28,DESEMBER
SULAWESI BARAT,MAMASA,BALLA,BALLA TIMUR,77,64,8,7,6,2,2,0,1,5,5,3,5,0,5,0,11,7,4,4,7,6,1,2,47,0,47,26,DESEMBER
SULAWESI BARAT,MAMASA,BAMBANG,MOKALLANG,70,15,4,2,1,1,0,2,1,1,1,3,8,6,2,3,10,8,2,1,7,0,7,0,13,3,10,6,DESEMBER
SULAWESI BARAT,MAMASA,BAMBANG,MASOSO,92,67,26,2,2,0,0,12,0,5,20,1,8,0,8,0,34,13,21,12,3,0,3,0,47,16,31,7,DESEMBER
SULAWESI BARAT,MAMASA,BAMBANG,SALUASSING,82,21,13,4,3,3,1,5,7,0,6,4,12,0,12,0,18,8,10,3,17,0,17,0,28,14,14,3,DESEMBER
SULAWESI BARAT,MAMASA,BAMBANG,SALUBULO,68,77,12,7,0,0,0,1,10,1,5,4,10,5,5,1,42,10,32,7,16,14,2,12,52,5,47,51,DESEMBER
SULAWESI BARAT,MAMASA,BAMBANG,SALUKADI,75,72,69,59,38,4,4,48,8,9,65,1,1,1,0,0,43,34,9,34,28,16,12,13,34,21,13,11,DESEMBER
SULAWESI BARAT,MAMASA,BAMBANG,SALUKEPOPOK,48,73,16,1,0,0,0,16,0,0,9,0,5,1,4,1,47,7,40,1,23,3,20,2,31,16,15,13,DESEMBER
SULAWESI BARAT,MAMASA,BAMBANG,ULUMAMBI BARAT,83,29,25,3,0,0,0,0,9,2,1,12,11,1,10,1,10,8,2,8,2,2,0,2,17,14,3,16,DESEMBER
SULAWESI BARAT,MAMASA,BAMBANG,LIMBADEBATA,43,21,20,9,2,1,1,17,1,0,4,2,6,0,6,0,15,14,1,1,11,1,10,0,5,2,3,5,DESEMBER
SULAWESI BARAT,MAMASA,BAMBANG,TANETE TOMBA,92,75,21,2,2,0,0,11,8,1,0,21,8,2,6,1,23,15,8,4,3,1,2,1,7,4,3,1,DESEMBER
SULAWESI BARAT,MAMASA,BAMBANG,BAMBANG,85,25,15,13,10,8,0,11,2,0,3,0,9,8,1,3,24,10,14,10,20,18,2,8,3,0,3,3,DESEMBER
SULAWESI BARAT,MAMASA,BAMBANG,RANTELEMO,40,29,7,5,5,5,5,2,0,0,5,0,0,0,0,0,29,8,21,5,28,11,17,2,35,11,24,5,DESEMBER
SULAWESI BARAT,MAMASA,BAMBANG,SALUDENGEN,96,14,9,5,4,3,1,3,3,1,5,2,6,2,4,1,10,9,1,0,7,1,6,1,7,4,3,4,DESEMBER
SULAWESI BARAT,MAMASA,BAMBANG,ULUMAMBI,98,31,24,5,4,1,0,1,14,5,18,5,16,8,8,4,17,11,6,11,4,4,0,0,9,1,8,5,DESEMBER
SULAWESI BARAT,MAMASA,BAMBANG,BAMBANG TIMUR,76,73,73,16,5,1,0,27,43,1,5,13,10,7,3,6,14,5,9,0,0,0,0,0,46,2,44,24,DESEMBER
SULAWESI BARAT,MAMASA,BAMBANG,MINANGA,63,62,39,28,7,6,0,14,7,6,28,6,2,0,2,0,22,12,10,8,5,2,3,1,30,15,15,1,DESEMBER
SULAWESI BARAT,MAMASA,BAMBANG,SIKAMASE,80,11,10,1,0,0,0,7,1,2,8,0,6,4,2,0,10,6,4,6,8,5,3,5,4,1,3,2,DESEMBER
SULAWESI BARAT,MAMASA,BAMBANG,RANTETARIMA,98,68,57,27,22,21,1,50,3,0,5,43,3,2,1,0,62,12,50,0,2,0,2,0,36,24,12,4,DESEMBER
SULAWESI BARAT,MAMASA,BAMBANG,SALURURU,55,11,0,0,0,0,0,0,0,0,0,0,2,0,2,0,10,7,3,0,7,5,2,3,14,7,7,7,DESEMBER
SULAWESI BARAT,MAMASA,BAMBANG,SALUTABANG,98,39,14,2,2,1,1,4,2,4,7,4,4,3,1,3,20,16,4,15,14,9,5,9,34,1,33,11,DESEMBER
SULAWESI BARAT,MAMASA,BAMBANG,BALATANA,42,31,0,0,0,0,0,0,0,0,0,0,5,4,1,2,17,5,12,1,7,0,7,0,16,10,6,7,DESEMBER
SULAWESI BARAT,MAMASA,BUNTUMALANGKA,BUNTUMALANGKA,30,35,9,8,3,0,0,9,0,0,5,1,3,2,1,0,10,10,0,6,1,0,1,0,12,12,0,1,DESEMBER
SULAWESI BARAT,MAMASA,BUNTUMALANGKA,RANTEBERAN,89,79,44,11,8,1,1,6,32,5,18,11,14,13,1,13,59,9,50,0,2,1,1,0,40,19,21,18,DESEMBER
SULAWESI BARAT,MAMASA,BUNTUMALANGKA,KEBANGA,56,58,5,0,0,0,0,4,1,0,3,1,5,3,2,1,45,41,4,10,25,25,0,7,29,15,14,25,DESEMBER
SULAWESI BARAT,MAMASA,BUNTUMALANGKA,SALURINDU,35,77,12,6,4,1,1,4,0,2,12,0,1,0,1,0,73,35,38,22,29,8,21,1,80,38,42,50,DESEMBER
SULAWESI BARAT,MAMASA,BUNTUMALANGKA,TAORA,54,79,78,10,6,1,0,8,33,28,57,15,1,1,0,0,17,15,2,13,14,5,9,5,45,0,45,19,DESEMBER
SULAWESI BARAT,MAMASA,BUNTUMALANGKA,KABAE,100,50,3,0,0,0,0,3,0,0,0,0,20,13,7,0,42,31,11,18,3,1,2,0,22,14,8,3,DESEMBER
SULAWESI BARAT,MAMASA,BUNTUMALANGKA,SALUTAMBUN BARAT,56,43,19,13,1,0,0,18,0,1,0,9,0,0,0,0,15,11,4,4,0,0,0,0,17,16,1,16,DESEMBER
SULAWESI BARAT,MAMASA,BUNTUMALANGKA,PENATANGAN,92,16,5,5,5,1,1,2,0,1,1,3,7,0,7,0,10,10,0,2,2,1,1,0,12,9,3,0,DESEMBER
SULAWESI BARAT,MAMASA,BUNTUMALANGKA,SALUTAMBUN TIMUR,77,70,53,44,9,4,3,22,3,6,44,4,2,2,0,1,28,12,16,7,21,0,21,0,70,10,60,22,DESEMBER
SULAWESI BARAT,MAMASA,BUNTUMALANGKA,SALUTAMBUN,35,74,48,13,10,9,9,14,13,10,8,37,0,0,0,0,48,39,9,31,27,19,8,6,36,29,7,28,DESEMBER
SULAWESI BARAT,MAMASA,BUNTUMALANGKA,ARALLE TIMUR,79,12,5,5,3,0,0,0,4,1,1,0,8,0,8,0,12,11,1,9,1,1,0,1,9,6,3,3,DESEMBER
SULAWESI BARAT,MAMASA,MAMASA,MAMASA,75,77,40,10,9,2,1,31,7,1,12,23,5,3,2,0,10,7,3,2,7,0,7,0,27,20,7,23,DESEMBER
SULAWESI BARAT,MAMASA,MAMASA,RAMBUSARATU,95,80,20,9,1,1,0,11,8,1,14,5,7,4,3,0,61,19,42,17,33,14,19,11,12,8,4,4,DESEMBER
SULAWESI BARAT,MAMASA,MAMASA,OSANGO,42,17,7,6,3,3,1,4,1,1,2,4,4,2,2,0,13,5,8,5,9,6,3,0,8,4,4,8,DESEMBER
SULAWESI BARAT,MAMASA,MAMASA,LAMBANAN,60,73,27,19,0,0,0,16,5,4,17,7,11,5,6,2,63,16,47,3,53,22,31,8,62,11,51,17,DESEMBER
SULAWESI BARAT,MAMASA,MAMASA,LEMBANA SALULO,91,74,40,33,23,0,0,5,26,4,0,19,14,10,4,4,46,20,26,18,39,7,32,5,32,12,20,11,DESEMBER
SULAWESI BARAT,MAMASA,MAMASA,TAUPE,65,40,3,3,2,2,0,3,0,0,0,2,5,3,2,3,14,10,4,9,7,6,1,1,11,1,10,2,DESEMBER
SULAWESI BARAT,MAMASA,MAMASA,BUNTU BUDA,86,53,26,15,15,6,3,13,2,1,14,2,8,3,5,0,18,15,3,6,8,0,8,0,19,5,14,16,DESEMBER
SULAWESI BARAT,MAMASA,MAMASA,TONDOK BAKARU,72,20,0,0,0,0,0,0,0,0,0,0,3,3,0,2,16,14,2,2,10,9,1,8,21,13,8,18,DESEMBER
SULAWESI BARAT,MAMASA,MAMASA,PEBASSIAN,70,63,14,14,12,9,8,0,5,1,9,2,4,1,3,0,42,42,0,4,34,9,25,5,13,12,1,5,DESEMBER
SULAWESI BARAT,MAMASA,MAMASA,MAMBULILING,60,36,30,6,6,5,1,24,5,0,13,13,1,1,0,1,12,6,6,5,3,1,2,1,15,1,14,2,DESEMBER
SULAWESI BARAT,MAMASA,MAMASA,BOMBONG LAMBE,40,70,41,34,10,0,0,35,5,1,31,4,3,0,3,0,29,25,4,22,13,1,12,1,20,8,12,16,DESEMBER
SULAWESI BARAT,MAMASA,MAMASA,BUBUN BATU,33,10,6,3,3,2,1,2,2,0,2,4,1,0,1,0,10,10,0,1,3,2,1,0,8,0,8,0,DESEMBER
SULAWESI BARAT,MAMASA,MAMBI,MAMBI,94,63,21,16,3,3,2,10,3,0,16,5,9,5,4,5,19,17,2,10,11,0,11,0,51,8,43,43,DESEMBER
SULAWESI BARAT,MAMASA,MAMBI,TALIPUKKI,48,37,9,7,3,2,2,7,0,0,3,3,9,1,8,1,36,11,25,10,31,20,11,5,16,13,3,6,DESEMBER
SULAWESI BARAT,MAMASA,MAMBI,RANTEBULAHAN,40,40,8,0,0,0,0,2,4,0,1,3,4,0,4,0,23,9,14,6,16,0,16,0,28,23,5,26,DESEMBER
SULAWESI BARAT,MAMASA,MAMBI,SONDONGLAYU,59,14,11,2,1,1,0,4,0,5,9,2,0,0,0,0,14,11,3,0,13,0,13,0,15,13,2,12,DESEMBER
SULAWESI BARAT,MAMASA,MAMBI,SALUBANUA,49,40,7,0,0,0,0,2,3,1,5,2,1,0,1,0,23,21,2,3,21,16,5,0,3,1,2,2,DESEMBER
SULAWESI BARAT,MAMASA,MAMBI,TAPALINA,82,48,22,11,7,4,0,10,12,0,8,11,3,1,2,1,20,13,7,6,19,5,14,0,12,2,10,5,DESEMBER
SULAWESI BARAT,MAMASA,MAMBI,SENDANA,92,21,10,4,1,1,1,8,0,0,6,4,15,12,3,9,11,11,0,10,1,1,0,0,9,0,9,9,DESEMBER
SULAWESI BARAT,MAMASA,MAMBI,PAMOSEAN,72,76,74,44,40,1,1,22,26,25,4,6,11,5,6,5,52,51,1,11,35,10,25,7,76,42,34,61,DESEMBER
SULAWESI BARAT,MAMASA,MAMBI,SELUMAKA,51,27,25,23,22,19,3,18,0,4,19,3,3,2,1,2,22,15,7,5,16,7,9,4,32,1,31,20,DESEMBER
SULAWESI BARAT,MAMASA,MAMBI,BUJUNG MANURUNG,86,15,14,8,1,1,1,6,1,1,5,9,12,11,1,6,10,6,4,2,0,0,0,0,8,2,6,6,DESEMBER
SULAWESI BARAT,MAMASA,MAMBI,SALU ALO,46,14,4,0,0,0,0,4,0,0,4,0,2,1,1,0,10,10,0,2,4,4,0,2,10,9,1,9,DESEMBER
SULAWESI BARAT,MAMASA,MAMBI,INDOBANUA,54,15,0,0,0,0,0,0,0,0,0,0,1,0,1,0,13,8,5,5,1,1,0,0,1,0,1,1,DESEMBER
SULAWESI BARAT,MAMASA,MAMBI,SALUDURIAN,45,47,30,18,14,7,7,7,13,2,27,3,9,0,9,0,30,10,20,8,2,2,0,2,24,2,22,21,DESEMBER
SULAWESI BARAT,MAMASA,MEHALAAN,MEHALAAN,35,65,12,1,1,0,0,1,0,0,7,2,4,0,4,0,59,36,23,33,36,2,34,2,8,0,8,0,DESEMBER
SULAWESI BARAT,MAMASA,MEHALAAN,BOTTENG,34,53,29,18,9,6,2,9,15,0,13,14,1,1,0,1,49,42,7,17,28,27,1,17,60,10,50,41,DESEMBER
SULAWESI BARAT,MAMASA,MEHALAAN,SALUKONTA,89,64,52,45,22,15,4,22,25,0,41,7,12,12,0,6,37,21,16,20,8,5,3,5,19,6,13,4,DESEMBER
SULAWESI BARAT,MAMASA,MEHALAAN,MESAKADA,80,48,8,6,4,1,0,3,5,0,8,0,7,7,0,7,24,13,11,6,11,9,2,6,12,3,9,1,DESEMBER
SULAWESI BARAT,MAMASA,MEHALAAN,MEHALAAN BARAT,75,78,58,0,0,0,0,2,53,1,7,45,15,10,5,1,55,38,17,1,50,37,13,27,72,40,32,20,DESEMBER
SULAWESI BARAT,MAMASA,MEHALAAN,SALUAHOK,89,20,10,2,2,1,0,4,3,3,2,8,8,0,8,0,15,14,1,6,0,0,0,0,12,7,5,3,DESEMBER
SULAWESI BARAT,MAMASA,MEHALAAN,SALUBALO,61,11,0,0,0,0,0,0,0,0,0,0,12,5,7,4,10,6,4,1,3,1,2,1,5,2,3,0,DESEMBER
SULAWESI BARAT,MAMASA,MEHALAAN,PASSEMBUK,80,36,26,9,2,0,0,18,6,1,6,5,6,0,6,0,19,13,6,3,4,0,4,0,7,2,5,1,DESEMBER
SULAWESI BARAT,MAMASA,MEHALAAN,KONDO,41,76,22,5,3,1,0,7,1,10,9,3,1,0,1,0,73,20,53,4,21,17,4,17,16,14,2,0,DESEMBER
SULAWESI BARAT,MAMASA,MEHALAAN,LEKO SUKAMAJU,80,33,15,7,7,1,0,12,2,0,0,1,14,5,9,2,16,7,9,1,16,9,7,6,29,13,16,3,DESEMBER
SULAWESI BARAT,MAMASA,MEHALAAN,ULUMEA,92,28,8,5,3,1,1,0,1,2,7,1,9,0,9,0,10,9,1,4,3,0,3,0,10,4,6,1,DESEMBER
SULAWESI BARAT,MAMASA,MESSAWA,MESSAWA,87,68,39,35,25,18,10,25,2,2,38,1,3,2,1,2,11,8,3,4,11,1,10,1,29,6,23,15,DESEMBER
SULAWESI BARAT,MAMASA,MESSAWA,RIPPUNG,95,66,5,0,0,0,0,1,4,0,0,2,16,2,14,2,64,16,48,0,64,21,43,20,29,15,14,0,DESEMBER
SULAWESI BARAT,MAMASA,MESSAWA,MAKUANG,67,77,47,2,2,2,1,18,4,15,19,0,7,6,1,2,61,28,33,19,26,16,10,3,74,63,11,1,DESEMBER
SULAWESI BARAT,MAMASA,MESSAWA,SEPANG,91,80,34,13,8,5,0,18,7,0,28,4,17,13,4,5,53,5,48,2,24,12,12,10,41,41,0,28,DESEMBER
SULAWESI BARAT,MAMASA,MESSAWA,MALIMBONG,41,16,12,6,1,1,0,4,3,0,3,1,2,2,0,0,10,10,0,1,2,0,2,0,4,1,3,1,DESEMBER
SULAWESI BARAT,MAMASA,MESSAWA,MATANDE,64,64,11,3,0,0,0,0,2,3,5,0,10,0,10,0,29,5,24,2,23,1,22,1,17,8,9,2,DESEMBER
SULAWESI BARAT,MAMASA,MESSAWA,SIPAI,94,14,0,0,0,0,0,0,0,0,0,0,17,1,16,1,10,7,3,3,6,1,5,0,4,2,2,4,DESEMBER
SULAWESI BARAT,MAMASA,MESSAWA,PASMA MAMBU,55,24,17,4,4,2,0,13,2,1,9,5,9,1,8,0,20,12,8,1,9,4,5,0,19,4,15,8,DESEMBER
SULAWESI BARAT,MAMASA,MESSAWA,TANETE BATU,85,22,0,0,0,0,0,0,0,0,0,0,10,8,2,5,14,9,5,9,9,7,2,4,5,2,3,3,DESEMBER
SULAWESI BARAT,MAMASA,NOSU,NOSU,80,44,16,6,5,2,1,7,3,0,12,2,7,4,3,1,24,24,0,21,6,6,0,0,0,0,0,0,DESEMBER
SULAWESI BARAT,MAMASA,NOSU,MINANGA,58,71,58,49,44,1,0,30,19,4,2,33,7,2,5,2,59,50,9,26,41,34,7,10,65,4,61,7,DESEMBER
SULAWESI BARAT,MAMASA,NOSU,BATUPAPAN,76,45,4,3,1,1,1,1,1,0,3,1,2,2,0,2,38,18,20,4,30,8,22,2,40,27,13,17,DESEMBER
SULAWESI BARAT,MAMASA,NOSU,MASEWWE,50,44,23,1,1,0,0,10,8,5,9,13,1,0,1,0,40,15,25,0,40,33,7,17,33,21,12,17,DESEMBER
SULAWESI BARAT,MAMASA,NOSU,SIWI,55,46,10,2,0,0,0,6,3,0,5,5,9,0,9,0,30,25,5,21,25,3,22,3,0,0,0,0,DESEMBER
SULAWESI BARAT,MAMASA,NOSU,MINANGA TIMUR,60,12,12,6,2,1,1,9,1,1,6,1,4,4,0,3,10,6,4,2,3,2,1,0,3,3,0,2,DESEMBER
SULAWESI BARAT,MAMASA,NOSU,PARINDING,46,25,22,2,1,0,0,13,3,1,20,0,5,0,5,0,18,14,4,6,13,11,2,6,8,2,6,3,DESEMBER
SULAWESI BARAT,MAMASA,PANA,PANA,76,78,27,2,1,1,1,19,7,0,6,7,0,0,0,0,38,23,15,2,15,14,1,12,17,15,2,13,DESEMBER
SULAWESI BARAT,MAMASA,PANA,MANIPI,80,56,34,21,0,0,0,6,11,1,10,18,14,1,13,1,22,21,1,15,19,1,18,0,50,47,3,36,DESEMBER
SULAWESI BARAT,MAMASA,PANA,MAMULLU,100,59,39,36,36,9,9,0,20,9,34,2,8,1,7,1,55,45,10,14,37,31,6,14,29,13,16,26,DESEMBER
SULAWESI BARAT,MAMASA,PANA,SAPAN,53,16,2,1,0,0,0,0,2,0,0,1,8,0,8,0,13,12,1,6,6,6,0,4,0,0,0,0,DESEMBER
SULAWESI BARAT,MAMASA,PANA,DATUBARINGAN,99,70,64,22,1,0,0,5,4,40,2,13,12,9,3,7,67,8,59,2,50,31,19,24,2,0,2,2,DESEMBER
SULAWESI BARAT,MAMASA,PANA,PANURA,64,64,29,19,7,5,4,19,0,0,25,3,8,5,3,2,21,8,13,3,7,5,2,4,15,15,0,4,DESEMBER
SULAWESI BARAT,MAMASA,PANA,TALLANG BULAWAN,61,23,23,1,0,0,0,7,8,4,6,2,1,0,1,0,19,7,12,5,10,8,2,3,18,0,18,6,DESEMBER
SULAWESI BARAT,MAMASA,PANA,KARAKA,79,56,43,37,9,2,0,23,8,0,40,1,12,1,11,0,56,52,4,45,25,17,8,1,18,15,3,2,DESEMBER
SULAWESI BARAT,MAMASA,PANA,ULUSALU,100,14,5,2,0,0,0,1,1,3,0,3,8,2,6,2,11,7,4,0,1,0,1,0,3,2,1,3,DESEMBER
SULAWESI BARAT,MAMASA,PANA,WERI,100,67,31,7,3,0,0,28,0,0,9,10,15,4,11,3,31,26,5,5,1,1,0,1,18,5,13,5,DESEMBER
SULAWESI BARAT,MAMASA,PANA,SALUTAMBUN,85,62,62,29,22,1,0,46,14,2,29,2,17,0,17,0,18,17,1,13,2,2,0,0,9,2,7,3,DESEMBER
SULAWESI BARAT,MAMASA,PANA,SALOAN,63,30,11,5,2,0,0,9,2,0,2,6,3,3,0,0,21,13,8,10,1,1,0,0,19,7,12,16,DESEMBER
SULAWESI BARAT,MAMASA,PANA,ULUSALU INDAH,99,40,24,4,1,0,0,24,0,0,5,12,19,0,19,0,36,28,8,28,7,5,2,5,22,0,22,8,DESEMBER
SULAWESI BARAT,MAMASA,RANTEBULAHAN TIMUR,SALUMOKANAN,45,67,61,44,36,0,0,20,10,21,8,38,6,1,5,0,55,18,37,1,4,2,2,1,44,31,13,36,DESEMBER
SULAWESI BARAT,MAMASA,RANTEBULAHAN TIMUR,SALUMOKANAN BARAT,73,60,28,13,0,0,0,24,4,0,23,5,9,6,3,5,11,5,6,5,11,6,5,1,29,13,16,2,DESEMBER
SULAWESI BARAT,MAMASA,RANTEBULAHAN TIMUR,BUANGIN,46,66,10,8,1,1,0,9,1,0,9,0,7,1,6,0,51,38,13,21,2,2,0,1,9,5,4,9,DESEMBER
SULAWESI BARAT,MAMASA,RANTEBULAHAN TIMUR,BAMBANG BUDA,69,50,48,46,33,24,15,21,6,1,36,2,3,0,3,0,32,28,4,7,29,20,9,11,19,7,12,10,DESEMBER
SULAWESI BARAT,MAMASA,RANTEBULAHAN TIMUR,LEKO,47,75,65,34,22,21,5,8,6,15,21,24,1,0,1,0,45,20,25,16,21,9,12,3,65,55,10,41,DESEMBER
SULAWESI BARAT,MAMASA,RANTEBULAHAN TIMUR,KIRAK,80,30,7,7,0,0,0,2,4,1,1,2,6,5,1,5,18,9,9,7,12,8,4,8,7,0,7,3,DESEMBER
SULAWESI BARAT,MAMASA,RANTEBULAHAN TIMUR,SALUMOKANAN UTARA,78,79,57,39,24,10,9,11,6,14,7,26,6,1,5,1,42,6,36,6,41,24,17,24,13,13,0,3,DESEMBER
SULAWESI BARAT,MAMASA,RANTEBULAHAN TIMUR,SAMPALE,60,12,1,0,0,0,0,1,0,0,1,0,4,3,1,0,12,7,5,1,11,10,1,5,1,0,1,1,DESEMBER
SULAWESI BARAT,MAMASA,SESENAPADANG,OROBUA,68,25,25,9,0,0,0,15,4,5,10,5,5,1,4,0,15,12,3,10,2,1,1,1,15,1,14,3,DESEMBER
SULAWESI BARAT,MAMASA,SESENAPADANG,PALADAN,100,64,0,0,0,0,0,0,0,0,0,0,6,5,1,0,17,5,12,4,5,4,1,1,13,11,2,13,DESEMBER
SULAWESI BARAT,MAMASA,SESENAPADANG,OROBUA TIMUR,87,52,3,1,1,1,1,2,0,0,2,0,10,1,9,1,50,19,31,4,15,5,10,5,12,11,1,9,DESEMBER
SULAWESI BARAT,MAMASA,SESENAPADANG,RANTE PUANG,81,75,23,6,4,2,0,15,6,0,11,2,10,2,8,2,25,16,9,12,6,0,6,0,18,12,6,12,DESEMBER
SULAWESI BARAT,MAMASA,SESENAPADANG,SATENETEAN,69,45,28,11,11,0,0,5,10,13,22,3,9,4,5,2,43,26,17,5,9,4,5,3,1,0,1,0,DESEMBER
SULAWESI BARAT,MAMASA,SESENAPADANG,LISUAN ADA,58,14,8,7,0,0,0,7,1,0,2,3,7,7,0,3,11,10,1,0,2,0,2,0,1,0,1,0,DESEMBER
SULAWESI BARAT,MAMASA,SESENAPADANG,OROBUA SELATAN,86,65,53,18,6,1,1,15,15,17,23,19,0,0,0,0,33,9,24,0,24,9,15,7,49,38,11,17,DESEMBER
SULAWESI BARAT,MAMASA,SESENAPADANG,MALANGKENA PADANG,33,72,1,0,0,0,0,1,0,0,0,1,2,2,0,0,27,6,21,4,10,6,4,2,16,13,3,5,DESEMBER
SULAWESI BARAT,MAMASA,SESENAPADANG,MALIMBONG,80,17,16,12,9,8,7,8,1,0,15,1,6,6,0,1,15,9,6,4,13,11,2,6,5,5,0,1,DESEMBER
SULAWESI BARAT,MAMASA,SESENAPADANG,MARAMPAN OROBUA,95,64,36,19,7,6,4,26,3,0,23,0,11,9,2,9,21,15,6,12,3,0,3,0,20,10,10,14,DESEMBER
SULAWESI BARAT,MAMASA,SUMARORONG,SUMARORONG,68,61,50,0,0,0,0,24,4,7,23,1,6,3,3,3,21,19,2,10,9,3,6,0,27,4,23,5,DESEMBER
SULAWESI BARAT,MAMASA,SUMARORONG,TABONE,100,34,28,6,1,0,0,9,7,8,6,2,17,9,8,5,27,14,13,12,3,3,0,3,26,12,14,6,DESEMBER
SULAWESI BARAT,MAMASA,SUMARORONG,BATANG URU,94,59,33,7,4,1,0,18,3,8,16,17,17,10,7,1,44,16,28,3,18,12,6,5,16,8,8,2,DESEMBER
SULAWESI BARAT,MAMASA,SUMARORONG,SASAKAN,95,57,27,19,4,3,2,22,3,0,17,10,13,5,8,4,16,5,11,2,3,3,0,0,32,19,13,19,DESEMBER
SULAWESI BARAT,MAMASA,SUMARORONG,TADISI,51,27,18,5,3,3,3,2,11,2,7,0,9,7,2,6,11,6,5,4,4,4,0,2,0,0,0,0,DESEMBER
SULAWESI BARAT,MAMASA,SUMARORONG,SIBANAWA,66,12,11,10,1,1,1,2,3,4,11,0,12,3,9,1,12,8,4,4,4,1,3,0,6,1,5,0,DESEMBER
SULAWESI BARAT,MAMASA,SUMARORONG,BATANGNGURU TIMUR,94,34,14,1,1,0,0,1,10,0,0,2,6,6,0,4,25,13,12,2,2,0,2,0,0,0,0,0,DESEMBER
SULAWESI BARAT,MAMASA,SUMARORONG,SALUBALO,68,69,13,3,3,3,3,6,2,1,8,3,13,9,4,0,27,18,9,17,15,9,6,6,39,32,7,35,DESEMBER
SULAWESI BARAT,MAMASA,SUMARORONG,BANEA,70,36,15,8,5,5,5,9,0,0,13,2,13,12,1,6,27,16,11,3,1,1,0,0,12,11,1,10,DESEMBER
SULAWESI BARAT,MAMASA,SUMARORONG,RANTE KAMASE,89,26,10,6,0,0,0,10,0,0,8,2,12,3,9,0,26,22,4,18,11,5,6,4,7,5,2,0,DESEMBER
SULAWESI BARAT,MAMASA,TABANG,TABANG,82,74,65,47,1,0,0,65,0,0,34,22,13,7,6,7,55,19,36,18,22,12,10,8,73,5,68,29,DESEMBER
SULAWESI BARAT,MAMASA,TABANG,TADOKALUA,78,11,9,3,1,0,0,2,2,5,6,0,1,0,1,0,10,5,5,0,7,1,6,1,14,6,8,13,DESEMBER
SULAWESI BARAT,MAMASA,TABANG,TABANG BARAT,35,37,12,8,5,1,0,2,0,5,0,2,7,0,7,0,22,13,9,11,22,16,6,8,11,8,3,11,DESEMBER
SULAWESI BARAT,MAMASA,TABANG,MASUPU,45,62,26,6,1,0,0,18,6,1,17,5,6,2,4,2,52,32,20,29,35,10,25,4,22,15,7,13,DESEMBER
SULAWESI BARAT,MAMASA,TABANG,KALAMA,62,75,11,9,4,3,1,3,7,0,2,2,8,6,2,1,43,37,6,26,6,0,6,0,13,12,1,6,DESEMBER
SULAWESI BARAT,MAMASA,TABANG,BAKADISURA,81,16,9,0,0,0,0,9,0,0,1,7,16,14,2,13,11,7,4,6,2,0,2,0,11,4,7,1,DESEMBER
SULAWESI BARAT,MAMASA,TABANG,SALUKONA,96,39,34,31,29,13,5,9,14,3,33,1,18,15,3,7,26,5,21,5,6,2,4,1,25,24,1,6,DESEMBER
SULAWESI BARAT,MAMASA,TABULAHAN,LAKAHANG,73,73,26,14,2,0,0,17,1,2,2,16,9,1,8,1,10,6,4,2,5,4,1,2,36,13,23,5,DESEMBER
SULAWESI BARAT,MAMASA,TABULAHAN,PERIANGAN,55,79,74,60,19,6,2,63,5,3,6,56,10,5,5,1,36,7,29,3,6,0,6,0,25,12,13,2,DESEMBER
SULAWESI BARAT,MAMASA,TABULAHAN,MALATIRO,53,46,40,15,15,12,8,28,0,2,23,17,3,0,3,0,14,6,8,4,5,0,5,0,11,4,7,10,DESEMBER
SULAWESI BARAT,MAMASA,TABULAHAN,TABULAHAN,39,40,21,11,9,0,0,7,12,1,20,1,5,4,1,1,11,10,1,10,0,0,0,0,16,12,4,7,DESEMBER
SULAWESI BARAT,MAMASA,TABULAHAN,SALULEANG,64,37,34,8,0,0,0,10,1,15,24,6,9,3,6,3,18,14,4,2,6,6,0,3,2,2,0,2,DESEMBER
SULAWESI BARAT,MAMASA,TABULAHAN,TAMPAK KURRA,57,76,29,2,1,0,0,12,8,7,23,3,6,4,2,1,74,61,13,44,35,31,4,16,37,36,1,37,DESEMBER
SULAWESI BARAT,MAMASA,TABULAHAN,GANDANG DEWATA,69,80,59,54,51,14,14,33,11,0,51,7,2,1,1,1,41,13,28,7,35,0,35,0,69,28,41,18,DESEMBER
SULAWESI BARAT,MAMASA,TABULAHAN,BURANA,69,62,21,18,11,0,0,17,1,2,7,13,8,0,8,0,59,59,0,51,54,18,36,1,55,34,21,6,DESEMBER
SULAWESI BARAT,MAMASA,TABULAHAN,SALUBAKKA,54,61,3,1,1,1,0,2,1,0,1,2,10,10,0,10,27,15,12,0,26,10,16,5,46,30,16,35,DESEMBER
SULAWESI BARAT,MAMASA,TABULAHAN,PANGANDARAN,34,74,45,20,4,4,2,26,2,12,32,7,1,0,1,0,54,28,26,2,46,34,12,14,56,2,54,4,DESEMBER
SULAWESI BARAT,MAMASA,TABULAHAN,TALOPAK,98,16,8,1,0,0,0,1,6,0,4,0,3,0,3,0,11,7,4,2,1,1,0,0,9,7,2,0,DESEMBER
SULAWESI BARAT,MAMASA,TABULAHAN,PEU',97,46,0,0,0,0,0,0,0,0,0,0,9,7,2,3,39,13,26,5,15,4,11,3,42,9,33,22,DESEMBER
SULAWESI BARAT,MAMASA,TABULAHAN,TIMORO,31,35,31,1,0,0,0,1,17,7,27,1,6,5,1,3,23,18,5,16,7,7,0,4,17,5,12,16,DESEMBER
SULAWESI BARAT,MAMASA,TABULAHAN,LAKAHANG UTAMA,52,77,70,4,4,2,2,27,35,1,40,25,3,2,1,2,49,28,21,25,6,5,1,5,42,19,23,11,DESEMBER
SULAWESI BARAT,MAMASA,TANDUK KALUA,MINAKE,76,68,63,37,19,6,0,21,31,8,25,21,10,8,2,3,31,7,24,0,5,0,5,0,31,24,7,28,DESEMBER
SULAWESI BARAT,MAMASA,TANDUK KALUA,MALABO,77,69,47,16,10,8,2,4,40,1,47,0,12,3,9,0,49,24,25,9,9,4,5,1,33,12,21,9,DESEMBER
SULAWESI BARAT,MAMASA,TANDUK KALUA,SINDAGAMANIK,73,44,26,1,0,0,0,5,20,0,9,6,12,9,3,2,27,5,22,3,4,2,2,2,18,0,18,14,DESEMBER
SULAWESI BARAT,MAMASA,TANDUK KALUA,PARONDOBULAWAN,37,61,56,6,0,0,0,46,1,9,14,34,6,0,6,0,54,11,43,9,26,24,2,6,60,35,25,56,DESEMBER
SULAWESI BARAT,MAMASA,TANDUK KALUA,TAMALANTIK,38,65,31,15,4,2,1,12,7,8,31,0,3,2,1,2,20,13,7,3,10,5,5,3,0,0,0,0,DESEMBER
SULAWESI BARAT,MAMASA,TANDUK KALUA,MANNABABA,63,56,13,11,8,8,4,5,0,4,9,0,1,1,0,0,45,34,11,32,37,31,6,6,17,11,6,2,DESEMBER
SULAWESI BARAT,MAMASA,TANDUK KALUA,MESAKADA,37,56,52,51,4,1,1,15,7,16,17,22,6,3,3,3,28,7,21,3,22,16,6,4,49,12,37,42,DESEMBER
SULAWESI BARAT,MAMASA,TANDUK KALUA,BALLABATU,47,73,35,27,25,20,1,12,20,2,0,32,0,0,0,0,29,21,8,10,26,16,10,2,39,2,37,18,DESEMBER
SULAWESI BARAT,MAMASA,TANDUK KALUA,PAMBE,98,20,2,1,0,0,0,2,0,0,0,1,12,8,4,2,10,9,1,9,0,0,0,0,8,0,8,6,DESEMBER
SULAWESI BARAT,MAMASA,TANDUK KALUA,SALURANO,62,75,38,1,0,0,0,17,21,0,11,24,8,6,2,0,59,8,51,2,57,32,25,7,80,49,31,54,DESEMBER
SULAWESI BARAT,MAMASA,TANDUK KALUA,TALIMBUNG,94,64,50,8,7,2,1,16,32,0,21,17,16,14,2,3,43,5,38,4,35,17,18,0,74,71,3,70,DESEMBER
SULAWESI BARAT,MAMASA,TANDUK KALUA,KANAN,32,75,43,10,1,0,0,35,7,0,28,1,3,2,1,1,38,10,28,6,26,24,2,23,2,0,2,0,DESEMBER
SULAWESI BARAT,MAMASA,TAWALIAN,TAWALIAN,38,30,7,2,0,0,0,7,0,0,5,0,2,2,0,1,15,11,4,7,2,1,1,0,2,0,2,1,DESEMBER
SULAWESI BARAT,MAMASA,TAWALIAN,TAWALIAN TIMUR,97,50,1,1,0,0,0,1,0,0,0,0,7,3,4,3,45,21,24,21,25,10,15,10,12,12,0,1,DESEMBER
SULAWESI BARAT,MAMASA,TAWALIAN,KARIANGO,81,11,11,8,1,1,1,6,2,0,5,3,16,8,8,4,11,7,4,5,10,5,5,4,0,0,0,0,DESEMBER
SULAWESI BARAT,MAMASA,TAWALIAN,RANTETANGNGA,51,54,8,2,2,2,1,0,3,3,2,4,0,0,0,0,29,21,8,13,16,1,15,1,40,5,35,9,DESEMBER
SULAWESI BARAT,POLEWALI MANDAR,ALLU,PETOOSANG,77,58,50,39,1,0,0,31,2,3,42,4,4,3,1,2,17,14,3,13,2,1,1,0,5,0,5,3,DESEMBER
SULAWESI BARAT,POLEWALI MANDAR,ALLU,MOMBI,63,31,24,10,5,0,0,23,0,1,0,6,0,0,0,0,24,14,10,4,5,3,2,2,6,5,1,3,DESEMBER
SULAWESI BARAT,POLEWALI MANDAR,ALLU,KALUMAMMANG,36,42,3,0,0,0,0,0,2,0,1,0,7,4,3,0,36,34,2,20,19,0,19,0,17,16,1,1,DESEMBER
SULAWESI BARAT,POLEWALI MANDAR,ALLU,PAO-PAO,30,44,28,6,0,0,0,17,6,2,0,7,3,0,3,0,40,26,14,11,36,3,33,0,32,19,13,26,DESEMBER
SULAWESI BARAT,POLEWALI MANDAR,ALLU,PUPPU URING,96,42,18,12,8,6,4,10,3,0,10,3,9,1,8,0,17,11,6,7,7,0,7,0,4,0,4,4,DESEMBER
SULAWESI BARAT,POLEWALI MANDAR,ALLU,SARAGIAN,44,56,52,31,13,2,2,24,17,2,51,0,5,4,1,3,21,20,1,4,14,4,10,3,1,1,0,0,DESEMBER
SULAWESI BARAT,POLEWALI MANDAR,ALLU,SAYOANG,91,20,7,2,0,0,0,1,2,1,0,6,10,4,6,1,17,8,9,7,6,6,0,3,18,0,18,16,DESEMBER
SULAWESI BARAT,POLEWALI MANDAR,ALLU,ALU,90,62,2,2,0,0,0,2,0,0,2,0,17,15,2,13,39,20,19,10,2,0,2,0,39,11,28,8,DESEMBER
SULAWESI BARAT,POLEWALI MANDAR,ANREAPI,ANREAPI,83,16,8,7,1,1,1,5,2,0,4,3,16,16,0,13,11,11,0,3,0,0,0,0,4,3,1,4,DESEMBER
SULAWESI BARAT,POLEWALI MANDAR,ANREAPI,DUAMPANUA,52,52,36,4,1,1,0,15,5,12,24,10,10,10,0,6,10,7,3,2,0,0,0,0,36,24,12,23,DESEMBER
SULAWESI BARAT,POLEWALI MANDAR,ANREAPI,KELAPA DUA,90,65,51,40,27,24,2,24,6,10,47,0,14,3,11,1,30,9,21,9,21,11,10,10,33,9,24,12,DESEMBER
SULAWESI BARAT,POLEWALI MANDAR,ANREAPI,PAPPANDANGAN,33,58,29,25,12,2,2,1,8,11,11,12,2,0,2,0,29,9,20,8,22,8,14,5,41,11,30,37,DESEMBER
SULAWESI BARAT,POLEWALI MANDAR,ANREAPI,KUNYI,67,15,12,9,6,2,0,5,0,0,7,5,13,5,8,0,13,6,7,3,6,6,0,4,7,7,0,1,DESEMBER
SULAWESI BARAT,POLEWALI MANDAR,BALANIPA,BALANIPA,90,53,19,19,8,0,0,10,0,7,14,5,1,0,1,0,20,6,14,5,11,2,9,2,20,18,2,19,DESEMBER
SULAWESI BARAT,POLEWALI MANDAR,BALANIPA,TAMMAJARRA,58,24,5,3,3,0,0,1,2,0,0,5,1,1,0,0,21,6,15,3,18,1,17,1,0,0,0,0,DESEMBER
SULAWESI BARAT,POLEWALI MANDAR,BALANIPA,TAMANGGALLE,60,34,20,15,4,3,2,16,0,1,10,10,12,0,12,0,25,21,4,8,1,1,0,1,17,14,3,2,DESEMBER
SULAWESI BARAT,POLEWALI MANDAR,BALANIPA,MOSSO,93,42,38,38,18,2,1,20,11,2,18,2,18,8,10,8,32,29,3,23,5,0,5,0,11,7,4,9,DESEMBER
SULAWESI BARAT,POLEWALI MANDAR,BALANIPA,GALUNG TULUK,78,28,11,7,6,3,1,5,1,3,4,3,0,0,0,0,17,11,6,11,13,9,4,7,11,3,8,8,DESEMBER
SULAWESI BARAT,POLEWALI MANDAR,BALANIPA,SABANG SUBIK,53,38,7,6,2,0,0,5,1,0,1,5,4,4,0,0,32,15,17,7,27,9,18,2,51,8,43,42,DESEMBER
SULAWESI BARAT,POLEWALI MANDAR,BALANIPA,PAMBUSUANG,57,72,59,15,2,2,2,10,46,1,35,14,6,5,1,0,22,12,10,1,16,4,12,3,22,3,19,15,DESEMBER
SULAWESI BARAT,POLEWALI MANDAR,BALANIPA,BALA,59,17,7,5,1,0,0,2,5,0,2,4,0,0,0,0,11,10,1,5,5,4,1,4,1,0,1,0,DESEMBER
SULAWESI BARAT,POLEWALI MANDAR,BALANIPA,LAMBANAN,89,45,9,2,2,0,0,2,5,2,7,0,9,2,7,1,15,6,9,4,6,1,5,0,18,0,18,12,DESEMBER
SULAWESI BARAT,POLEWALI MANDAR,BALANIPA,LEGO,66,45,11,5,0,0,0,4,0,0,6,5,13,0,13,0,11,8,3,5,7,6,1,5,3,2,1,2,DESEMBER
SULAWESI BARAT,POLEWALI MANDAR,BALANIPA,PALLIS,54,72,40,36,6,5,1,27,6,5,23,9,0,0,0,0,43,43,0,18,38,3,35,2,49,27,22,12,DESEMBER
SULAWESI BARAT,POLEWALI MANDAR,BINUANG,AMASSANGAN,94,50,15,2,0,0,0,8,4,2,6,7,2,0,2,0,38,29,9,12,15,3,12,1,29,22,7,26,DESEMBER
SULAWESI BARAT,POLEWALI MANDAR,BINUANG,TONYAMAN,56,26,15,5,3,1,0,13,0,2,9,6,9,6,3,6,15,8,7,2,15,7,8,5,9,5,4,3,DESEMBER
SULAWESI BARAT,POLEWALI MANDAR,BINUANG,KUAJANG,46,47,12,1,0,0,0,2,3,0,12,0,6,6,0,3,15,5,10,5,9,3,6,0,24,5,19,6,DESEMBER
SULAWESI BARAT,POLEWALI MANDAR,BINUANG,PAKU,49,24,24,23,20,14,11,5,0,7,22,2,5,1,4,0,11,9,2,4,0,0,0,0,5,2,3,4,DESEMBER
SULAWESI BARAT,POLEWALI MANDAR,BINUANG,MIRRING,89,27,23,23,12,6,4,17,1,0,13,9,16,12,4,11,20,15,5,5,2,0,2,0,17,5,12,10,DESEMBER
SULAWESI BARAT,POLEWALI MANDAR,BINUANG,BATETANGNGA,31,74,0,0,0,0,0,0,0,0,0,0,3,2,1,2,46,20,26,17,21,6,15,6,39,33,6,36,DESEMBER
SULAWESI BARAT,POLEWALI MANDAR,BINUANG,MAMMI,68,29,8,5,0,0,0,4,2,2,4,3,5,2,3,1,26,15,11,3,14,10,4,4,23,9,14,22,DESEMBER
SULAWESI BARAT,POLEWALI MANDAR,BINUANG,KALEOK,97,30,1,1,1,1,0,1,0,0,0,1,19,16,3,12,23,8,15,7,21,19,2,8,29,22,7,9,DESEMBER
SULAWESI BARAT,POLEWALI MANDAR,BINUANG,AMOLA,33,24,13,1,0,0,0,3,5,1,11,0,2,2,0,0,11,10,1,8,4,2,2,1,5,1,4,0,DESEMBER
SULAWESI BARAT,POLEWALI MANDAR,BINUANG,REA,52,71,11,1,1,1,0,2,9,0,6,1,6,1,5,0,18,17,1,11,12,11,1,8,51,27,24,28,DESEMBER
SULAWESI BARAT,POLEWALI MANDAR,BULO,BULO,46,17,17,16,9,9,9,2,1,1,17,0,4,4,0,2,16,11,5,2,5,0,5,0,9,9,0,2,DESEMBER
SULAWESI BARAT,POLEWALI MANDAR,BULO,PULLIWA,38,60,39,6,5,0,0,3,20,4,36,0,0,0,0,0,15,5,10,4,7,4,3,4,8,6,2,1,DESEMBER
SULAWESI BARAT,POLEWALI MANDAR,BULO,PATAMBANUA,87,59,24,12,7,0,0,15,0,1,19,3,9,1,8,0,34,29,5,1,32,0,32,0,7,3,4,5,DESEMBER
SULAWESI BARAT,POLEWALI MANDAR,BULO,KAROMBANG,90,66,2,2,1,1,0,1,0,1,2,0,4,1,3,1,50,22,28,18,27,27,0,14,25,16,9,17,DESEMBER
SULAWESI BARAT,POLEWALI MANDAR,BULO,DAALA TIMUR,64,76,58,54,13,11,0,44,5,2,35,0,1,0,1,0,21,14,7,1,15,2,13,0,55,5,50,29,DESEMBER
SULAWESI BARAT,POLEWALI MANDAR,BULO,LENGGO,100,71,14,9,1,1,0,0,10,4,5,6,14,9,5,7,48,7,41,2,1,0,1,0,39,22,17,1,DESEMBER
SULAWESI BARAT,POLEWALI MANDAR,BULO,SABURA,84,18,6,5,1,1,1,5,0,0,2,0,6,2,4,2,15,8,7,4,7,1,6,0,5,0,5,2,DESEMBER
SULAWESI BARAT,POLEWALI MANDAR,BULO,SEPPORRAKI,76,40,31,12,1,0,0,6,8,14,28,2,15,12,3,5,25,15,10,15,12,5,7,5,36,17,19,25,DESEMBER
SULAWESI BARAT,POLEWALI MANDAR,BULO,IHING,54,41,19,8,0,0,0,5,14,0,4,1,5,1,4,0,21,17,4,13,1,0,1,0,21,18,3,2,DESEMBER
SULAWESI BARAT,POLEWALI MANDAR,CAMPALAGIAN,PAPPANG,72,45,42,10,2,1,1,23,17,1,6,32,10,8,2,5,32,20,12,1,21,15,6,8,20,14,6,0,DESEMBER
SULAWESI BARAT,POLEWALI MANDAR,CAMPALAGIAN,LALIKO,31,28,2,1,0,0,0,0,0,2,0,2,5,0,5,0,22,11,11,1,13,10,3,1,18,10,8,11,DESEMBER
SULAWESI BARAT,POLEWALI MANDAR,CAMPALAGIAN,BONDE,57,20,3,2,0,0,0,1,2,0,1,0,8,8,0,5,12,12,0,11,5,1,4,1,5,4,1,2,DESEMBER
SULAWESI BARAT,POLEWALI MANDAR,CAMPALAGIAN,KATUMBANGAN LEMO,92,78,13,12,12,4,0,11,0,0,2,3,18,13,5,1,40,32,8,24,30,10,20,10,59,42,17,40,DESEMBER
SULAWESI BARAT,POLEWALI MANDAR,CAMPALAGIAN,PANYAMPA,62,67,42,6,2,0,0,41,0,1,1,14,8,4,4,1,17,13,4,12,13,4,9,0,46,44,2,43,DESEMBER
SULAWESI BARAT,POLEWALI MANDAR,CAMPALAGIAN,SURUANG,77,41,2,1,1,1,0,2,0,0,1,0,14,1,13,1,22,17,5,12,14,3,11,1,13,12,1,10,DESEMBER
SULAWESI BARAT,POLEWALI MANDAR,CAMPALAGIAN,LAMPOKO,35,59,10,5,3,0,0,1,5,4,5,5,7,7,0,1,14,5,9,1,3,2,1,0,19,18,1,1,DESEMBER
SULAWESI BARAT,POLEWALI MANDAR,CAMPALAGIAN,KATUMBANGAN,69,78,68,66,1,1,0,13,19,33,61,3,5,3,2,3,59,54,5,42,11,10,1,2,9,3,6,7,DESEMBER
SULAWESI BARAT,POLEWALI MANDAR,CAMPALAGIAN,LAPEO,46,75,36,16,15,0,0,7,2,7,12,0,3,0,3,0,34,20,14,3,2,0,2,0,38,18,20,18,DESEMBER
SULAWESI BARAT,POLEWALI MANDAR,CAMPALAGIAN,PARAPPE,40,26,18,2,1,0,0,16,0,0,6,0,8,0,8,0,10,8,2,2,5,1,4,0,17,6,11,11,DESEMBER
SULAWESI BARAT,POLEWALI MANDAR,CAMPALAGIAN,ONGKO,96,42,35,18,18,2,0,4,0,15,23,10,13,10,3,10,11,7,4,7,5,5,0,1,15,9,6,8,DESEMBER
SULAWESI BARAT,POLEWALI MANDAR,CAMPALAGIAN,KENJE,72,56,8,5,4,4,3,4,1,0,6,0,14,3,11,3,15,15,0,11,14,0,14,0,14,9,5,11,DESEMBER
SULAWESI BARAT,POLEWALI MANDAR,CAMPALAGIAN,SUMARRANG,83,32,22,21,10,4,1,12,2,4,20,1,14,1,13,0,24,6,18,4,16,11,5,7,29,21,8,18,DESEMBER
SULAWESI BARAT,POLEWALI MANDAR,CAMPALAGIAN,BOTTO,90,41,6,5,0,0,0,5,1,0,2,3,5,3,2,1,21,5,16,5,10,0,10,0,18,17,1,14,DESEMBER
SULAWESI BARAT,POLEWALI MANDAR,CAMPALAGIAN,GATTUNGAN,49,55,36,12,11,6,5,28,1,2,28,5,1,0,1,0,34,19,15,18,12,5,7,5,36,31,5,15,DESEMBER
SULAWESI BARAT,POLEWALI MANDAR,CAMPALAGIAN,PADANG TIMUR,42,65,0,0,0,0,0,0,0,0,0,0,1,1,0,1,56,18,38,8,47,30,17,16,47,34,13,10,DESEMBER
SULAWESI BARAT,POLEWALI MANDAR,CAMPALAGIAN,PADANG,65,52,52,18,1,1,1,21,19,1,22,1,13,1,12,0,48,22,26,16,14,2,12,0,49,43,6,17,DESEMBER
SULAWESI BARAT,POLEWALI MANDAR,CAMPALAGIAN,LAGI-AGI,48,61,16,6,2,0,0,11,2,2,14,0,7,1,6,1,40,28,12,10,3,3,0,2,22,12,10,21,DESEMBER
SULAWESI BARAT,POLEWALI MANDAR,LIMBORO,LIMBORO,65,58,53,44,41,24,7,34,12,0,38,5,5,3,2,0,50,5,45,1,43,14,29,7,46,9,37,41,DESEMBER
SULAWESI BARAT,POLEWALI MANDAR,LIMBORO,LEMBANG LEMBANG,83,20,0,0,0,0,0,0,0,0,0,0,10,6,4,1,18,8,10,8,16,8,8,7,11,10,1,2,DESEMBER
SULAWESI BARAT,POLEWALI MANDAR,LIMBORO,TANDASURA,58,47,4,2,2,1,0,1,0,2,4,0,11,10,1,9,41,25,16,9,24,7,17,6,32,11,21,20,DESEMBER
SULAWESI BARAT,POLEWALI MANDAR,LIMBORO,SAMASUNDU,92,24,3,0,0,0,0,2,1,0,0,1,1,0,1,0,11,5,6,1,9,8,1,2,25,12,13,20,DESEMBER
SULAWESI BARAT,POLEWALI MANDAR,LIMBORO,NAPO,47,16,4,3,0,0,0,4,0,0,0,2,0,0,0,0,10,10,0,4,1,0,1,0,3,0,3,1,DESEMBER
SULAWESI BARAT,POLEWALI MANDAR,LIMBORO,TODANG TODANG,50,41,21,16,11,1,0,9,7,5,9,8,3,2,1,2,13,8,5,8,4,4,0,0,13,5,8,3,DESEMBER
SULAWESI BARAT,POLEWALI MANDAR,LIMBORO,PENDULANGAN,68,24,21,8,7,2,0,13,6,1,9,3,9,6,3,6,17,11,6,9,0,0,0,0,3,0,3,1,DESEMBER
SULAWESI BARAT,POLEWALI MANDAR,LIMBORO,RENGGEANG,56,47,44,30,12,12,7,31,2,1,43,0,11,3,8,1,45,11,34,5,18,18,0,17,38,31,7,37,DESEMBER
SULAWESI BARAT,POLEWALI MANDAR,LIMBORO,SALARRI,62,13,2,2,1,1,0,2,0,0,0,2,5,3,2,0,11,10,1,0,11,0,11,0,8,0,8,5,DESEMBER
SULAWESI BARAT,POLEWALI MANDAR,LIMBORO,TANGAN BARU,86,56,8,5,5,2,2,1,0,5,4,2,10,6,4,4,44,26,18,13,38,29,9,25,63,28,35,34,DESEMBER
SULAWESI BARAT,POLEWALI MANDAR,LIMBORO,PALECE,55,78,21,16,0,0,0,12,7,2,6,8,0,0,0,0,31,30,1,10,6,5,1,4,51,11,40,50,DESEMBER
SULAWESI BARAT,POLEWALI MANDAR,LUYO,BATUPANGA,36,47,17,12,6,2,1,5,11,0,8,7,1,0,1,0,22,9,13,8,4,0,4,0,36,26,10,13,DESEMBER
SULAWESI BARAT,POLEWALI MANDAR,LUYO,MAMBU,64,70,55,40,23,14,9,20,26,0,19,12,10,10,0,9,48,18,30,0,41,11,30,3,62,53,9,34,DESEMBER
SULAWESI BARAT,POLEWALI MANDAR,LUYO,TENGGELANG,64,79,27,12,3,3,3,24,0,0,0,17,10,9,1,9,72,52,20,15,2,0,2,0,30,2,28,18,DESEMBER
SULAWESI BARAT,POLEWALI MANDAR,LUYO,BARU,35,21,0,0,0,0,0,0,0,0,0,0,5,3,2,0,12,7,5,7,4,0,4,0,12,10,2,7,DESEMBER
SULAWESI BARAT,POLEWALI MANDAR,LUYO,PUSSUI,36,30,0,0,0,0,0,0,0,0,0,0,5,2,3,0,21,8,13,7,9,3,6,1,3,2,1,3,DESEMBER
SULAWESI BARAT,POLEWALI MANDAR,LUYO,MAPILI BARAT,43,29,20,13,9,6,5,4,7,0,5,0,4,2,2,2,24,21,3,18,8,1,7,1,26,0,26,19,DESEMBER
SULAWESI BARAT,POLEWALI MANDAR,LUYO,SAMBALI WALI,74,48,18,8,8,5,0,7,11,0,0,10,12,12,0,6,41,8,33,8,39,10,29,6,53,20,33,12,DESEMBER
SULAWESI BARAT,POLEWALI MANDAR,LUYO,BATUPANGA DAALA,70,75,69,23,6,0,0,9,9,48,23,39,5,4,1,3,25,6,19,0,23,2,21,2,17,16,1,15,DESEMBER
SULAWESI BARAT,POLEWALI MANDAR,LUYO,LUYO,96,11,9,5,2,2,2,7,0,0,1,2,2,1,1,0,11,5,6,3,2,0,2,0,9,0,9,1,DESEMBER
SULAWESI BARAT,POLEWALI MANDAR,LUYO,PUSSUI BARAT,79,63,59,26,21,16,13,24,3,15,36,20,13,12,1,10,16,12,4,5,13,7,6,4,5,1,4,3,DESEMBER
SULAWESI BARAT,POLEWALI MANDAR,LUYO,PUCCADI,90,78,20,11,0,0,0,18,2,0,18,1,15,14,1,10,35,34,1,2,35,18,17,12,83,39,44,73,DESEMBER
SULAWESI BARAT,POLEWALI MANDAR,MAPILLI,MAPILI,89,42,28,27,0,0,0,20,3,0,0,0,2,2,0,2,21,15,6,15,7,6,1,0,11,8,3,4,DESEMBER
SULAWESI BARAT,POLEWALI MANDAR,MAPILLI,UGIBARU,42,75,24,21,12,3,3,18,2,0,4,18,7,5,2,3,49,23,26,23,18,10,8,3,2,1,1,0,DESEMBER
SULAWESI BARAT,POLEWALI MANDAR,MAPILLI,RUMPA,91,53,0,0,0,0,0,0,0,0,0,0,4,2,2,0,31,17,14,10,9,3,6,2,20,14,6,12,DESEMBER
SULAWESI BARAT,POLEWALI MANDAR,MAPILLI,KURMA,35,69,3,3,1,0,0,1,0,1,0,2,3,2,1,2,56,19,37,10,23,10,13,0,57,14,43,11,DESEMBER
SULAWESI BARAT,POLEWALI MANDAR,MAPILLI,BUKU,78,31,7,1,0,0,0,4,2,0,3,1,15,13,2,8,11,9,2,3,8,1,7,1,3,3,0,3,DESEMBER
SULAWESI BARAT,POLEWALI MANDAR,MAPILLI,BONNE BONNE,62,30,27,6,1,0,0,11,4,10,21,2,11,11,0,7,14,14,0,10,6,0,6,0,13,12,1,10,DESEMBER
SULAWESI BARAT,POLEWALI MANDAR,MAPILLI,BEROANGIN,48,54,46,10,8,0,0,28,10,8,18,19,8,3,5,0,51,46,5,3,49,27,22,12,30,28,2,18,DESEMBER
SULAWESI BARAT,POLEWALI MANDAR,MAPILLI,SEGERANG,77,53,11,4,1,1,1,8,1,1,2,8,4,0,4,0,10,9,1,2,9,9,0,2,12,6,6,1,DESEMBER
SULAWESI BARAT,POLEWALI MANDAR,MAPILLI,BONRA,97,46,17,5,0,0,0,13,4,0,1,9,4,3,1,0,35,10,25,4,13,4,9,4,24,0,24,15,DESEMBER
SULAWESI BARAT,POLEWALI MANDAR,MAPILLI,SATTOKO,55,51,10,4,0,0,0,2,0,8,8,2,6,5,1,0,27,5,22,4,7,6,1,3,35,32,3,24,DESEMBER
SULAWESI BARAT,POLEWALI MANDAR,MAPILLI,RAPPANG BARAT,47,79,38,27,24,6,6,32,0,0,18,2,7,2,5,1,29,24,5,12,14,13,1,10,30,22,8,15,DESEMBER
SULAWESI BARAT,POLEWALI MANDAR,MAPILLI,LANDI KANUSUANG,43,51,40,33,20,2,0,38,2,0,25,0,3,1,2,1,41,37,4,0,3,3,0,1,2,2,0,1,DESEMBER
SULAWESI BARAT,POLEWALI MANDAR,MATAKALI,MATAKALI,86,56,54,27,17,6,1,9,42,0,45,1,7,7,0,5,13,12,1,0,13,8,5,1,11,5,6,4,DESEMBER
SULAWESI BARAT,POLEWALI MANDAR,MATAKALI,PETAMPANUA,55,58,11,4,3,2,0,8,3,0,1,2,10,7,3,2,32,13,19,3,25,7,18,3,7,1,6,5,DESEMBER
SULAWESI BARAT,POLEWALI MANDAR,MATAKALI,BARUMBUNG,79,80,12,1,1,0,0,2,10,0,11,0,7,1,6,1,75,67,8,22,57,55,2,36,42,20,22,20,DESEMBER
SULAWESI BARAT,POLEWALI MANDAR,MATAKALI,PASIANG,64,56,21,11,8,8,1,5,12,0,12,0,5,5,0,0,37,17,20,10,27,23,4,22,57,46,11,56,DESEMBER
SULAWESI BARAT,POLEWALI MANDAR,MATAKALI,TONROLIMA,99,64,21,10,4,2,0,14,0,2,21,0,12,7,5,4,51,28,23,28,6,2,4,1,34,6,28,5,DESEMBER
SULAWESI BARAT,POLEWALI MANDAR,MATAKALI,INDOMAKKOMBONG,81,22,7,6,5,1,0,4,1,0,2,2,8,1,7,0,17,14,3,10,15,13,2,11,23,13,10,12,DESEMBER
SULAWESI BARAT,POLEWALI MANDAR,MATAKALI,BUNGA-BUNGA,58,18,0,0,0,0,0,0,0,0,0,0,7,4,3,3,11,9,2,7,8,6,2,6,19,15,4,8,DESEMBER
SULAWESI BARAT,POLEWALI MANDAR,MATANGNGA,MATANGNGA,53,45,44,1,1,0,0,7,35,0,15,29,9,8,1,1,19,12,7,8,11,2,9,1,42,19,23,36,DESEMBER
SULAWESI BARAT,POLEWALI MANDAR,MATANGNGA,LILLI,74,35,13,8,4,1,0,0,8,4,8,5,11,8,3,0,18,8,10,4,7,3,4,0,27,27,0,27,DESEMBER
SULAWESI BARAT,POLEWALI MANDAR,MATANGNGA,RANGOAN,36,11,10,0,0,0,0,8,2,0,9,0,6,5,1,2,11,9,2,4,9,6,3,4,16,0,16,16,DESEMBER
SULAWESI BARAT,POLEWALI MANDAR,MATANGNGA,TAPUA,93,23,1,1,0,0,0,0,1,0,0,1,1,1,0,0,19,7,12,6,10,5,5,4,12,5,7,7,DESEMBER
SULAWESI BARAT,POLEWALI MANDAR,MATANGNGA,MAMBU TAPUA,54,61,17,2,2,1,1,7,0,1,7,9,6,4,2,4,45,24,21,14,36,14,22,3,11,7,4,8,DESEMBER
SULAWESI BARAT,POLEWALI MANDAR,MATANGNGA,BA'BA TAPUA,55,28,25,18,3,0,0,23,1,1,8,14,1,0,1,0,26,24,2,4,13,10,3,1,27,8,19,14,DESEMBER
SULAWESI BARAT,POLEWALI MANDAR,MATANGNGA,KATIMBANG,67,63,13,8,6,4,3,4,4,1,13,0,8,3,5,0,44,41,3,26,19,13,6,3,52,18,34,27,DESEMBER
SULAWESI BARAT,POLEWALI MANDAR,POLEWALI,POLEWALI,81,45,31,28,6,4,1,2,13,7,23,7,14,4,10,3,41,29,12,12,26,7,19,1,26,4,22,26,DESEMBER
SULAWESI BARAT,POLEWALI MANDAR,POLEWALI,WATTANG,73,35,15,11,2,1,1,9,3,2,15,0,1,0,1,0,20,6,14,3,17,5,12,5,23,22,1,15,DESEMBER
SULAWESI BARAT,POLEWALI MANDAR,POLEWALI,SULEWATANG,80,37,15,6,2,2,2,12,1,0,6,9,3,0,3,0,13,12,1,6,7,6,1,4,13,0,13,13,DESEMBER
SULAWESI BARAT,POLEWALI MANDAR,POLEWALI,LANTORA,91,18,9,7,5,2,2,5,0,1,7,1,16,12,4,4,15,6,9,2,7,3,4,2,16,10,6,4,DESEMBER
SULAWESI BARAT,POLEWALI MANDAR,POLEWALI,TAKATIDUNG,87,17,0,0,0,0,0,0,0,0,0,0,15,6,9,6,14,10,4,7,4,3,1,2,5,0,5,5,DESEMBER
SULAWESI BARAT,POLEWALI MANDAR,POLEWALI,PEKKABATA,63,58,32,16,11,9,0,7,25,0,21,5,9,2,7,2,28,17,11,9,24,0,24,0,46,24,22,10,DESEMBER
SULAWESI BARAT,POLEWALI MANDAR,POLEWALI,MADATE,78,42,11,8,6,5,3,5,0,2,1,0,6,6,0,1,42,22,20,10,8,3,5,1,1,1,0,0,DESEMBER
SULAWESI BARAT,POLEWALI MANDAR,POLEWALI,MANDING,37,13,12,3,0,0,0,3,8,1,0,4,3,2,1,2,10,6,4,5,1,1,0,0,8,3,5,8,DESEMBER
SULAWESI BARAT,POLEWALI MANDAR,POLEWALI,DARMA,69,42,0,0,0,0,0,0,0,0,0,0,2,2,0,1,10,10,0,3,3,0,3,0,2,0,2,0,DESEMBER
SULAWESI BARAT,POLEWALI MANDAR,TAPANGO,PELITAKAN,76,11,11,1,0,0,0,11,0,0,5,4,13,1,12,1,10,9,1,3,5,2,3,1,6,0,6,1,DESEMBER
SULAWESI BARAT,POLEWALI MANDAR,TAPANGO,TAPANGO,46,11,1,1,0,0,0,1,0,0,0,1,8,4,4,3,10,9,1,2,1,0,1,0,7,6,1,3,DESEMBER
SULAWESI BARAT,POLEWALI MANDAR,TAPANGO,RAPPANG,81,30,14,12,3,1,1,10,1,1,0,3,11,5,6,4,30,18,12,10,25,0,25,0,25,14,11,13,DESEMBER
SULAWESI BARAT,POLEWALI MANDAR,TAPANGO,DAKKA,95,66,29,24,13,6,1,19,6,2,13,2,6,4,2,4,37,32,5,21,0,0,0,0,31,28,3,11,DESEMBER
SULAWESI BARAT,POLEWALI MANDAR,TAPANGO,BATU,80,60,58,51,7,0,0,22,5,24,9,48,3,1,2,1,26,20,6,12,12,6,6,2,49,33,16,13,DESEMBER
SULAWESI BARAT,POLEWALI MANDAR,TAPANGO,RISO,32,25,1,0,0,0,0,1,0,0,1,0,4,2,2,0,15,14,1,13,14,10,4,1,18,14,4,14,DESEMBER
SULAWESI BARAT,POLEWALI MANDAR,TAPANGO,PALATTA,78,72,22,11,0,0,0,10,8,2,8,12,15,3,12,1,65,23,42,15,58,11,47,11,28,5,23,18,DESEMBER
SULAWESI BARAT,POLEWALI MANDAR,TAPANGO,TAPANGO BARAT,53,54,36,1,0,0,0,16,3,7,8,23,1,0,1,0,13,12,1,11,4,1,3,0,39,16,23,9,DESEMBER
SULAWESI BARAT,POLEWALI MANDAR,TAPANGO,KURRAK,55,57,11,10,5,1,0,9,1,1,0,11,2,0,2,0,37,12,25,9,30,27,3,18,16,9,7,2,DESEMBER
SULAWESI BARAT,POLEWALI MANDAR,TAPANGO,BUSSU,89,36,19,2,2,0,0,14,5,0,1,9,6,0,6,0,15,15,0,8,2,2,0,2,21,19,2,18,DESEMBER
SULAWESI BARAT,POLEWALI MANDAR,TAPANGO,TUTTULA,88,73,66,40,38,37,37,13,2,10,13,32,5,5,0,5,10,9,1,2,2,2,0,2,49,26,23,15,DESEMBER
SULAWESI BARAT,POLEWALI MANDAR,TAPANGO,JAMBU MALEA,72,45,7,2,2,2,0,4,0,3,7,0,1,0,1,0,40,11,29,4,39,17,22,1,53,1,52,21,DESEMBER
SULAWESI BARAT,POLEWALI MANDAR,TAPANGO,KALIMBUA,58,43,36,0,0,0,0,16,2,15,21,7,3,0,3,0,11,6,5,6,11,4,7,1,38,12,26,5,DESEMBER
SULAWESI BARAT,POLEWALI MANDAR,TAPANGO,BANATO REJO,41,43,22,6,1,1,1,13,4,1,14,1,5,2,3,2,38,30,8,28,10,1,9,0,20,2,18,8,DESEMBER
SULAWESI BARAT,POLEWALI MANDAR,TINAMBUNG,TINAMBUNG,75,35,28,13,10,6,4,13,9,2,20,8,13,6,7,0,31,16,15,15,18,17,1,2,6,0,6,3,DESEMBER
SULAWESI BARAT,POLEWALI MANDAR,TINAMBUNG,KARAMA,30,73,5,5,3,3,1,2,2,0,2,0,5,5,0,0,68,22,46,5,34,17,17,3,38,19,19,11,DESEMBER
SULAWESI BARAT,POLEWALI MANDAR,TINAMBUNG,TANGNGA TANGNGA,52,17,2,2,2,2,0,1,0,0,2,0,8,6,2,5,12,6,6,3,12,2,10,0,0,0,0,0,DESEMBER
SULAWESI BARAT,POLEWALI MANDAR,TINAMBUNG,LEKOPADIS,59,52,18,2,0,0,0,6,5,2,18,0,9,1,8,0,47,12,35,3,29,21,8,13,8,2,6,7,DESEMBER
SULAWESI BARAT,POLEWALI MANDAR,TINAMBUNG,GALUNG LOMBOK,82,61,17,15,3,1,1,5,0,6,8,9,15,7,8,4,35,26,9,13,14,11,3,10,6,5,1,4,DESEMBER
SULAWESI BARAT,POLEWALI MANDAR,TINAMBUNG,TANDUNG,42,17,7,5,1,0,0,1,1,4,6,1,5,2,3,2,11,8,3,3,0,0,0,0,3,2,1,0,DESEMBER
SULAWESI BARAT,POLEWALI MANDAR,TINAMBUNG,BATULAYA,67,43,6,0,0,0,0,5,0,1,3,3,2,1,1,0,15,14,1,7,12,2,10,1,29,9,20,5,DESEMBER
SULAWESI BARAT,POLEWALI MANDAR,TINAMBUNG,SEPABATU,56,16,16,4,3,0,0,6,3,5,9,6,3,0,3,0,11,9,2,9,3,0,3,0,0,0,0,0,DESEMBER
SULAWESI BARAT,POLEWALI MANDAR,TUTAR,TARAMANU,97,14,12,0,0,0,0,7,4,0,1,4,15,5,10,1,12,9,3,7,8,1,7,1,0,0,0,0,DESEMBER
SULAWESI BARAT,POLEWALI MANDAR,TUTAR,AMBOPADANG,56,26,3,0,0,0,0,3,0,0,3,0,6,5,1,4,17,14,3,0,13,11,2,4,24,13,11,0,DESEMBER
SULAWESI BARAT,POLEWALI MANDAR,TUTAR,TUBBI,38,79,68,7,2,2,1,16,8,7,3,31,6,5,1,0,23,19,4,9,7,0,7,0,12,8,4,1,DESEMBER
SULAWESI BARAT,POLEWALI MANDAR,TUTAR,RATTE,73,38,20,5,1,0,0,16,4,0,20,0,5,3,2,3,14,5,9,5,6,2,4,0,18,12,6,5,DESEMBER
SULAWESI BARAT,POLEWALI MANDAR,TUTAR,BESOANGIN,66,70,51,40,34,2,0,4,29,10,22,6,10,0,10,0,62,52,10,33,35,13,22,8,84,2,82,83,DESEMBER
SULAWESI BARAT,POLEWALI MANDAR,TUTAR,PIRIANG TAPIKO,64,74,10,5,5,5,3,6,1,0,9,0,11,4,7,3,20,5,15,0,15,2,13,0,32,21,11,32,DESEMBER
SULAWESI BARAT,POLEWALI MANDAR,TUTAR,PEBURRU,58,39,27,9,7,6,3,15,8,1,23,2,4,1,3,0,12,6,6,4,9,6,3,6,7,3,4,4,DESEMBER
SULAWESI BARAT,POLEWALI MANDAR,TUTAR,TALOBA,56,77,20,5,0,0,0,12,2,5,10,8,0,0,0,0,60,7,53,0,11,2,9,1,38,2,36,2,DESEMBER
SULAWESI BARAT,POLEWALI MANDAR,TUTAR,POLLEWANI,91,53,2,2,2,0,0,1,1,0,2,0,7,5,2,0,26,25,1,14,1,0,1,0,23,0,23,14,DESEMBER
SULAWESI BARAT,POLEWALI MANDAR,TUTAR,ARABUA,47,28,20,10,0,0,0,9,11,0,18,1,8,0,8,0,14,11,3,9,9,6,3,6,17,17,0,6,DESEMBER
SULAWESI BARAT,POLEWALI MANDAR,TUTAR,BESOANGIN UTARA,54,20,0,0,0,0,0,0,0,0,0,0,10,6,4,1,18,8,10,6,7,6,1,2,18,0,18,12,DESEMBER
SULAWESI BARAT,POLEWALI MANDAR,TUTAR,PODA,89,69,23,22,3,3,2,8,9,0,3,12,5,5,0,1,58,12,46,1,47,42,5,14,24,20,4,0,DESEMBER
SULAWESI BARAT,POLEWALI MANDAR,TUTAR,TARAMANU TUA,58,18,16,0,0,0,0,9,1,2,1,12,11,6,5,2,18,13,5,13,17,2,15,0,2,2,0,0,DESEMBER
SULAWESI BARAT,POLEWALI MANDAR,WONOMULYO,SIDODADI,35,13,2,2,2,0,0,1,0,1,2,0,1,0,1,0,11,9,2,5,8,5,3,2,2,1,1,2,DESEMBER
SULAWESI BARAT,POLEWALI MANDAR,WONOMULYO,SIDOREJO,35,33,10,3,2,1,1,2,4,2,0,10,5,4,1,0,11,9,2,0,10,0,10,0,22,0,22,5,DESEMBER
SULAWESI BARAT,POLEWALI MANDAR,WONOMULYO,SUMBEREJO,56,34,5,5,0,0,0,4,1,0,0,4,10,5,5,4,17,15,2,6,6,0,6,0,7,7,0,7,DESEMBER
SULAWESI BARAT,POLEWALI MANDAR,WONOMULYO,BUMIAYU,77,35,10,2,1,1,0,10,0,0,9,0,13,2,11,2,23,20,3,5,14,13,1,13,25,3,22,3,DESEMBER
SULAWESI BARAT,POLEWALI MANDAR,WONOMULYO,KEBUNSARI,88,31,1,1,0,0,0,0,1,0,0,0,4,3,1,3,14,8,6,3,3,1,2,0,7,2,5,1,DESEMBER
SULAWESI BARAT,POLEWALI MANDAR,WONOMULYO,BANUA BARU,63,67,32,2,2,0,0,4,0,3,22,10,3,1,2,0,49,42,7,34,16,3,13,0,56,48,8,26,DESEMBER
SULAWESI BARAT,POLEWALI MANDAR,WONOMULYO,NEPO,79,61,33,27,24,24,11,21,0,0,33,0,13,12,1,9,24,6,18,2,17,2,15,1,3,2,1,1,DESEMBER
SULAWESI BARAT,POLEWALI MANDAR,WONOMULYO,SUGIHWARAS,98,41,13,1,0,0,0,10,2,0,5,6,15,6,9,5,41,24,17,13,14,7,7,4,26,6,20,17,DESEMBER
SULAWESI BARAT,POLEWALI MANDAR,WONOMULYO,CAMPURJO,52,37,17,0,0,0,0,6,5,3,3,11,2,0,2,0,30,19,11,13,26,3,23,2,3,1,2,2,DESEMBER
SULAWESI BARAT,POLEWALI MANDAR,WONOMULYO,BUMIMULYO,61,47,39,36,20,14,11,15,13,0,7,28,6,6,0,5,44,20,24,20,4,2,2,1,35,28,7,27,DESEMBER
SULAWESI BARAT,POLEWALI MANDAR,WONOMULYO,TUMPILING,49,15,14,11,4,4,0,4,5,2,5,5,7,2,5,1,12,8,4,1,8,5,3,5,15,11,4,3,DESEMBER
SULAWESI BARAT,POLEWALI MANDAR,WONOMULYO,BAKKA-BAKKA,71,10,5,5,5,3,2,0,0,3,4,1,6,0,6,0,10,7,3,6,5,2,3,2,9,7,2,0,DESEMBER
SULAWESI BARAT,POLEWALI MANDAR,WONOMULYO,ARJO SARI,76,39,13,1,1,1,1,12,0,0,8,2,15,1,14,1,26,5,21,1,17,4,13,4,22,6,16,22,DESEMBER
SULAWESI BARAT,POLEWALI MANDAR,WONOMULYO,GALESON,80,13,5,3,3,0,0,4,0,0,5,0,6,1,5,0,12,10,2,9,8,3,5,2,17,2,15,0,DESEMBER
SULAWESI BARAT,MAMUJU,MAMUJU,BINANGA,58,24,23,5,3,3,1,14,0,3,11,6,2,1,1,0,23,12,11,4,22,11,11,5,12,10,2,9,DESEMBER
SULAWESI BARAT,MAMUJU,MAMUJU,MAMUNYU,82,52,39,23,1,1,0,8,30,0,19,18,11,6,5,2,52,34,18,27,8,6,2,0,31,15,16,28,DESEMBER
SULAWESI BARAT,MAMUJU,MAMUJU,KAREMA,39,40,16,11,4,4,2,0,8,1,9,6,5,3,2,2,36,8,28,2,14,13,1,13,21,21,0,2,DESEMBER
SULAWESI BARAT,MAMUJU,MAMUJU,RIMUKU,67,10,5,3,2,0,0,4,1,0,3,1,12,0,12,0,10,5,5,5,3,2,1,2,4,3,1,4,DESEMBER
SULAWESI BARAT,MAMUJU,MAMUJU,BAMBU,86,71,13,10,10,2,1,3,9,0,0,4,3,1,2,0,54,54,0,49,33,33,0,18,22,15,7,21,DESEMBER
SULAWESI BARAT,MAMUJU,MAMUJU,KARAMPUANG,87,42,18,3,2,0,0,18,0,0,5,1,10,2,8,1,30,9,21,6,25,20,5,2,2,1,1,2,DESEMBER
SULAWESI BARAT,MAMUJU,MAMUJU,TADUI,96,45,17,16,8,8,1,3,2,1,6,0,14,14,0,0,15,8,7,3,13,9,4,8,9,6,3,1,DESEMBER
SULAWESI BARAT,MAMUJU,MAMUJU,BATU PANNU,63,64,11,3,3,2,2,2,0,6,9,1,3,3,0,3,50,38,12,14,28,24,4,17,67,26,41,1,DESEMBER
SULAWESI BARAT,MAMUJU,TAPALANG,GALUNG,53,23,11,0,0,0,0,10,0,1,9,2,2,2,0,1,10,5,5,1,5,5,0,5,17,4,13,10,DESEMBER
SULAWESI BARAT,MAMUJU,TAPALANG,KASAMBANG,71,22,7,7,3,0,0,1,0,3,6,1,9,4,5,0,15,15,0,12,0,0,0,0,12,2,10,11,DESEMBER
SULAWESI BARAT,MAMUJU,TAPALANG,DAYANGINNA,43,39,23,18,6,6,3,10,1,1,12,8,3,3,0,1,31,6,25,1,29,6,23,0,47,3,44,37,DESEMBER
SULAWESI BARAT,MAMUJU,TAPALANG,OROBATU,62,46,42,15,12,3,1,0,18,9,25,2,6,0,6,0,27,10,17,0,15,13,2,9,19,5,14,0,DESEMBER
SULAWESI BARAT,MAMUJU,TAPALANG,TAKANDEANG,73,15,13,1,0,0,0,8,4,1,0,13,4,2,2,1,11,11,0,1,2,1,1,0,2,1,1,1,DESEMBER
SULAWESI BARAT,MAMUJU,TAPALANG,BELA,55,23,21,2,0,0,0,16,2,3,6,12,10,1,9,1,21,20,1,16,4,4,0,0,15,14,1,5,DESEMBER
SULAWESI BARAT,MAMUJU,TAPALANG,TAAN,50,52,46,2,2,2,2,12,27,0,41,4,0,0,0,0,43,42,1,19,14,5,9,1,50,46,4,3,DESEMBER
SULAWESI BARAT,MAMUJU,TAPALANG,TAMPALANG,35,31,21,7,1,0,0,12,0,2,19,0,2,1,1,1,12,8,4,7,4,1,3,0,6,3,3,1,DESEMBER
SULAWESI BARAT,MAMUJU,TAPALANG,RANTEDODA,98,58,57,17,16,6,4,19,23,4,26,9,10,8,2,5,48,33,15,23,34,23,11,12,39,17,22,36,DESEMBER
SULAWESI BARAT,MAMUJU,TAPALANG,KOPEANG,76,77,39,22,11,1,0,16,12,4,9,28,6,5,1,3,25,19,6,7,2,1,1,0,4,0,4,2,DESEMBER
SULAWESI BARAT,MAMUJU,KALUKKU,SINYONYOI,77,20,16,8,4,2,0,1,4,3,1,7,9,0,9,0,10,7,3,4,7,7,0,3,2,1,1,2,DESEMBER
SULAWESI BARAT,MAMUJU,KALUKKU,BEBANGA,55,46,27,12,11,2,2,14,9,0,11,5,11,1,10,1,17,15,2,12,13,13,0,0,32,4,28,26,DESEMBER
SULAWESI BARAT,MAMUJU,KALUKKU,KALUKKU,42,65,32,18,4,2,0,19,6,1,11,18,1,1,0,1,23,6,17,4,22,1,21,1,28,0,28,8,DESEMBER
SULAWESI BARAT,MAMUJU,KALUKKU,SINYONYOI SELATAN,49,17,5,0,0,0,0,5,0,0,3,0,2,1,1,0,16,9,7,1,3,2,1,0,2,0,2,0,DESEMBER
SULAWESI BARAT,MAMUJU,KALUKKU,SONDOANG,96,71,36,19,6,4,1,20,1,10,18,14,13,2,11,0,37,13,24,12,37,29,8,18,36,17,19,22,DESEMBER
SULAWESI BARAT,MAMUJU,KALUKKU,BERU-BERU,99,18,0,0,0,0,0,0,0,0,0,0,1,0,1,0,18,6,12,1,7,3,4,3,15,1,14,15,DESEMBER
SULAWESI BARAT,MAMUJU,KALUKKU,BELANG BELANG,96,35,33,31,28,19,3,11,11,1,32,0,15,13,2,4,18,16,2,10,13,12,1,12,11,4,7,4,DESEMBER
SULAWESI BARAT,MAMUJU,KALUKKU,KABULOANG,52,56,39,30,10,0,0,16,3,0,9,21,5,3,2,3,36,14,22,11,22,22,0,0,10,10,0,1,DESEMBER
SULAWESI BARAT,MAMUJU,KALUKKU,KEANG,93,57,46,44,11,8,7,29,7,3,9,23,4,2,2,2,19,19,0,11,11,2,9,0,11,6,5,2,DESEMBER
SULAWESI BARAT,MAMUJU,KALUKKU,POKKANG,80,73,4,0,0,0,0,1,3,0,4,0,15,8,7,4,62,36,26,31,56,7,49,1,52,39,13,22,DESEMBER
SULAWESI BARAT,MAMUJU,KALUKKU,GULILING,76,54,41,30,28,3,3,10,11,16,36,3,0,0,0,0,17,8,9,3,5,3,2,3,40,5,35,29,DESEMBER
SULAWESI BARAT,MAMUJU,KALUKKU,UHAIMATE,42,28,17,8,4,0,0,3,6,0,1,6,1,0,1,0,15,7,8,5,10,10,0,4,26,0,26,18,DESEMBER
SULAWESI BARAT,MAMUJU,KALUKKU,KALUKKU BARAT,40,10,4,3,3,0,0,0,0,1,0,3,0,0,0,0,10,5,5,4,8,3,5,3,2,2,0,1,DESEMBER
SULAWESI BARAT,MAMUJU,KALUKKU,PAMMULUKANG,54,45,39,28,6,4,3,23,4,8,10,2,10,4,6,1,37,16,21,16,12,11,1,1,15,3,12,0,DESEMBER
SULAWESI BARAT,MAMUJU,KALUMPANG,KALUMPANG,73,60,12,10,1,0,0,6,1,2,4,2,1,1,0,1,53,43,10,28,15,12,3,5,13,3,10,9,DESEMBER
SULAWESI BARAT,MAMUJU,KALUMPANG,KARATAUN,80,15,7,6,3,2,1,5,1,0,6,0,5,0,5,0,13,7,6,5,0,0,0,0,4,1,3,2,DESEMBER
SULAWESI BARAT,MAMUJU,KALUMPANG,KARAMA,75,26,0,0,0,0,0,0,0,0,0,0,13,13,0,10,18,17,1,5,16,5,11,1,12,9,3,10,DESEMBER
SULAWESI BARAT,MAMUJU,KALUMPANG,SIRAUN,52,11,7,7,1,0,0,6,1,0,4,2,3,2,1,0,10,5,5,2,8,5,3,5,2,0,2,2,DESEMBER
SULAWESI BARAT,MAMUJU,KALUMPANG,TUMOGA,33,18,13,0,0,0,0,4,8,0,2,9,0,0,0,0,15,9,6,8,3,0,3,0,4,3,1,4,DESEMBER
SULAWESI BARAT,MAMUJU,KALUMPANG,SALUMAKKI,63,32,1,0,0,0,0,1,0,0,0,0,3,1,2,0,27,5,22,2,15,9,6,9,24,14,10,22,DESEMBER
SULAWESI BARAT,MAMUJU,KALUMPANG,POLIO,53,78,29,18,3,1,1,12,5,5,14,3,5,0,5,0,35,25,10,25,34,26,8,11,28,14,14,12,DESEMBER
SULAWESI BARAT,MAMUJU,KALUMPANG,LIMBONG,35,79,23,17,16,10,8,12,2,1,18,5,2,1,1,1,59,6,53,4,30,11,19,10,11,4,7,1,DESEMBER
SULAWESI BARAT,MAMUJU,KALUMPANG,SANDAPANG,85,72,13,4,2,2,0,0,6,2,11,0,16,2,14,2,21,8,13,2,8,5,3,5,22,6,16,7,DESEMBER
SULAWESI BARAT,MAMUJU,KALUMPANG,KONDO BULO,74,74,4,1,0,0,0,1,1,2,0,4,10,0,10,0,43,32,11,0,34,30,4,3,49,4,45,38,DESEMBER
SULAWESI BARAT,MAMUJU,KALUMPANG,MAKKALIKI,75,80,53,32,13,1,1,40,11,1,6,33,1,0,1,0,46,44,2,13,33,23,10,10,52,33,19,13,DESEMBER
SULAWESI BARAT,MAMUJU,KALUMPANG,BATU MAKKADA,86,43,19,12,1,0,0,1,7,7,8,9,1,1,0,0,35,15,20,12,3,1,2,0,31,1,30,3,DESEMBER
SULAWESI BARAT,MAMUJU,KALUMPANG,LASA',71,29,23,21,7,2,0,14,6,2,6,16,4,2,2,2,18,17,1,7,1,0,1,0,9,4,5,4,DESEMBER
SULAWESI BARAT,MAMUJU,PAPALANG,TOABO,69,48,2,1,0,0,0,2,0,0,1,0,5,0,5,0,36,14,22,10,35,20,15,17,44,25,19,24,DESEMBER
SULAWESI BARAT,MAMUJU,PAPALANG,PAPALANG,38,23,17,8,8,4,4,10,0,3,9,3,0,0,0,0,17,11,6,0,0,0,0,0,14,3,11,0,DESEMBER
SULAWESI BARAT,MAMUJU,PAPALANG,BONDA,65,10,7,4,4,0,0,1,2,2,0,3,10,2,8,1,10,9,1,0,4,1,3,1,10,7,3,4,DESEMBER
SULAWESI BARAT,MAMUJU,PAPALANG,TOPORE,40,62,1,1,0,0,0,1,0,0,1,0,2,0,2,0,15,5,10,1,4,2,2,0,36,0,36,1,DESEMBER
SULAWESI BARAT,MAMUJU,PAPALANG,SALUKAYU,99,60,10,7,0,0,0,0,8,1,2,0,16,13,3,10,48,36,12,2,36,7,29,0,22,15,7,19,DESEMBER
SULAWESI BARAT,MAMUJU,PAPALANG,SUKADAMAI,93,34,18,13,4,0,0,3,5,10,8,9,18,8,10,2,18,7,11,0,0,0,0,0,6,5,1,6,DESEMBER
SULAWESI BARAT,MAMUJU,PAPALANG,BODA-BODA,42,52,2,0,0,0,0,1,0,0,2,0,3,2,1,1,34,8,26,8,5,4,1,1,11,2,9,6,DESEMBER
SULAWESI BARAT,MAMUJU,PAPALANG,SISANGO,95,54,15,5,1,0,0,10,1,1,7,4,17,10,7,2,36,24,12,12,13,1,12,0,37,6,31,15,DESEMBER
SULAWESI BARAT,MAMUJU,PAPALANG,BATU AMPA,80,40,31,28,12,0,0,18,7,2,12,17,9,5,4,3,34,8,26,5,20,2,18,0,20,3,17,1,DESEMBER
SULAWESI BARAT,MAMUJU,SAMPAGA,BUNDE,50,15,3,2,0,0,0,2,0,0,1,2,0,0,0,0,14,8,6,4,10,10,0,8,4,4,0,2,DESEMBER
SULAWESI BARAT,MAMUJU,SAMPAGA,KALONDING,37,13,9,4,1,1,0,7,1,0,4,0,7,7,0,2,11,9,2,5,11,7,4,4,20,14,6,19,DESEMBER
SULAWESI BARAT,MAMUJU,SAMPAGA,TARAILU,89,73,5,1,1,1,1,4,0,0,5,0,10,9,1,9,14,11,3,9,4,4,0,0,52,27,25,10,DESEMBER
SULAWESI BARAT,MAMUJU,SAMPAGA,SAMPAGA,100,20,19,18,6,0,0,9,7,0,1,7,2,2,0,2,16,9,7,2,11,9,2,3,10,7,3,3,DESEMBER
SULAWESI BARAT,MAMUJU,SAMPAGA,TANAMBUAH,65,13,9,7,7,2,1,5,3,0,8,0,1,1,0,1,11,7,4,2,0,0,0,0,0,0,0,0,DESEMBER
SULAWESI BARAT,MAMUJU,SAMPAGA,SALUBARANA,32,69,26,1,1,0,0,18,3,1,20,4,5,1,4,1,21,20,1,2,12,12,0,9,53,26,27,8,DESEMBER
SULAWESI BARAT,MAMUJU,SAMPAGA,LOSSO,81,32,2,1,1,1,1,1,0,0,2,0,6,4,2,1,28,8,20,5,1,0,1,0,3,1,2,3,DESEMBER
SULAWESI BARAT,MAMUJU,TOMMO,TOMMO,86,58,50,36,16,9,2,2,37,1,35,3,0,0,0,0,41,23,18,13,1,0,1,0,21,14,7,8,DESEMBER
SULAWESI BARAT,MAMUJU,TOMMO,CAMPALOGA,57,66,49,1,1,0,0,44,2,2,19,23,6,2,4,0,51,28,23,18,47,15,32,14,67,16,51,27,DESEMBER
SULAWESI BARAT,MAMUJU,TOMMO,BUANA SAKTI,60,23,17,15,13,7,6,9,1,1,9,5,3,1,2,0,11,7,4,6,1,0,1,0,8,6,2,6,DESEMBER
SULAWESI BARAT,MAMUJU,TOMMO,TAMEMONGGA,37,74,13,6,4,4,3,6,4,0,9,3,0,0,0,0,11,7,4,0,7,7,0,3,3,2,1,1,DESEMBER
SULAWESI BARAT,MAMUJU,TOMMO,TAMEJARRA,85,10,10,1,0,0,0,3,5,2,2,5,6,4,2,3,10,10,0,8,3,0,3,0,9,5,4,4,DESEMBER
SULAWESI BARAT,MAMUJU,TOMMO,RANTEMARIO,55,25,11,10,2,0,0,8,2,0,0,7,9,3,6,2,11,7,4,1,11,3,8,3,0,0,0,0,DESEMBER
SULAWESI BARAT,MAMUJU,TOMMO,MALINO,47,21,13,2,1,0,0,6,5,2,8,2,4,1,3,1,20,9,11,8,18,17,1,16,4,2,2,4,DESEMBER
SULAWESI BARAT,MAMUJU,TOMMO,KAKULLASANG,72,37,20,4,2,0,0,7,9,1,3,17,5,5,0,2,18,17,1,9,13,0,13,0,0,0,0,0,DESEMBER
SULAWESI BARAT,MAMUJU,TOMMO,LELING,85,63,20,0,0,0,0,9,4,4,16,3,16,0,16,0,39,12,27,6,0,0,0,0,42,6,36,32,DESEMBER
SULAWESI BARAT,MAMUJU,TOMMO,KALEPU,68,19,4,2,1,0,0,1,2,1,0,4,12,2,10,1,19,7,12,6,9,6,3,3,19,14,5,15,DESEMBER
SULAWESI BARAT,MAMUJU,TOMMO,SANDANA,82,79,6,4,0,0,0,5,1,0,5,0,1,0,1,0,56,10,46,1,13,13,0,8,28,4,24,5,DESEMBER
SULAWESI BARAT,MAMUJU,TOMMO,LELING BARAT,82,51,6,5,0,0,0,1,5,0,0,4,14,2,12,2,22,7,15,1,19,10,9,4,10,4,6,1,DESEMBER
SULAWESI BARAT,MAMUJU,TOMMO,LELING UTARA,50,73,71,2,1,1,1,2,47,19,55,11,0,0,0,0,37,24,13,16,2,2,0,0,12,9,3,5,DESEMBER
SULAWESI BARAT,MAMUJU,TOMMO,SALUDENGEN,96,20,8,0,0,0,0,8,0,0,0,6,13,1,12,1,20,16,4,10,4,3,1,2,0,0,0,0,DESEMBER
SULAWESI BARAT,MAMUJU,SIMBORO DAN KEPULAUAN,SIMBORO,64,34,23,5,1,0,0,7,13,0,19,2,0,0,0,0,12,6,6,3,4,4,0,4,14,7,7,12,DESEMBER
SULAWESI BARAT,MAMUJU,SIMBORO DAN KEPULAUAN,RANGAS,65,64,12,4,2,2,2,6,1,0,10,2,6,2,4,1,63,61,2,31,25,24,1,0,47,32,15,45,DESEMBER
SULAWESI BARAT,MAMUJU,SIMBORO DAN KEPULAUAN,BOTTENG,79,41,26,25,24,5,3,12,1,7,6,0,3,1,2,0,19,6,13,4,19,12,7,0,23,17,6,12,DESEMBER
SULAWESI BARAT,MAMUJU,SIMBORO DAN KEPULAUAN,SALETTO,69,80,77,25,19,5,2,43,15,7,0,34,7,3,4,3,30,14,16,3,18,4,14,3,64,14,50,8,DESEMBER
SULAWESI BARAT,MAMUJU,SIMBORO DAN KEPULAUAN,SUMARE,33,64,34,11,11,8,1,25,0,2,6,21,5,5,0,4,43,37,6,27,2,2,0,0,30,9,21,27,DESEMBER
SULAWESI BARAT,MAMUJU,SIMBORO DAN KEPULAUAN,BOTTENG UTARA,38,31,26,26,22,7,3,2,12,2,0,8,6,4,2,1,19,10,9,0,7,6,1,1,1,1,0,0,DESEMBER
SULAWESI BARAT,MAMUJU,SIMBORO DAN KEPULAUAN,TAPANDULLU,55,55,47,2,1,1,0,23,13,3,5,19,7,4,3,4,14,5,9,3,5,4,1,2,30,5,25,25,DESEMBER
SULAWESI BARAT,MAMUJU,SIMBORO DAN KEPULAUAN,PATI'DI,79,41,22,4,3,3,1,16,3,2,17,5,9,2,7,1,35,9,26,1,4,1,3,1,0,0,0,0,DESEMBER
SULAWESI BARAT,MAMUJU,TAPALANG BARAT,DUNGKAIT,76,77,48,14,5,1,1,25,0,13,30,10,13,13,0,1,69,69,0,20,31,29,2,28,77,35,42,18,DESEMBER
SULAWESI BARAT,MAMUJU,TAPALANG BARAT,LEBANI,42,51,7,7,3,1,1,4,0,0,1,6,4,3,1,3,20,12,8,8,6,5,1,0,9,8,1,2,DESEMBER
SULAWESI BARAT,MAMUJU,TAPALANG BARAT,LABUANG RANO,69,21,0,0,0,0,0,0,0,0,0,0,11,10,1,4,11,11,0,10,11,10,1,3,23,2,21,6,DESEMBER
SULAWESI BARAT,MAMUJU,TAPALANG BARAT,PASABU,65,38,26,7,0,0,0,6,8,1,8,12,12,4,8,2,29,24,5,18,7,7,0,6,13,6,7,12,DESEMBER
SULAWESI BARAT,MAMUJU,TAPALANG BARAT,TANETE PAO,87,28,15,15,0,0,0,7,8,0,6,7,11,0,11,0,19,8,11,8,9,8,1,3,11,10,1,9,DESEMBER
SULAWESI BARAT,MAMUJU,TAPALANG BARAT,PANGASAAN,96,62,24,13,10,9,5,14,3,0,1,16,5,1,4,1,35,10,25,4,6,5,1,1,33,20,13,28,DESEMBER
SULAWESI BARAT,MAMUJU,TAPALANG BARAT,AHU,72,55,24,19,7,5,4,9,8,1,3,18,11,10,1,0,22,6,16,4,20,2,18,1,17,0,17,9,DESEMBER
SULAWESI BARAT,MAMUJU,BONEHAU,BONEHAU,45,62,42,27,21,12,6,13,1,16,34,0,8,1,7,0,17,6,11,3,11,8,3,8,52,1,51,2,DESEMBER
SULAWESI BARAT,MAMUJU,BONEHAU,SALUTIWO,47,75,34,18,1,0,0,12,22,0,30,4,1,0,1,0,12,9,3,9,5,5,0,4,36,3,33,5,DESEMBER
SULAWESI BARAT,MAMUJU,BONEHAU,BUTTUADA,43,54,0,0,0,0,0,0,0,0,0,0,5,0,5,0,50,36,14,13,16,3,13,3,14,0,14,13,DESEMBER
SULAWESI BARAT,MAMUJU,BONEHAU,TAMALEA,60,67,25,23,2,2,0,1,19,5,19,2,8,7,1,5,11,10,1,10,5,0,5,0,12,3,9,10,DESEMBER
SULAWESI BARAT,MAMUJU,BONEHAU,LUMIKA,46,35,33,11,11,2,2,1,9,12,4,10,8,2,6,1,21,17,4,14,19,11,8,10,31,9,22,18,DESEMBER
SULAWESI BARAT,MAMUJU,BONEHAU,MAPPU,48,56,29,10,0,0,0,15,10,0,11,10,4,0,4,0,35,22,13,6,7,2,5,2,45,12,33,21,DESEMBER
SULAWESI BARAT,MAMUJU,BONEHAU,BANUADA,80,36,33,0,0,0,0,15,6,11,26,4,14,0,14,0,24,10,14,2,10,6,4,6,28,19,9,0,DESEMBER
SULAWESI BARAT,MAMUJU,BONEHAU,HINUA,58,62,46,33,31,28,5,27,8,2,10,9,9,4,5,1,58,29,29,26,24,5,19,0,12,5,7,11,DESEMBER
SULAWESI BARAT,MAMUJU,BONEHAU,KINATANG,94,31,15,14,14,0,0,3,8,2,4,6,0,0,0,0,27,24,3,16,23,19,4,8,23,15,8,18,DESEMBER
SULAWESI BARAT,MAMUJU,KEP. BALA BALAKANG,BALA BALAKANG,43,42,42,42,19,17,2,31,2,2,37,0,0,0,0,0,27,8,19,5,20,20,0,20,36,5,31,28,DESEMBER
SULAWESI BARAT,MAMUJU,KEP. BALA BALAKANG,BALA-BALAKANG TIMUR,59,18,18,6,5,2,1,14,1,0,17,0,1,1,0,1,12,5,7,0,7,5,2,1,3,3,0,1,DESEMBER
